ecommerce,category,original_id,name,price,original_price,discount,discount_rate
TIKI,nha-sach-tiki,95218547,"Đọc Vị Mọi Vấn Đề Của Trẻ - Giải Mã Mọi Vấn Đề Về Nuôi Con Nhỏ: Ăn - Ngủ - Kỷ Luật Hành Vi (Tái Bản)",133000,199000,66000,33
TIKI,nha-sach-tiki,273536931,"Kinh Doanh Thời Trang - 8 Bước Xây Dựng, Vận Hành Và Phát Triển Shop Quần Áo Của Bạn",155000,199000,44000,22
TIKI,nha-sach-tiki,135498945,"COMBO EHON SONG NGỮ ANH VIỆT PHIÊN BẢN ĐẶC BIỆT CÓ FILE ÂMTHANH",109000,109000,0,0
TIKI,nha-sach-tiki,113964351,"(Gift)Bút ký khắc tên cao cấp Doanh nhân 006, thép nguyên khối, mực bi đều ở mọi góc nghiêng",450000,450000,0,0
TIKI,nha-sach-tiki,216102104,"Bóng nhựa Arylic trong suốt đường kính 35 cm",1500000,1500000,0,0
TIKI,nha-sach-tiki,188940817,"Vị Thần Của Những Quyết Định",56100,79000,22900,29
TIKI,nha-sach-tiki,109017985,"Thiên Tài Bên Trái, Kẻ Điên Bên Phải (Tái Bản)",118000,179000,61000,34
TIKI,nha-sach-tiki,26114399,"Nóng Giận Là Bản Năng , Tĩnh Lặng Là Bản Lĩnh",56500,89000,32500,37
TIKI,nha-sach-tiki,74021317,"Cây Cam Ngọt Của Tôi",77300,108000,30700,28
TIKI,nha-sach-tiki,184075874,"(Gift) Bút ký khắc tên cao cấp LC 010, đẹp, mực mịn đều ở mọi góc nghiêng",159000,159000,0,0
TIKI,nha-sach-tiki,189643105,"Không Phải Sói Nhưng Cũng Đừng Là Cừu -Tặng kèm bookmark 2 mặt",96800,128000,31200,24
TIKI,nha-sach-tiki,52789367,"Nhà Giả Kim (Tái Bản 2020)",54000,79000,25000,32
TIKI,nha-sach-tiki,180592885,"Combo 2Q: Mong Mẹ Hãy Yêu Lấy Chính Mình + Cơ Thể Tự Chữa Lành: Nước Ép Cần Tây",197500,197500,0,0
TIKI,nha-sach-tiki,69764541,"Tâm Lý Học Hành Vi (Tặng Kèm 1 Bookmark )",70100,98000,27900,28
TIKI,nha-sach-tiki,216102826,"Bóng nhựa Arylic trong suốt đường kính 60 cm",6500000,6500000,0,0
TIKI,nha-sach-tiki,175444830,"Combo 2Q: 7 Bài Học Lãnh Đạo Trong Khủng Hoảng + Kiếm Tiền Thời Khủng Hoảng (Cẩm Nang Kinh Doanh / Phát Triển Lãnh Đạo Doanh Nghiệp Tự Thân / Đột Phá Quy Trình Quản Trị Và Nâng Tầm Dịch Vụ)",250500,250500,0,0
TIKI,nha-sach-tiki,174301838,"BỘ BOOKMARK 1% TINH HOA",49000,49000,0,0
TIKI,nha-sach-tiki,73207240,"Xa Ngoài Kia Nơi Loài Tôm Hát - Where The Crawdads Sing",105000,165000,60000,36
TIKI,nha-sach-tiki,174444163,"Dear, Darling",62900,88000,25100,29
TIKI,nha-sach-tiki,74921655,"Combo 10 thẻ tên nhân viên thay tên mica trong suốt",159000,159000,0,0
TIKI,nha-sach-tiki,270122602,"Kệ bút mica 50 ngăn dùng trưng bày bút viết, chất liệu mica 2,5mm sáng bóng, bền đẹp",499000,499000,0,0
TIKI,nha-sach-tiki,271442564,"Sổ planner 52 tuần 2024 SDstationery “Treasure the Journey” gáy lò xo, họa tiết màu pastel trang nhã 14x20.3cm",112000,132000,20000,15
TIKI,nha-sach-tiki,73787185,"Những Tù Nhân Của Địa Lý",139000,210000,71000,34
TIKI,nha-sach-tiki,42230121,"Sách Hiểu Về Trái Tim (Tái Bản 2019) - Minh Niệm",129000,158000,29000,18
TIKI,nha-sach-tiki,195801653,"Chú Thuật Hồi Chiến - Tập 6 - Bản Tặng Kèm Obi Và Thẻ Bo Góc Nhựa",30000,30000,0,0
TIKI,nha-sach-tiki,115701940,"Giá MiCa Để Sách, iPad, Máy Tính",75000,75000,0,0
TIKI,nha-sach-tiki,3954355,"Yêu Những Điều Không Hoàn Hảo",99500,139000,39500,28
TIKI,nha-sach-tiki,121635154,"Điều Đẹp Nhất Có Khi Là Buông Tay (Tặng Kèm Bookmark)",51000,72000,21000,29
TIKI,nha-sach-tiki,117254517,"Đại Dương Đen - Những Câu Chuyện Từ Thế Giới Của Trầm Cảm",186000,240000,54000,23
TIKI,nha-sach-tiki,72882553,"Kỷ Luật Tự Giác (Tặng Kèm Bookmark )",58500,84000,25500,30
TIKI,nha-sach-tiki,46240929,"Rèn Luyện Tư Duy Phản Biện",68000,99000,31000,31
TIKI,nha-sach-tiki,121635152,"Không Ai Có Thể Làm Bạn Tổn Thương Trừ Khi Bạn Cho Phép (Tặng Kèm 1 Bộ Bookmark Gồm 4 Cái)",84000,119000,35000,29
TIKI,nha-sach-tiki,193151000,"Trend Following – Cách thức để kiếm được VẬN MAY LỚN và GIÀU CÓ trong các thị trường BÒ, GẤU và các sự kiện THIÊN NGA ĐEN",599000,599000,0,0
TIKI,nha-sach-tiki,192844861,"Combo 2 Cuốn Tôn Giáo - Tâm Linh: An Nhiên Như Nắng + Đi Gặp Mùa Xuân - Hành Trạng Thiền Sư Thích Nhất Hạnh",375000,375000,0,0
TIKI,nha-sach-tiki,157432544,"Giải Thích Ngữ Pháp Tiếng Anh (Với Bài Tập Và Đáp Án) (Tái Bản)",142000,220000,78000,35
TIKI,nha-sach-tiki,196515658,"Blue Period - Tập 04",43100,48000,4900,10
TIKI,nha-sach-tiki,117238177,"Thư Viện Nửa Đêm",115000,150000,35000,23
TIKI,nha-sach-tiki,147920903,"Một Thoáng Ta Rực Rỡ Ở Nhân Gian",100000,135000,35000,26
TIKI,nha-sach-tiki,194959173,"Semantic Error – Lỗi Logic (Tập 2)",194000,259000,65000,25
TIKI,nha-sach-tiki,72459686,"How Psychology Works - Hiểu Hết Về Tâm Lý Học",225000,300000,75000,25
TIKI,nha-sach-tiki,190861557,"Yêu Những Ngày Nắng Chẳng Ghét Những Ngày Mưa",106000,132000,26000,20
TIKI,nha-sach-tiki,8885999,"Totto - Chan Bên Cửa Sổ (Tái Bản)",67000,98000,31000,32
TIKI,nha-sach-tiki,170352283,"Đi Gặp Mùa Xuân - Hành Trạng Thiền Sư Thích Nhất Hạnh",305500,305500,0,0
TIKI,nha-sach-tiki,194960721,"Blue Period - Tập 03",34100,48000,13900,29
TIKI,nha-sach-tiki,111285062,"Đắc Nhân Tâm (Bìa Mềm)(Tái Bản)",62300,86000,23700,28
TIKI,nha-sach-tiki,195969664,"Tokyo Revengers - Tập 4",37000,115000,78000,68
TIKI,nha-sach-tiki,97594364,"Luật Tâm Thức - Giải Mã Ma Trận Vũ Trụ",226000,292000,66000,23
TIKI,nha-sach-tiki,197719874,"Suy Nghĩ Thống Kê Trong Đời Thường",105000,160000,55000,34
TIKI,nha-sach-tiki,3304875,"Điều Kỳ Diệu Của Tiệm Tạp Hóa NAMIYA (Tái Bản)",81400,105000,23600,22
TIKI,nha-sach-tiki,143217512,"Điềm Tĩnh Và Nóng Giận",69600,96000,26400,28
TIKI,nha-sach-tiki,68585576,"Càng Kỷ Luật, Càng Tự Do",79100,109000,29900,27
TIKI,nha-sach-tiki,106863963,"Tâm Lý Học - Phác Họa Chân Dung Kẻ Phạm Tội",105000,145000,40000,28
TIKI,nha-sach-tiki,85763211,"Hãy Khiến Tương Lai Biết Ơn Vì Hiện Tại Bạn Đã Cố Gắng Hết Mình (Tặng Kèm: 01 Bookmark)",68800,99000,30200,31
TIKI,nha-sach-tiki,10095276,"Ikigai - Bí Mật Sống Trường Thọ Và Hạnh Phúc Của Người Nhật",69700,90000,20300,23
TIKI,nha-sach-tiki,145288029,"Xứ Cát",186000,249000,63000,25
TIKI,nha-sach-tiki,173748415,"Tâm Lý Học Mối Quan Hệ",69200,98000,28800,29
TIKI,nha-sach-tiki,80628929,"Từ IQ Đến EQ - Nắm Bắt Thành Công Qua Trí Tuệ Cảm Xúc",63500,91000,27500,30
TIKI,nha-sach-tiki,147999778,"Không Bao Giờ Là Thất Bại - Tất Cả Là Thử Thách (Ấn Bản Cập Nhật Đầy Đủ Nhất)(Bìa Cứng)",141000,268000,127000,47
TIKI,nha-sach-tiki,138107485,"Mặt Dày Tâm Đen (Tái Bản)",109000,169000,60000,36
TIKI,nha-sach-tiki,91947689,"7 Thói Quen Hiệu Quả (The 7 Habits Of Highly Effective People) (Tái Bản)",191000,250000,59000,24
TIKI,nha-sach-tiki,195969669,"Chào Mừng Đến Lớp Học Đề Cao Thực Lực - 3",63000,120000,57000,48
TIKI,nha-sach-tiki,168293266,"Chiến Tranh Tiền Tệ - Phần 2 - Sự Thống Trị Của Quyền Lực Tài Chính ( Tái Bản 2022)",111000,170000,59000,35
TIKI,nha-sach-tiki,70016692,"Bắt Trẻ Đồng Xanh (Tái Bản 2020)",60000,88000,28000,32
TIKI,nha-sach-tiki,103640412,"Đừng Lựa Chọn An Nhàn Khi Còn Trẻ (Tái Bản)",69000,99000,30000,30
TIKI,nha-sach-tiki,174215347,"Ajin - Boxset Số 3 (Tập 13 - 17) - Tặng Kèm Bookmark 3D",192000,270000,78000,29
TIKI,nha-sach-tiki,197344439,"Kingdom - Tập 34",43600,45000,1400,3
TIKI,nha-sach-tiki,103379147,"Bạch Dạ Hành (Tái Bản)",156000,209000,53000,25
TIKI,nha-sach-tiki,74341297,"Không Sợ Chậm Chỉ Sợ Dừng",92400,129000,36600,28
TIKI,nha-sach-tiki,70224520,"Băng keo dán nano 2 mặt siêu dính trong suốt dày 1mm dài 2m rộng 3cm và 5cm",17999,17999,0,0
TIKI,nha-sach-tiki,72308265,"Hoa Vẫn Nở Mỗi Ngày",140400,234000,93600,40
TIKI,nha-sach-tiki,197344441,"Như Cơn Gió Thoảng - Nghĩ Về Những Qui Luật Cuộc Sống",80500,80500,0,0
TIKI,nha-sach-tiki,56454897,"Hiệu Sách Nhỏ Ở Paris",110000,149000,39000,26
TIKI,nha-sach-tiki,5067169,"Luật Hấp Dẫn (Tái Bản)",66300,89000,22700,26
TIKI,nha-sach-tiki,23416722,"How The Body Works - Hiểu Hết Về Cơ Thể",205000,300000,95000,32
TIKI,nha-sach-tiki,27582931,"How Money Works - Hiểu Hết Về Tiền",220000,300000,80000,27
TIKI,nha-sach-tiki,74362508,"Thần Số Học Ứng Dụng",78000,129000,51000,40
TIKI,nha-sach-tiki,184070223,"OSHO - Cảm Xúc",131000,188000,57000,30
TIKI,nha-sach-tiki,139303869,"Nghệ Thuật Tinh Tế Của Việc Đếch Quan Tâm (Tái Bản)",83000,128000,45000,35
TIKI,nha-sach-tiki,3608625,"Payback Time - Ngày Đòi Nợ",299000,299000,0,0
TIKI,nha-sach-tiki,195801662,"Ngôi Sao Vườn Nữ Sinh - Tập 1",49100,50000,900,2
TIKI,nha-sach-tiki,76013378,"Storytelling With Data - Kể Chuyện Thông Qua Dữ Liệu (Cuốn Cẩm Nang Hướng Dẫn Trực Quan Hóa Dữ Liệu)",222100,319000,96900,30
TIKI,nha-sach-tiki,7718737,"Nghệ Thuật Tư Duy Rành Mạch (Tái Bản)",85600,118000,32400,27
TIKI,nha-sach-tiki,8835159,"Đời Ngắn Đừng Ngủ Dài (Tái Bản)",62200,85000,22800,27
TIKI,nha-sach-tiki,157255752,"Sức Mạnh Của Hiện Tại (Tái Bản)",117000,168000,51000,30
TIKI,nha-sach-tiki,196923457,"Blue Flag - Tập 2",44100,45000,900,2
TIKI,nha-sach-tiki,194205608,"Cherry Magic - Tập 2",86500,109000,22500,21
TIKI,nha-sach-tiki,196016785,"Ikigami - Tập 08",40400,45000,4600,10
TIKI,nha-sach-tiki,82912488,"Từ Tốt Đến Vĩ Đại (Tái bản 2021)",75000,130000,55000,42
TIKI,nha-sach-tiki,140416370,"Dòng Chảy",167000,228000,61000,27
TIKI,nha-sach-tiki,127844385,"Kiêu Hãnh Và Định Kiến (Tái Bản)",86500,116000,29500,25
TIKI,nha-sach-tiki,72001057,"Chiến Tranh Tiền Tệ - Phần III",112000,175000,63000,36
TIKI,nha-sach-tiki,181699664,"Những Ngã Tư Và Những Cột Đèn",149000,200000,51000,26
TIKI,nha-sach-tiki,59262880,"Sách Người Bán Hàng Vĩ Đại Nhất Thế Giới (Tái Bản 2020)",103000,148000,45000,30
TIKI,nha-sach-tiki,148760924,"How Management Works - Hiểu Hết Về Quản Lý",242000,330000,88000,27
TIKI,nha-sach-tiki,192115858,"Chú Thuật Hồi Chiến -  Tập 5 - Giao Lưu Trường Kết Nghĩa Kyoto [Tặng Kèm Obi Và Thẻ Bo Góc Nhựa]",30000,30000,0,0
TIKI,nha-sach-tiki,58342212,"Set 3 cuốn Moi Moi và những người bạn - Dành cho trẻ từ 0-2 tuổi",75600,117000,41400,35
TIKI,nha-sach-tiki,273536931,"Kinh Doanh Thời Trang - 8 Bước Xây Dựng, Vận Hành Và Phát Triển Shop Quần Áo Của Bạn",155000,199000,44000,22
TIKI,nha-sach-tiki,180592885,"Combo 2Q: Mong Mẹ Hãy Yêu Lấy Chính Mình + Cơ Thể Tự Chữa Lành: Nước Ép Cần Tây",197500,197500,0,0
TIKI,nha-sach-tiki,184075874,"(Gift) Bút ký khắc tên cao cấp LC 010, đẹp, mực mịn đều ở mọi góc nghiêng",159000,159000,0,0
TIKI,nha-sach-tiki,113779037,"(Gift) Bút ký khắc tên cao cấp Doanh nhân LC014, mực bi, đều ở mọi góc nghiêng",299000,299000,0,0
TIKI,nha-sach-tiki,3639597,"Bước Chậm Lại Giữa Thế Gian Vội Vã (Tái Bản)",65000,85000,20000,24
TIKI,nha-sach-tiki,161008715,"Power Vs Force - Trường Năng Lượng Và Những Nhân Tố Quyết Định Hành Vi Của Con Người (Tái Bản)",128000,179000,51000,28
TIKI,nha-sach-tiki,272530379,"Bộ sách trở thành “ÁT CHỦ BÀI” công sở (Gồm 2 cuốn)",498000,498000,0,0
TIKI,nha-sach-tiki,54614797,"Có Một Ngày, Bố Mẹ Sẽ Già Đi",66700,96000,29300,31
TIKI,nha-sach-tiki,168283405,"Chiến Tranh Tiền Tệ - Phần 1 - Ai Thực Sự Là Người Giàu Nhất Thế Giới ( Tái Bản 2022)",106000,165000,59000,36
TIKI,nha-sach-tiki,113530805,"Tuổi Trẻ Đáng Giá Bao Nhiêu (Tái Bản)",61100,90000,28900,32
TIKI,nha-sach-tiki,161008717,"Kiếp Nào Ta Cũng Tìm Thấy Nhau: Câu Chuyện Về Những Linh Hồn Tri Kỷ Vĩnh Viễn Không Chia Lìa (Tái Bản)",66800,99000,32200,33
TIKI,nha-sach-tiki,271061349,"Cách đưa bạn trở thành siêu sao nơi công sở - How to Be the Employee Your Company Can't Live Without",249000,249000,0,0
TIKI,nha-sach-tiki,141739123,"Ruột bút kim loại 0.5 mm và 0.7 mm, mực mịn đều ở mọi góc nghiêng cầm bút",170000,170000,0,0
TIKI,nha-sach-tiki,78598381,"Tâm Lý Học Tính Cách (Tặng Kèm: 1 Bookmark)",76900,109000,32100,29
TIKI,nha-sach-tiki,12410166,"Bút ký Lộc phát 168 - Màu đen - 1 bộ Full box ruột đen",210000,210000,0,0
TIKI,nha-sach-tiki,115281323,"(Gift) Bút ký khắc tên cao cấp Doanh nhân LC048, mực mịn, đều ở mọi góc nghiêng",380000,380000,0,0
TIKI,nha-sach-tiki,104612965,"FLASHCARD SachID Moon",10000,10000,0,0
TIKI,nha-sach-tiki,216102104,"Bóng nhựa Arylic trong suốt đường kính 35 cm",1500000,1500000,0,0
TIKI,nha-sach-tiki,114937969,"Rừng Nauy (Tái Bản)",116000,150000,34000,23
TIKI,nha-sach-tiki,54266567,"Sách Nghĩ Giàu Và Làm Giàu (Bìa Mềm)",78000,110000,32000,29
TIKI,nha-sach-tiki,8885995,"Sự Im Lặng Của Bầy Cừu (Tái Bản)",85800,115000,29200,25
TIKI,nha-sach-tiki,71345381,"Sách Thay Đổi Cuộc Sống Với Nhân Số Học - Lê Đỗ Quỳnh Hương",181000,248000,67000,27
TIKI,nha-sach-tiki,184466860,"Hành Tinh Của Một Kẻ Nghĩ Nhiều",64000,86000,22000,26
TIKI,nha-sach-tiki,74158943,"Miễn phí khắc tên & Tặng kèm ống mực - Bút Kim Loại Cao Cấp BJ024W Eliteman Đẳng Cấp Tinh Hoa Phong Cách Bắc Âu",150000,150000,0,0
TIKI,nha-sach-tiki,53720978,"Trong Cái Không Có Gì Không ? (Thiền Sư Thích Nhất Hạnh Trả Lời Cho Trẻ Em Những Thắc Mắc Về Ý Nghĩa Cuộc Sống, Về Cái Chết, Về Gia Đình, Bạn Bè Và Nhiều Câu Hỏi Khác)",113000,160000,47000,29
TIKI,nha-sach-tiki,7833728,"Dạy Con Làm Giàu (Tập 1) - Để Không Có Tiền Vẫn Tạo Ra Tiền - Cha Giàu Cha Nghèo (Tái Bản)",49100,80000,30900,39
TIKI,nha-sach-tiki,197558905,"Komi - Nữ Thần Sợ Giao Tiếp - Tập 13",24800,25000,200,1
TIKI,nha-sach-tiki,92859698,"Tâm Lý Học Biểu Cảm",65500,98000,32500,33
TIKI,nha-sach-tiki,76388962,"Chúng Ta Rồi Sẽ Hạnh Phúc, Theo Những Cách Khác Nhau [Tặng Kèm: 01 Bookmark]",61400,86000,24600,29
TIKI,nha-sach-tiki,187338036,"Chiến Tranh Tiền Tệ - Tập 4",116700,185000,68300,37
TIKI,nha-sach-tiki,168373800,"Sách - Thao túng tâm lý - 1980BOOKS",118000,169000,51000,30
TIKI,nha-sach-tiki,75307228,"Sách OSHO Yêu - Being In Love - Yêu Trong Tỉnh Thức",116000,168000,52000,31
TIKI,nha-sach-tiki,19792256,"Chuyện Con Mèo Dạy Hải Âu Bay (Tái Bản 2019)",37200,49000,11800,24
TIKI,nha-sach-tiki,10005245,"Đàn Ông Sao Hỏa Đàn Bà Sao Kim",134000,188000,54000,29
TIKI,nha-sach-tiki,106185389,"Tổng ôn ngữ pháp Tiếng Anh cô Trang Anh- Sách luyện thi THPT Quốc gia môn tiếng anh",189000,250000,61000,24
TIKI,nha-sach-tiki,193614514,"[Gift] Tặng 01 bookmark cho mỗi đơn hàng",19500,30000,10500,35
TIKI,nha-sach-tiki,52788072,"Chiến Binh Cầu Vồng (Tái Bản 2020)",84500,109000,24500,22
TIKI,nha-sach-tiki,109505434,"Bạn Không Thông Minh Lắm Đâu (Tái Bản)(Tặng kèm Bookmark)",96800,139000,42200,30
TIKI,nha-sach-tiki,77774625,"Nghệ Thuật Tập Trung - Nâng Cao Năng Suất, Tối Ưu Thời Gian, Hiệu Quả Bất Ngờ",68800,99000,30200,31
TIKI,nha-sach-tiki,15267827,"Hoàng Tử Bé (Tái Bản 2019)",53000,75000,22000,29
TIKI,nha-sach-tiki,271405604,"Lịch bàn 2024 SDstationery From Yourself with Love, cảm hứng phát triển bản thân, tiếng Anh, minh họa đẹp 20x24x7,5",22000,110000,88000,80
TIKI,nha-sach-tiki,90622579,"Tâm Lý Học - Nghệ Thuật Giải Mã Hành Vi",96100,150000,53900,36
TIKI,nha-sach-tiki,69978860,"Sói đội lốt Cừu - Kẻ hiếu chiến ngầm và các thủ thuật thao túng tâm lí",75000,110000,35000,32
TIKI,nha-sach-tiki,113964351,"(Gift)Bút ký khắc tên cao cấp Doanh nhân 006, thép nguyên khối, mực bi đều ở mọi góc nghiêng",450000,450000,0,0
TIKI,nha-sach-tiki,106318762,"Sách ID Tiếng Anh cho người mới bắt đầu - người mới mất gốc Cô Trang Anh",159000,200000,41000,21
TIKI,nha-sach-tiki,193659018,"Combo 2 Cuốn: Dinh Dưỡng Học Bị Thất Truyền + Chế Độ Ăn Trường Thọ",268350,268350,0,0
TIKI,nha-sach-tiki,171556602,"2030: Những Xu Hướng Lớn Sẽ Định Hình Thế Giới Tương Lai (Tái Bản Lần 1)",155000,209000,54000,26
TIKI,nha-sach-tiki,57325187,"Sách Người Giàu Có Nhất Thành Babylon (Tái Bản 2020)",64500,98000,33500,34
TIKI,nha-sach-tiki,49747007,"Hai Mặt Của Gia Đình",68500,98000,29500,30
TIKI,nha-sach-tiki,4780917,"Người Đua Diều (Tái Bản 2018)",100000,129000,29000,22
TIKI,nha-sach-tiki,197344455,"Ikigami - The Ultimate Limit - Tuyển Tập Những Câu Chuyện Lay Động Lòng Người - Tập 9",45000,45000,0,0
TIKI,nha-sach-tiki,112110014,"TÂM LÝ HỌC ỨNG DỤNG",89800,129000,39200,30
TIKI,nha-sach-tiki,161310103,"Từ Vựng IELTS 8.0 - Từ Vựng Đắt Để Đạt Điểm Cao 4 Kỹ Năng",89000,135000,46000,34
TIKI,nha-sach-tiki,20917699,"Làm Sao Học Ít Hiểu Nhiều",82700,128000,45300,35
TIKI,nha-sach-tiki,196851308,"Dragon Ball Full Color - Phần Năm: Truy Lùng Cell Bọ Hung - Tập 4",76500,77000,500,1
TIKI,nha-sach-tiki,167972598,"Tôi Thích Bản Thân Nỗ Lực Hơn (Ấn Bản Kỷ Niệm)",84500,120000,35500,30
TIKI,nha-sach-tiki,107802183,"Sách Sức Mạnh Tiềm Thức (Tái Bản) (Bìa Mềm)",91700,128000,36300,28
TIKI,nha-sach-tiki,173882437,"8 Vụ Án Hoàn Hảo - Vạch Trần Tâm Lý Kẻ Phạm Tội",101000,145000,44000,30
TIKI,nha-sach-tiki,94173458,"Khuyến Học (Tái Bản)",47100,65000,17900,28
TIKI,nha-sach-tiki,120219394,"Tôi Nói Gì Khi Nói Về Chạy Bộ",53000,76000,23000,30
TIKI,nha-sach-tiki,192124399,"Blue Period Tập 2",34000,48000,14000,29
TIKI,nha-sach-tiki,173763072,"Tâm Lý Học Hẹn Hò - Nghệ Thuật Giao Tiếp Trong Tình Yêu",78000,109000,31000,28
TIKI,nha-sach-tiki,185067342,"Tô Bình Yên Vẽ Hạnh Phúc (Tái Bản)",62000,88000,26000,30
TIKI,nha-sach-tiki,179546672,"Làm Sao Học Hết Được Nhân Sinh",130000,169000,39000,23
TIKI,nha-sach-tiki,85396163,"Combo 2 Cuốn: Yêu Những Điều Không Hoàn Hảo + Bước Chậm Lại Giữa Thế Gian Vội Vã (Tái Bản)",165000,224000,59000,26
TIKI,nha-sach-tiki,194205620,"Người Hướng Nội Trong Thế Giới Hướng Ngoại",79000,105000,26000,25
TIKI,nha-sach-tiki,55605170,"Cơ Thể Tự Chữa Lành: Thực Phẩm Thay Đổi Cuộc Sống",119000,185000,66000,36
TIKI,nha-sach-tiki,108684605,"Trí Thông Minh Của Sự Tinh Tế",63600,89000,25400,29
TIKI,nha-sach-tiki,195187480,"Thiên Quan Tứ Phúc - Tập 6 (Tiểu thuyết, đam mỹ)",110700,159000,48300,30
TIKI,nha-sach-tiki,100931416,"Bắt Đầu Với Câu Hỏi Tại Sao - Nghệ Thuật Truyền Cảm Hứng Trong Kinh Doanh (Tái Bản)",78000,109000,31000,28
TIKI,nha-sach-tiki,540039,"Giáo Trình Chuẩn HSK 1 - Bài Học (Kèm file MP3)",149000,198000,49000,25
TIKI,nha-sach-tiki,163703151,"Chuyện Kể Rằng Có Nàng Và Tôi",51600,72000,20400,28
TIKI,nha-sach-tiki,13333355,"Đọc Nhiều Nhớ Được Bao Nhiêu?",76200,118000,41800,35
TIKI,nha-sach-tiki,197353399,"Học Viện Siêu Anh Hùng Vigilantes - My Hero Academia Illegals - Tập 1: Đã Có Ta Ở Đây",29000,30000,1000,3
TIKI,nha-sach-tiki,52329763,"Kafka bên bờ biển (Tái Bản 2020)",114000,158000,44000,28
TIKI,nha-sach-tiki,179735872,"Sách Tâm Lý Dành Cho Người Nhạy Cảm",62700,89000,26300,30
TIKI,nha-sach-tiki,154245455,"Combo 2 Cuốn Nghiền Từ Vựng Tiếng Anh: Học Qua Gốc Từ Bằng Hình Ảnh - Gốc Từ Là Bí Quyết Để Ghi Nhớ Hàng Nghìn Từ Vựng",177000,270000,93000,34
TIKI,nha-sach-tiki,3644267,"Đặc Quyền Của Gái Hư",61400,86000,24600,29
TIKI,nha-sach-tiki,71907876,"Từ Điển Tiếng “Em”",48200,69000,20800,30
TIKI,nha-sach-tiki,105483727,"Ổn Định Hay Tự Do",92400,129000,36600,28
TIKI,nha-sach-tiki,158019962,"Combo 3 Cuốn Bộ Sách: Nuôi Con Không Phải Là Cuộc Chiến 2 (Tái Bản)",262000,377000,115000,31
TIKI,nha-sach-tiki,8886007,"Ngàn Mặt Trời Rực Rỡ (Tái Bản)",99000,130000,31000,24
TIKI,nha-sach-tiki,76776245,"Nghệ Thuật Tư Duy Phản Biện",85900,129000,43100,33
TIKI,nha-sach-tiki,171549981,"Cuộc Diễu Hành Thầm Lặng",148000,198000,50000,25
TIKI,nha-sach-tiki,168234714,"Cư Xử Như Đàn Bà Suy Nghĩ Như Đàn Ông",78100,109000,30900,28
TIKI,nha-sach-tiki,195885688,"Dragon Quest - Dấu Ấn Roto (Dragon Quest Saga Emblem Of Roto) Perfect Edition - Tập 9",74100,75000,900,1
TIKI,nha-sach-tiki,273624916,"[ Trạm Đọc Official ]  Trí Tuệ Do Thái (Tái Bản)",142000,189000,47000,25
TIKI,nha-sach-tiki,196422809,"Bá Tước Tiểu Thư - Tập 3",30000,30000,0,0
TIKI,nha-sach-tiki,124767703,"Cân Bằng Cảm Xúc Cả Lúc Bão Giông (Tặng Kèm Bookmark)(Tái Bản)",67100,105000,37900,36
TIKI,nha-sach-tiki,196409700,"Công Chúa Ma Cà Rồng Quyền Năng Chỉ Muốn Có Một Người Em Gái Mà Thôi",147000,175000,28000,16
TIKI,nha-sach-tiki,105663942,"Hành Trình Về Phương Đông (Tái Bản 2021)",83000,118000,35000,30
TIKI,nha-sach-tiki,191920180,"Cherry Magic - Tập 1",86500,109000,22500,21
TIKI,nha-sach-tiki,149089470,"Những Vị Thần Nước Mỹ",187000,250000,63000,25
TIKI,nha-sach-tiki,139567621,"Thức Tỉnh Mục Đích Sống (Tái Bản)",98000,148000,50000,34
TIKI,nha-sach-tiki,126743459,"Fear - Sợ Hãi (Hóa Giải Sợ Hãi Bằng Tình Thương)",76100,109000,32900,30
TIKI,nha-sach-tiki,185071145,"Sói Đầu Đàn Và Cún Nhỏ - Tập 2",105000,135000,30000,22
TIKI,nha-sach-tiki,194960238,"Slam Dunk - Deluxe Edition - Tập 10",55000,60000,5000,8
TIKI,nha-sach-tiki,35191892,"21 Bài Học Cho Thế Kỷ 21",162000,209000,47000,22
TIKI,nha-sach-tiki,104741661,"Combo 2 Tập : 999 Lá Thư Gửi Cho Chính Mình (Tái Bản)",193000,258000,65000,25
TIKI,nha-sach-tiki,14508205,"Sổ tay thực hành 66 ngày thử thách",89000,89000,0,0
TIKI,nha-sach-tiki,197781975,"Dr.Slump Ultimate Edition Tập 12",59500,60000,500,1
TIKI,nha-sach-tiki,196016781,"Kingdom - Tập 33",42000,45000,3000,7
TIKI,nha-sach-tiki,167210779,"Quyền Lực",111000,155000,44000,28
TIKI,nha-sach-tiki,54422942,"Tôi Quyết Định Sống Cho Chính Tôi (Tái Bản 2020)",59400,88000,28600,33
TIKI,nha-sach-tiki,152740748,"Lối Sống Tối Giản Của Người Nhật (Tái Bản)",85200,119000,33800,28
TIKI,nha-sach-tiki,12377498,"Bố Con Cá Gai (Tái Bản 2019)",73900,96000,22100,23
TIKI,nha-sach-tiki,77105730,"Tàn Ngày Để Lại (Bìa Cứng)",126000,169000,43000,25
TIKI,nha-sach-tiki,3608623,"Bí Mật Của Phan Thiên Ân",69000,69000,0,0
TIKI,nha-sach-tiki,57110087,"Siêu Cò – How To Be A Power Connector",249000,249000,0,0
TIKI,nha-sach-tiki,57762732,"Nhà Đầu Tư Thông Minh (Tái Bản 2020)",154000,199000,45000,23
TIKI,nha-sach-tiki,170708233,"Thay Đổi Tí Hon - Hiệu Quả Bất Ngờ (Tái Bản)",140000,189000,49000,26
TIKI,nha-sach-tiki,195190105,"Color Rush - Bản Thông Thường",224000,265000,41000,15
TIKI,nha-sach-tiki,54748899,"Sách Muôn Kiếp Nhân Sinh (Bìa Mềm) - Nguyên Phong",118000,168000,50000,30
TIKI,nha-sach-tiki,196515661,"Văn Phòng Thám Tử Quái Vật - Tập 12",23500,30000,6500,22
TIKI,nha-sach-tiki,196851310,"Migi & Dali - Tập 2",39000,40000,1000,3
TIKI,nha-sach-tiki,187827003,"Không Diệt Không Sinh Đừng Sợ Hãi (TB5)",75000,110000,35000,32
TIKI,nha-sach-tiki,53532186,"Tuyệt kỹ Giao dịch bằng đồ thị nến Nhật – Japanese Candlestick Charting Techniques",499000,499000,0,0
TIKI,nha-sach-tiki,196923451,"Vua Sáng Chế - Tập 17",20000,20000,0,0
TIKI,nha-sach-tiki,110448022,"Ba Phút Sơ Cứu",104000,140000,36000,26
TIKI,nha-sach-tiki,158019964,"Combo 4 Cuốn Bộ Sách: Nuôi Con Không Phải Là Cuộc Chiến (Tái Bản)",350300,506000,155700,31
TIKI,nha-sach-tiki,185242031,"The Shining - Thị Kiến",200000,269000,69000,26
TIKI,nha-sach-tiki,50414368,"Án Mạng Mười Một Chữ",75400,110000,34600,31
TIKI,nha-sach-tiki,87226756,"Những Đêm Không Ngủ, Những Ngày Chậm Trôi",56000,86000,30000,35
TIKI,nha-sach-tiki,191571494,"Black Jack - Tập 12",30000,30000,0,0
TIKI,nha-sach-tiki,183058543,"OSHO - Trưởng Thành",89100,128000,38900,30
TIKI,nha-sach-tiki,90887853,"Mình Chỉ Là Người Bình Thường (Sách Tô Màu)",97500,138000,40500,29
TIKI,nha-sach-tiki,162844699,"Tạm Biệt Tôi Của Nhiều Năm Về Trước",67800,95000,27200,29
TIKI,nha-sach-tiki,750578,"Khi Hơi Thở Hóa Thinh Không",74000,109000,35000,32
TIKI,nha-sach-tiki,73878873,"Tư Duy Sâu",64100,91000,26900,30
TIKI,nha-sach-tiki,17336360,"Lolita (Tái Bản 2019)",92900,128000,35100,27
TIKI,nha-sach-tiki,378448,"Nhà Giả Kim",66950,66950,0,0
TIKI,nha-sach-tiki,115266692,"Sách - Ám Ảnh Sợ Xã Hội - Chạy Trốn Hay Đối Mặt",82900,125000,42100,34
TIKI,nha-sach-tiki,45902241,"Tìm Mình Trong Thế Giới Hậu Tuổi Thơ",106000,142000,36000,25
TIKI,nha-sach-tiki,196515664,"Anh Em Phi Hành Gia - Tập 33",44500,45000,500,1
TIKI,nha-sach-tiki,84970841,"Men Chase Women Choose - Chuyện Tình Yêu Bạn Biết Được Bao Nhiêu?",73600,109000,35400,32
TIKI,nha-sach-tiki,145289356,"Sách Atomic Habits - Thay Đổi Tí Hon, Hiệu Quả Bất Ngờ ( Những Thay Đổi Nhỏ Tạo Nên Thành Công Lớn/ Tặng kèm Bookmark)",160000,189000,29000,15
TIKI,nha-sach-tiki,9948009,"Dám Hạnh Phúc",78100,110000,31900,29
TIKI,nha-sach-tiki,641906,"Bí Mật Của Naoko",78900,108000,29100,27
TIKI,nha-sach-tiki,128649312,"21 Nguyên Tắc Tự Do Tài Chính (Tái Bản)",38000,55000,17000,31
TIKI,nha-sach-tiki,100321478,"Muốn An Được An (Tái bản 2021)",43000,65000,22000,34
TIKI,nha-sach-tiki,186237324,"Thiên quan tứ phúc - Tập 5 (Tiểu thuyết đam mỹ) - Tặng kèm 1 bookmark 2 mặt",110700,159000,48300,30
TIKI,nha-sach-tiki,173865570,"Một Cuốn Sách Về Chủ Nghĩa Tối Giản (Tái bản 2022)",129000,129000,0,0
TIKI,nha-sach-tiki,179546078,"Luật Hấp Dẫn - Quy Luật Về Sức Mạnh Tâm Trí Và Phát Huy Năng Lượng Tích Cực Để Làm Chủ Định Mệnh",81500,139000,57500,41
TIKI,nha-sach-tiki,86517373,"Khoa Học Về Nấu Ăn - The Science Of Cooking",267000,350000,83000,24
TIKI,nha-sach-tiki,197990865,"Dragon Quest - Dấu Ấn Roto (Dragon Quest Saga Emblem Of Roto) Perfect Edition - Tập 10",73800,75000,1200,2
TIKI,nha-sach-tiki,104074997,"Kỹ Năng Bán Hàng Tuyệt Đỉnh (Tái Bản)",77500,120000,42500,35
TIKI,nha-sach-tiki,2496281,"Đồi Gió Hú (Tái Bản)",80500,108000,27500,25
TIKI,nha-sach-tiki,73515859,"Sách OSHO - Can Đảm Là Chính Mình Trong Thế Giới Hiểm Nguy",61100,88000,26900,31
TIKI,nha-sach-tiki,145288026,"Chia Rẽ - Tại Sao Chúng Ta Đang Sống Trong Thời Đại Của Những Bức Tường",149000,200000,51000,26
TIKI,nha-sach-tiki,11122712,"Bộ sách Làm Giàu Từ Chứng Khoán (How To Make Money In Stock) phiên bản mới + Hướng Dẫn Thực Hành CANSLIM Cho Người Mới Bắt Đầu",700000,700000,0,0
TIKI,nha-sach-tiki,179063952,"Khi Mọi Điểm Tựa Đều Mất",65200,98000,32800,33
TIKI,nha-sach-tiki,11368965,"Combo Giáo Trình Chuẩn HSK 1 - Bài Học (Kèm 1 MP3) và Giáo Trình Chuẩn HSK 1 - Bài Tập (Kèm 1 MP3) ( Tặng Kèm Viết )",284800,356000,71200,20
TIKI,nha-sach-tiki,7982628,"Suối Nguồn (Tái Bản)",229000,380000,151000,40
TIKI,nha-sach-tiki,52584834,"Tư Duy Hệ Thống Trong Công Việc",61000,89000,28000,31
TIKI,nha-sach-tiki,106864418,"Combo 10 Cuốn: Chuyện Xóm Gà",409000,580000,171000,29
TIKI,nha-sach-tiki,130233544,"Mèo Và Triết Lý Nhân Sinh - Mèo Đã Dạy Chúng Ta Điều Gì Về Cuộc Sống",145500,209000,63500,30
TIKI,nha-sach-tiki,194104216,"Văn Phòng Thám Tử Quái Vật - Tập 11",29100,30000,900,3
TIKI,nha-sach-tiki,35283863,"Lược Sử Thế Giới",219000,320000,101000,32
TIKI,nha-sach-tiki,179546070,"Luật Hấp Dẫn - Quy Luật Về Sức Mạnh Của Linh Hồn Và Năng Lượng Chữa Lành Cơ Thể Từ Bên Trong",85900,129000,43100,33
TIKI,nha-sach-tiki,102629318,"999 Lá Thư Gửi Cho Chính Mình (*) - Tập 1 - Mong Bạn Trở Thành Phiên Bản Hoàn Hảo Nhất (Tái bản)",92400,129000,36600,28
TIKI,nha-sach-tiki,168559521,"Sự Trung Thực Của Xác Chết – Ghi Chép Của Một Nhà Pháp Y",68800,99000,30200,31
TIKI,nha-sach-tiki,191782162,"Trên Đường Băng (Tony Buổi Sáng)",71500,105000,33500,32
TIKI,nha-sach-tiki,73316977,"Hành Trình Của Linh Hồn (Tái Bản 2020)",89800,129000,39200,30
TIKI,nha-sach-tiki,66090079,"Cơ Thể Tự Chữa Lành: Giải Cứu Gan",161000,250000,89000,36
TIKI,nha-sach-tiki,540040,"Giáo Trình Chuẩn HSK 1 - Bài Tập (Kèm file MP3)",119000,158000,39000,25
TIKI,nha-sach-tiki,193434490,"Ikigami - Tập 07",32000,45000,13000,29
TIKI,nha-sach-tiki,194960244,"Fullmetal Alchemist - Cang Giả Kim Thuật Sư - Fullmetal Edition - Tập 16",63000,69000,6000,9
TIKI,nha-sach-tiki,196515668,"Quán Rượu Dị Giới "Nobu" - Tập 11",35000,40000,5000,13
TIKI,nha-sach-tiki,155550591,"Dinh Dưỡng Học Bị Thất Truyền - Dinh Dưỡng Đẩy Lùi Bệnh Tật",115000,178000,63000,35
TIKI,nha-sach-tiki,828621,"Dolocher (Trinh Thám)",44000,159000,115000,72
TIKI,nha-sach-tiki,56692532,"Tôi Từng Nghĩ Mọi Thứ Sẽ Ổn Khi Trở Thành Người Lớn (Tặng Kèm 1 Bookmark)",66500,96000,29500,31
TIKI,nha-sach-tiki,21130350,"Vụ Án LEROUGE (Trinh Thám)",79000,168000,89000,53
TIKI,nha-sach-tiki,174842858,"Sách Sức Mạnh Của Ngôn Từ (Tái Bản 2022)",75100,108000,32900,30
TIKI,nha-sach-tiki,126743464,"Kế Hoạch Của Linh Hồn - Khám Phá Ý Nghĩa Cuộc Sống Mà Bạn Đã Lên Kế Hoạch Trước Khi Sinh Ra",117000,169000,52000,31
TIKI,nha-sach-tiki,176909221,"Ngôi Nhà Bên Bờ Biển Xanh Thẳm",124000,174000,50000,29
TIKI,nha-sach-tiki,2429811,"Tư Duy Phản Biện",56100,85000,28900,34
TIKI,nha-sach-tiki,130996082,"Bồ Câu Bay Đi Tìm Bà",56100,77000,20900,27
TIKI,nha-sach-tiki,52785564,"Dịch Hạch (Nobel Văn Chương 1957)",93700,129000,35300,27
TIKI,nha-sach-tiki,111580006,"Sách Muôn Kiếp Nhân Sinh 2 (Khổ Nhỏ) - Nguyên Phong",86000,148000,62000,42
TIKI,nha-sach-tiki,22881852,"English Grammar in Use Book w Ans",160200,198000,37800,19
TIKI,nha-sach-tiki,195357772,"Máy Tính CASIO FX-880BTG - Màu Đen",696000,800000,104000,13
TIKI,nha-sach-tiki,11371249,"Chuyện Con Mèo Và Con Chuột Bạn Thân Của Nó - Tái Bản",30100,39000,8900,23
TIKI,nha-sach-tiki,159004131,"Semantic Error – Lỗi Logic (Tập 1) - Bản thường (Tặng Kèm 01 Bookmark + 01 Postcard)",183000,259000,76000,29
TIKI,nha-sach-tiki,147988185,"Combo 2 Cuốn "Hiểu Hết" : How Business Works - Hiểu Hết Về Kinh Doanh + How Money Works - Hiểu Hết Về Tiền",469000,680000,211000,31
TIKI,nha-sach-tiki,52805060,"Chúa Ruồi - Tiểu Thuyết (Nobel Văn Chương 1983)(Tái Bản 2020)",63700,88000,24300,28
TIKI,nha-sach-tiki,160997378,"Giải Thích Ngữ Pháp Tiếng Anh Với Bài Tập Và Đáp Án (TB 2022) - Tác giả Mai Lan Hương, Hà Thanh Uyên",165000,220000,55000,25
TIKI,nha-sach-tiki,25557704,"Bãi săn người - Trinh Thám Kinh Dị",62000,162000,100000,62
TIKI,nha-sach-tiki,190238356,"Kỷ Luật Bản Thân",125000,189000,64000,34
TIKI,nha-sach-tiki,95218451,"Lần Đầu Làm Mẹ - Tổng Hợp Những Kiến Thức Mới Nhất Về Mang Thai Và Sinh Nở (Tái Bản)",176000,260000,84000,32
TIKI,nha-sach-tiki,57761618,"Vụ Án Mạng Ở Lữ Quán Kairotei",84100,123000,38900,32
TIKI,nha-sach-tiki,193411736,"Anh Em Nhà Motohashi - Tập 2",52000,68000,16000,24
TIKI,nha-sach-tiki,1926761,"Khởi Nghiệp Bán Lẻ - Bí Quyết Thành Công Và Giàu Có Bằng Những Cửa Hàng Đông Khách - Công Thức Kinh Doanh Và Quản Lý Cửa Hàng Hiệu Quả",125000,199000,74000,37
TIKI,nha-sach-tiki,50751279,"Vui Vẻ Không Quạu Nha - Tản Văn",49200,69000,19800,29
TIKI,nha-sach-tiki,164336673,"How The Brain Works - Hiểu Hết Về Bộ Não",264000,330000,66000,20
TIKI,nha-sach-tiki,14053724,"Sự Cứu Rỗi Của Thánh Nữ",94200,128000,33800,26
TIKI,nha-sach-tiki,195649312,"Trí Tuệ Do Thái  (Tái Bản 2022)",137000,189000,52000,28
TIKI,nha-sach-tiki,162205263,"Những Đồ Vật Có Linh Hồn - Bản Thường (Tặng Kèm 1 Bookmark)",106000,149000,43000,29
TIKI,nha-sach-tiki,79672197,"Bí Mật Của May Mắn (Khổ Nhỏ)(Tái Bản)",32100,45000,12900,29
TIKI,nha-sach-tiki,157240665,"Ra Bờ Suối Ngắm Hoa Kèn Hồng (Truyện Dài-Nguyễn Nhật Ánh) - Bìa Mềm (Màu Hồng) (Tặng Kèm Bookmark Bồi Hai Mặt, Thiệp Trái Tim In Bài Thơ Của Tác Giả)",97400,145000,47600,33
TIKI,nha-sach-tiki,193433626,"Kỹ năng tự học cho trẻ tiểu học",142000,199000,57000,29
TIKI,nha-sach-tiki,66619715,"Sách Vị Tu Sĩ Bán Chiếc Ferrari (Tái Bản)",68100,98000,29900,31
TIKI,nha-sach-tiki,66067655,"Trải Nghiệm Khách Hàng Xuất Sắc",181000,250000,69000,28
TIKI,nha-sach-tiki,137741275,"Ngỡ Như Lương Thiện, Hóa Ra Mềm Yếu",93000,125000,32000,26
TIKI,nha-sach-tiki,3976835,"Velma - Trinh Thám Cổ Điển Phương Tây",49500,99000,49500,50
TIKI,nha-sach-tiki,187190676,"Black Jack - Tập 11",30000,30000,0,0
TIKI,nha-sach-tiki,195885685,"Vua Sáng Chế -  Tập 16",20000,20000,0,0
TIKI,nha-sach-tiki,141333746,"Chúng Ta Học Thế Nào - How We Learn (Sự Thật Khó Tin Về Việc Học Nó Diễn Ra Khi Nào, Ở Đâu , Và Tại Sao)",112000,150000,38000,25
TIKI,nha-sach-tiki,85029033,"Truyện Cổ Grimm (Ấn Bản Đầy Đủ Nhất Kèm 184 Minh Hoạ Của Philipp Grot Johann Và Robert Leinweber)",446000,680000,234000,34
TIKI,nha-sach-tiki,196923452,"Birdmen - Tập 7",30000,30000,0,0
TIKI,nha-sach-tiki,143186001,"Chiến Thắng Con Quỷ Trong Bạn - Bí Quyết Tự Do Và Thành Công (Tái Bản)",82300,115000,32700,28
TIKI,nha-sach-tiki,70016690,"Thế Giới Rộng Lớn Lòng Người Chật Hẹp (Tặng Kèm 1 Bookmark )",62100,92000,29900,33
TIKI,nha-sach-tiki,67271338,"Sách OSHO - Trò Chuyện Với Vĩ Nhân",135000,198000,63000,32
TIKI,nha-sach-tiki,108501279,"Viết Đi Đừng Sợ! Từ Tay Không Thành Tay Viết",188000,245000,57000,23
TIKI,nha-sach-tiki,160081250,"Tăng Cường Sức Mạnh Não Bộ",95500,120000,24500,20
TIKI,nha-sach-tiki,69644752,"Toàn Thư Chiêm Tinh Học Nhập Môn",226000,350000,124000,35
TIKI,nha-sach-tiki,186286187,"Nhà Lãnh Đạo Không Chức Danh",68000,105000,37000,35
TIKI,nha-sach-tiki,100931414,"Cách Khen Cách Mắng Cách Phạt Con (Tái Bản)",47800,69000,21200,31
TIKI,nha-sach-tiki,13419678,"Sách Đi Tìm Lẽ Sống (Tái Bản )",61100,88000,26900,31
TIKI,nha-sach-tiki,195801644,"Black Jack - Tập 13 (Bìa Cứng)",128000,135000,7000,5
TIKI,nha-sach-tiki,104314401,"Sách Bí Mật Của May Mắn (Khổ Lớn) (Tái Bản)",46100,68000,21900,32
TIKI,nha-sach-tiki,193988323,"Sa Vào Ánh Hào Quang Của Người – Tập 2",113000,138000,25000,18
TIKI,nha-sach-tiki,52597663,"Đừng Chạy Theo Số Đông - Cuốn Sách Bạn Cần Đọc Trước Khi Quá Muộn",129000,200000,71000,36
TIKI,nha-sach-tiki,184070221,"Sách OSHO Hiểu - Đường Đến Tự Do",117000,168000,51000,30
TIKI,nha-sach-tiki,13624088,"Nghĩ Thiện Để Cuộc Đời Và Công Việc Viên Mãn",51000,85000,34000,40
TIKI,nha-sach-tiki,7916685,"All The Rule - Bình Tĩnh Khi Ế, Mạnh Mẽ Khi Yêu",60600,86000,25400,30
TIKI,nha-sach-tiki,1938915,"Sự Tiếp Xúc Của Văn Hóa Việt Nam Với Pháp",81650,109000,27350,25
TIKI,nha-sach-tiki,100958457,"Gieo Trồng Hạnh Phúc (Tái Bản)",61800,89000,27200,31
TIKI,nha-sach-tiki,198016656,"Blue Flag - Tập 3",44100,45000,900,2
TIKI,nha-sach-tiki,170297937,"Tâm Lý Học Về Sự Lo Âu",95100,129000,33900,26
TIKI,nha-sach-tiki,90469338,"Combo 5 cuốn: Cơ Thể Tự Chữa Lành",594000,923000,329000,36
TIKI,nha-sach-tiki,113540576,"Hảo Nữ Trung Hoa",101000,128000,27000,21
TIKI,nha-sach-tiki,129381090,"Minh Triết Trong Đời Sống (Tái Bản)",71100,108000,36900,34
TIKI,nha-sach-tiki,32155084,"Combo 25 Chuyên đề ngữ pháp tiếng anh trọng tâm ( trọn bộ tập 1+2 )",148000,230000,82000,36
TIKI,nha-sach-tiki,45321594,"Nghệ Thuật Bán Hàng Của Người Hướng Nội",88800,119000,30200,25
TIKI,nha-sach-tiki,48481763,"Thiên Nga Đen (Tái Bản 2020)",190400,299000,108600,36
TIKI,nha-sach-tiki,143172597,"2000 English Collocation and Idioms",119000,200000,81000,41
TIKI,nha-sach-tiki,44433397,"Yêu Mình Trước Đã, Yêu Đời Để Sau",75800,109000,33200,30
TIKI,nha-sach-tiki,160759005,"Cơ Thể Tự Chữa Lành - Thanh Lọc Để Phục Hồi",190000,295000,105000,36
TIKI,nha-sach-tiki,145287904,"Sách - Giận (Tái Bản 2021)(Cuốn sách hay của Thiền sư Thích Nhất Hạnh/ Tặng kèm Bookmark)",128650,128650,0,0
TIKI,nha-sach-tiki,168576295,"Mình Phải Sống Như Biển Rộng Sông Dài",77300,109000,31700,29
TIKI,nha-sach-tiki,100931418,"Giao Tiếp Bất Kỳ Ai - 101 Cách Nâng Cao Khả Năng Giao Tiếp (Tái Bản)",37800,55000,17200,31
TIKI,nha-sach-tiki,184774173,"Những Người Nhật Tử Tế",96000,148000,52000,35
TIKI,nha-sach-tiki,136143567,"Thần Số Học",146000,219000,73000,33
TIKI,nha-sach-tiki,49910019,"Bác Sĩ Riêng Của Bé Yêu - Chào Con! Ba Mẹ Đã Sẵn Sàng (Tái Bản)",66000,95000,29000,31
TIKI,nha-sach-tiki,145288031,"Tarot Toàn Thư - Đọc Vận Mệnh Qua Những Lá Bài",244000,380000,136000,36
TIKI,nha-sach-tiki,153045603,"Sách Người Giỏi Không Phải Là Người Làm Tất Cả (Tái Bản 2021)",40000,58000,18000,31
TIKI,nha-sach-tiki,155683832,"túi đựng card visit - JL",5000,5000,0,0
TIKI,nha-sach-tiki,119694726,"Combo 6 cuốn Ehon Kích thích thị giác - Âm thanh cho Trẻ sơ sinh",121680,234000,112320,48
TIKI,nha-sach-tiki,17719702,"Một Thế Giới Không Có Đàn Bà (Trinh Thám Việt Nam)",98000,142000,44000,31
TIKI,nha-sach-tiki,50723822,"Con Đường Đi Đến Thành Công Bằng Sự Tử Tế (Tái Bản 2020)",48000,70000,22000,31
TIKI,nha-sach-tiki,160081252,"Người Tan Làm Sau Cùng Là Người Nghỉ Việc Đầu Tiên (Tặng kèm bookmark)",84000,119000,35000,29
TIKI,nha-sach-tiki,179063564,"Tôi Tự Học",79000,120000,41000,34
TIKI,nha-sach-tiki,54051752,"Bộ Ba Quái Hiệp (Trinh Thám)",69000,138000,69000,50
TIKI,nha-sach-tiki,148802202,"How Philosophy Works - Hiểu Hết Về Triết Học",246000,330000,84000,25
TIKI,nha-sach-tiki,197634252,"Văn phòng thám tử quái vật - Tập 13",25900,30000,4100,14
TIKI,nha-sach-tiki,195357776,"Máy Tính CASIO FX-880BTG - Màu Hồng",742000,800000,58000,7
TIKI,nha-sach-tiki,96357336,"Cáo Pax",85100,116000,30900,27
TIKI,nha-sach-tiki,197781977,"Yu-Gi-Oh! Gx Tập 1: “Người Hùng Mới” Lộ Diện",29500,30000,500,2
TIKI,nha-sach-tiki,182548592,"Thiên Sứ Nhà Bên – Tập 3",70000,95000,25000,26
TIKI,nha-sach-tiki,1080002,"Boxset Harry Potter - Tiếng Việt (Trọn Bộ 7 Tập)",1199000,1750000,551000,31
TIKI,nha-sach-tiki,48323805,"Sách Người trong muôn nghề",169000,189000,20000,11
TIKI,nha-sach-tiki,100947274,"Tìm Bình Yên Trong Gia Đình (Tái Bản)",68800,99000,30200,31
TIKI,nha-sach-tiki,197353391,"Ninja Rantaro - Tập 61",39000,40000,1000,3
TIKI,nha-sach-tiki,274404957,"Montessori – Phương Pháp Giáo Dục Toàn Diện Cho Trẻ 0-6 Tuổi",81100,81100,0,0
TIKI,nha-sach-tiki,243358535,"Squid Game Móc khoá - Móc khoá Silicon 5cm-SQ1",10000,20000,10000,50
TIKI,nha-sach-tiki,179952621,"Hành Trình Tarot (Tái Bản 2022)",107000,149000,42000,28
TIKI,nha-sach-tiki,196944533,"Tài chính doanh nghiệp for Dummies",166000,239000,73000,31
TIKI,nha-sach-tiki,171057415,"Cẩm nang hướng dẫn tự học tiếng Thái – trình độ sơ cấp – trung cấp",98000,98000,0,0
TIKI,nha-sach-tiki,80657321,"Cơ Thể Tự Chữa Lành: Phục Hồi Tuyến Giáp",116000,180000,64000,36
TIKI,nha-sach-tiki,50475521,"Sách Đánh Thức Con Người Phi Thường Trong Bạn",97000,168000,71000,42
TIKI,nha-sach-tiki,161245852,"Giải Thích Ngữ Pháp Tiếng Anh (Tái Bản 2022)",176000,220000,44000,20
TIKI,nha-sach-tiki,90056907,"Khởi Nghiệp Tinh Gọn (The Lean Startup) (Tái Bản)",129000,165000,36000,22
TIKI,nha-sach-tiki,626886,"Những Tấm Lòng Cao Cả",53100,80000,26900,34
TIKI,nha-sach-tiki,187622420,"The Art and Science of Technical Analysis – Phân tích kỹ thuật: Sự kết hợp giữa KHOA HỌC và NGHỆ THUẬT trong đầu tư chứng khoán",569000,569000,0,0
TIKI,nha-sach-tiki,147058065,"Phi Lý Trí - Khám Phá Những Động Lực Vô Hình Ẩn Sau Những Quyết Định Của Con Người ( Tái Bản)",110000,169000,59000,35
TIKI,nha-sach-tiki,194104232,"Anh Em Phi Hành Gia - Tập 32",42300,45000,2700,6
TIKI,nha-sach-tiki,178483637,"Nước Ép Trị Liệu Và Chế Độ Ăn Theo Phương Pháp Cơ Thể Tự Chữa Lành",142000,199000,57000,29
TIKI,nha-sach-tiki,191148794,"Tôi Ước Mình Chưa Từng Được Sinh Ra -Tặng kèm 1 bookmark",63000,90000,27000,30
TIKI,nha-sach-tiki,81323246,"90-20-30 90 Bài Học Vỡ Lòng Về Ý Tưởng Và Câu Chữ (Bản Đen Trắng)",149000,195000,46000,24
TIKI,nha-sach-tiki,57870426,"Sức Mạnh Của Ngôn Từ (Tặng Kèm 1 Photocard Mintbooks Limited)",64500,96000,31500,33
TIKI,nha-sach-tiki,115478654,"Keo Siêu Dính Đa Năng Mạnh Gấp 80 Keo 502 Dán Sắt, Dán Đá, Dán Nhựa, Dán Gỗ",39000,39000,0,0
TIKI,nha-sach-tiki,110448020,"Nhà Ảo Thuật Đen Và Vụ Án Mạng Tại Thị Trấn Không Tên",154000,199000,45000,23
TIKI,nha-sach-tiki,3737963,"Bức Xúc Không Làm Ta Vô Can (Tái Bản)",63300,85000,21700,26
TIKI,nha-sach-tiki,186091870,"Fullmetal Alchemist - Cang Giả Kim Thuật Sư - Fullmetal Edition Tập 15 [Tặng Kèm Bookmark PVC]",62100,69000,6900,10
TIKI,nha-sach-tiki,113655533,"Giáo Trình Chủ Nghĩa Xã Hội Khoa Học (Dành Cho Bậc Đại Học Hệ Không Chuyên Lý Luận Chính Trị) - Bộ mới năm 2021",58000,58000,0,0
TIKI,nha-sach-tiki,125528587,"Thần Với Chả Thoại (Những Câu Chuyện "Mệt Mỏi" Về Các Vị Thần)",85000,139000,54000,39
TIKI,nha-sach-tiki,58695343,"Kỹ Năng Giao Tiếp Đỉnh Cao",66500,96000,29500,31
TIKI,nha-sach-tiki,176550321,"Bàn Về Ham Muốn: Tại Sao Chúng Ta Muốn Thứ Mà Ta Muốn",121000,169000,48000,28
TIKI,nha-sach-tiki,162181800,"Cảm Ơn Anh Đã Đánh Mất Em - Bản Thường (Tặng Kèm 2 postcard)",70000,99000,29000,29
TIKI,nha-sach-tiki,87959748,"451 Độ F",73800,99000,25200,25
TIKI,nha-sach-tiki,194104631,"Mong Bạn Đừng Khóc Một Mình",65500,88000,22500,26
TIKI,nha-sach-tiki,195649281,"Đọc Vị Tâm Lý Hành Vi Của Giới Giàu Và Siêu Giàu",223000,299000,76000,25
TIKI,nha-sach-tiki,193433863,"101 Lời Khuyên Tài Chính Cá Nhân Từ Thái Phạm",299000,299000,0,0
TIKI,nha-sach-tiki,193434488,"Kingdom -  Tập 32",32600,45000,12400,28
TIKI,nha-sach-tiki,168662171,"Vừa Nhắm Mắt Vừa Mở Cửa Số",52000,75000,23000,31
TIKI,nha-sach-tiki,69644748,"Thiền Sư Và Em Bé 5 Tuổi",67100,120000,52900,44
TIKI,nha-sach-tiki,71090268,"Ám Ảnh Từ Kiếp Trước - Bí Mật Của Sự Sống Và Cái Chết (Tái Bản 2020)",58100,89000,30900,35
TIKI,nha-sach-tiki,67491398,"Sách OSHO Từ Bi - Compassion",89100,128000,38900,30
TIKI,nha-sach-tiki,40933969,"Một Đời Quản Trị (Tái Bản)",121000,200000,79000,40
TIKI,nha-sach-tiki,153521878,"Nhân Loại - Một Lịch Sử Tràn Đầy Hi Vọng",153000,245000,92000,38
TIKI,nha-sach-tiki,155550600,"Sống Bán Nông Bán X - Tâm Lý Mới Về Cuộc Sống Điền Viên",96000,148000,52000,35
TIKI,nha-sach-tiki,195885690,"Birdmen - Tập 6",29000,30000,1000,3
TIKI,nha-sach-tiki,73222800,"Nghĩ Giàu Và Làm Giàu (Khổ Nhỏ)",74000,108000,34000,31
TIKI,nha-sach-tiki,108715084,"Rio Book No.1 - Xấu Thế Nào, Đẹp Ra Sao - Bí Kíp Thẩm Định Thiết Kế Trong Marketing (Tái Bản Lần 6)",134000,175000,41000,23
TIKI,nha-sach-tiki,66712456,"Trở Về Không - Trải Nghiệm Ho'oponopono - Thực Hiện Hóa Những Phép Màu Trong Cuộc Sống",118000,159000,41000,26
TIKI,nha-sach-tiki,94173462,"Muôn Kiếp Nhân Sinh 2",192000,268000,76000,28
TIKI,nha-sach-tiki,49317816,"Cơ Thể Tự Chữa Lành",103000,160000,57000,36
TIKI,nha-sach-tiki,140416373,"Hành Trình Về Phương Đông (Khổ Nhỏ)(Tái Bản)",54100,78000,23900,31
TIKI,nha-sach-tiki,188548575,"Đời Muối: Lịch Sử Thế Giới",152000,235000,83000,35
TIKI,nha-sach-tiki,63473605,"Ho’Oponopono: Sống Như Người Hawaii – Chấp Nhận, Biết Ơn Và Tha Thứ",80200,109000,28800,26
TIKI,nha-sach-tiki,69764534,"Thợ Xăm Ở Auschwitz",110000,148000,38000,26
TIKI,nha-sach-tiki,95220861,"Tuần Làm Việc 4 Giờ (Tái Bản)",80000,115000,35000,30
TIKI,nha-sach-tiki,31509726,"Làm Bạn Với Bầu Trời (Bìa Mềm) (Tặng Kèm Khung Ảnh Số Lượng Có Hạn)",62000,110000,48000,44
TIKI,nha-sach-tiki,36363381,"Sao Chúng Ta Lại Ngủ",186800,249000,62200,25
TIKI,nha-sach-tiki,377644,"Chờ Đến Mẫu Giáo Thì Đã Muộn",49000,69000,20000,29
TIKI,nha-sach-tiki,109862191,"Combo 8 cuốn: Bộ sách IQ vượt trội - IQ booster",49920,96000,46080,48
TIKI,nha-sach-tiki,56697257,"Bí Mật Và Thực Tế Về Tự Kỉ Ám Thị (Self Mastery Through Conscious Autosuggestion) - Cuốn Sách Về Tự Kỉ Ám Thị Được Freud Và Các Bậc Thầy Phân Tâm Trích Dẫn Và Nghiên Cứu - Liệu Pháp Tự Chữa Lành Được Napoleon Hill Và Tony Robbin Sử Dụng Đều Xuất Phát Từ Đ",52700,83000,30300,37
TIKI,nha-sach-tiki,173745189,"Clean Code – Mã Sạch Và Con Đường Trở Thành Lập Trình Viên Giỏi",244000,386000,142000,37
TIKI,nha-sach-tiki,99513994,"Những Người Đàn Ông Không Có Đàn Bà (Tái Bản)",73000,100000,27000,27
TIKI,nha-sach-tiki,76012203,"Cuộc Đời Là Một Tiểu Thuyết",104000,140000,36000,26
TIKI,nha-sach-tiki,151994935,"Sói Đầu Đàn Và Cún Nhỏ - Tập 1",99300,128000,28700,22
TIKI,nha-sach-tiki,193446628,"Dragon Ball Full Color - Phần Năm: Truy Lùng Cell Bọ Hung Tập 3 [Tặng kèm Standee hoặc Postcard]",69100,77000,7900,10
TIKI,nha-sach-tiki,74686986,"Spy X Family Tập 2",25000,25000,0,0
TIKI,nha-sach-tiki,2126103,"Tazaki Tsukuru Không Màu Và Những Năm Tháng Hành Hương (Tái Bản 2018)",79000,106000,27000,25
TIKI,nha-sach-tiki,112106439,"GIẢI MÃ HÀNH VI ĐỌC VỊ CẢM XÚC",89800,129000,39200,30
TIKI,nha-sach-tiki,194960730,"Nỗi buồn chiến tranh",86000,130000,44000,34
TIKI,nha-sach-tiki,95218447,"Con Đường Chuyển Hóa - Kinh Bốn Lĩnh Vực Quán Niệm (Tái Bản)",61800,89000,27200,31
TIKI,nha-sach-tiki,107331062,"Khởi Nghiệp Kinh Doanh Online - Bán Hàng Hiệu Quả Trên Face.book",159000,199000,40000,20
TIKI,nha-sach-tiki,195357782,"Máy Tính CASIO FX-880BTG - Màu Xám",740000,800000,60000,8
TIKI,nha-sach-tiki,162865518,"Tôn Tử Binh Pháp (Tái Bản)",117000,160000,43000,27
TIKI,nha-sach-tiki,106863962,"Sách Bên Rặng Tuyết Sơn - Nguyên Phong (Tái Bản)",82100,118000,35900,30
TIKI,nha-sach-tiki,45663008,"Ngày Xưa Có Một Con Bò…(Tái Bản)",48000,70000,22000,31
TIKI,nha-sach-tiki,103550551,"Hung Khí Hoàn Mỹ",116000,150000,34000,23
TIKI,nha-sach-tiki,117595535,"Kẻ Ngoại Cuộc",90000,123000,33000,27
TIKI,nha-sach-tiki,274566783,"Siêu Nhí Hỏi Nhà Khoa Học Trả Lời - 100 Bí Ẩn Mọi Đứa Trẻ Đều Muốn Hỏi Một Nhà Khoa Học",173000,173000,0,0
TIKI,nha-sach-tiki,130996088,"Câu Chuyện Ngôn Ngữ",116000,160000,44000,28
TIKI,nha-sach-tiki,129381098,"Tiếp Thị 5.0: Công Nghệ Vị Nhân Sinh",82500,120000,37500,31
TIKI,nha-sach-tiki,394434,"Giấy Excel A4 DL70",62000,62000,0,0
TIKI,nha-sach-tiki,77900454,"Bí Mật Của Nước (Tái Bản)",63600,89000,25400,29
TIKI,nha-sach-tiki,197558899,"Anime Comics: One Piece Film Z - Tập 1",68800,77000,8200,11
TIKI,nha-sach-tiki,197558902,"Anime Comics: One Piece Film Z - Tập 2",68800,77000,8200,11
TIKI,nha-sach-tiki,93734071,"Trí Thông Minh Trên Giường",130000,219000,89000,41
TIKI,nha-sach-tiki,17881046,"Trầm lặng - Sức mạnh tiềm ẩn của người hướng nội",88100,130000,41900,32
TIKI,nha-sach-tiki,197119849,"Chuông Gió (Tập 3)",136000,174000,38000,22
TIKI,nha-sach-tiki,72680632,"Năng Lực Tìm Kiếm",60400,91000,30600,34
TIKI,nha-sach-tiki,39228816,"Kỹ Thuật Giao Dịch Để Kiếm Tiền Hàng Ngày Trên Thị Trường Chứng Khoán – Day Trade For A Living",298000,298000,0,0
TIKI,nha-sach-tiki,154160965,"Thần Thoại Hy Lạp (Tái Bản)",169000,255000,86000,34
TIKI,nha-sach-tiki,100947276,"Ung Thư - Sự Thật, Hư Cấu, Gian Lận Và Những Phương Pháp Chữa Bệnh Không Độc Hại (Tái Bản)",114000,169000,55000,33
TIKI,nha-sach-tiki,72744612,"Nghề Thầy",52000,70000,18000,26
TIKI,nha-sach-tiki,194960245,"Migi & Dali -Tập 1",37100,40000,2900,7
TIKI,nha-sach-tiki,90985718,"Càng Mạnh Mẽ, Càng Dịu Dàng (Tái Bản)",67800,99000,31200,32
TIKI,nha-sach-tiki,178294073,"Trading in The Zone - Thực Hành Kiểm Soát Cảm Xúc bằng Tâm Lý Học Hành Vi trong Đầu Tư và Giao Dịch",295000,295000,0,0
TIKI,nha-sach-tiki,133599625,"Spy X Family Tập 6",25000,25000,0,0
TIKI,nha-sach-tiki,186578227,"Những kẻ cuồng nhạc Musicophilia – Tales of music and the brain",178000,230000,52000,23
TIKI,nha-sach-tiki,21130354,"Vòng Tròn Máu - Trinh Thám Cổ Điển Anh",72000,102000,30000,29
TIKI,nha-sach-tiki,193590152,"Méthode Rose - Phương pháp hồng 1 - Năm thứ nhất với đàn piano - Giáo trình dạy piano nổi tiếng của Pháp",97000,150000,53000,35
TIKI,nha-sach-tiki,87959745,"Hạnh Phúc Là Con Đường",115000,155000,40000,26
TIKI,nha-sach-tiki,113540577,"Anne Tóc Đỏ Dưới Chái Nhà Xanh",92300,119000,26700,22
TIKI,nha-sach-tiki,184466862,"Trưởng Thành Là Khi Nỗi Buồn Cũng Có Deadline",65000,88000,23000,26
TIKI,nha-sach-tiki,192048665,"Vỡ lòng về tiền tệ - Money for Beginners",112000,150000,38000,25
TIKI,nha-sach-tiki,53722909,"Combo Trinh Thám Trung Quốc: Phục Thù (2 tập)",95000,225000,130000,58
TIKI,nha-sach-tiki,189657049,"One Piece - Tập 99",25000,25000,0,0
TIKI,nha-sach-tiki,77621607,"Spy X Family Tập 3",24300,25000,700,3
TIKI,nha-sach-tiki,274607551,"Lời Nói Thần Kỳ Nuôi Dưỡng Những Đứa Trẻ Hạnh Phúc: 0 - 6 Tuổi",61100,61800,700,1
TIKI,nha-sach-tiki,96616370,"Con Đường Trở Thành Freelance Writer - Tôi Đã Kiếm 800.000.000 Một Năm Từ Viết Lách Như Thế Nào? (Tái Bản)",164000,220000,56000,25
TIKI,nha-sach-tiki,193605362,"Ali Và NiNo",97000,125000,28000,22
TIKI,nha-sach-tiki,97561438,"Thế Giới Quả Là Rộng Lớn Và Có Rất Nhiều Việc Phải Làm (Tái Bản)",92620,139000,46380,33
TIKI,nha-sach-tiki,194104223,"Quán Rượu Dị Giới "Nobu" - Tập 10",28100,40000,11900,30
TIKI,nha-sach-tiki,191045565,"Cô Gái Mặc Váy Tím",73600,95000,21400,23
TIKI,nha-sach-tiki,55506686,"Tiktok Marketing",92100,139000,46900,34
TIKI,nha-sach-tiki,168662558,"CCMR. Phải Trái Đúng Sai",92000,155000,63000,41
TIKI,nha-sach-tiki,192909291,"Văn Phòng Thám Tử Quái Vật - Tập 10",21000,30000,9000,30
TIKI,nha-sach-tiki,193896563,"Cô Bạn Tôi Thầm Thích Lại Quên Mang Kính Rồi - Tập 2 [Tặng Kèm Standee Ivory]",37100,38000,900,2
TIKI,nha-sach-tiki,125776045,"Giấy in photo A4 IK Copy IK-01 - Định lượng 70 gsm - 500 tờ/ream - giấy chất lượng cao nhập khẩu Indonesia",70000,110000,40000,36
TIKI,nha-sach-tiki,637390,"Tuần Của Bé - Bé Thông Minh",21850,23000,1150,5
TIKI,nha-sach-tiki,93249197,"22 Quy Luật Bất Biến Trong Marketing",53100,78000,24900,32
TIKI,nha-sach-tiki,20444622,"Cẩm Nang Cấu Trúc Tiếng Anh",63000,98000,35000,36
TIKI,nha-sach-tiki,197634260,"Black Jack - Tập 14",30000,30000,0,0
TIKI,nha-sach-tiki,80960198,"Thiên Tài Bên Trái, Kẻ Điên Bên Phải (Tái Bản 2021)",121000,179000,58000,32
TIKI,nha-sach-tiki,197990871,"Doraemon Movie Story: Nobita Và Hòn Đảo Diệu Kì - Cuộc Phiêu Lưu Của Loài Thú",30000,30000,0,0
TIKI,nha-sach-tiki,197990867,"Doraemon Movie Story: Nobita Và Viện Bảo Tàng Bảo Bối",30000,30000,0,0
TIKI,nha-sach-tiki,56218385,"Thông Điệp Của Nước (Tái Bản 2020)",59100,89000,29900,34
TIKI,nha-sach-tiki,174444205,"Dịch Vụ Đặc Biệt: Dọn Dẹp Nhà Cho Người Chết",71800,99000,27200,27
TIKI,nha-sach-tiki,14645351,"Cuộc Đời Của Pi ( Tái Bản 2019)",82000,110000,28000,25
TIKI,nha-sach-tiki,54624820,"Sức Mạnh Của Tĩnh Lặng (Tái Bản 2020)",46500,68000,21500,32
TIKI,nha-sach-tiki,111582631,"Cái Dũng Của Thánh Nhân (Thu Giang Nguyễn Duy Cần) (Tái Bản)",62000,90000,28000,31
TIKI,nha-sach-tiki,381234,"Cuốn Sách Hoàn Hảo Về Ngôn Ngữ Cơ Thể - Body Language (Tái Bản)",149000,198000,49000,25
TIKI,nha-sach-tiki,89179374,"Spy X Family Tập 4",24300,25000,700,3
TIKI,nha-sach-tiki,77109209,"Nghệ Thuật Đánh Cắp Ý Tưởng (10 Bí Mật Không Ai Nói Với Bạn Về Sáng Tạo)",65400,99000,33600,34
TIKI,nha-sach-tiki,87391039,"Thuật Yêu Đương (Tái Bản)",81000,120000,39000,33
TIKI,nha-sach-tiki,52329861,"Con Đường Hồi Giáo (Tái Bản 2020)",72500,100000,27500,28
TIKI,nha-sach-tiki,10405966,"Tarot Nhập Môn (Tái Bản 2019)",87100,120000,32900,27
TIKI,nha-sach-tiki,106605689,"Spy X Family Tập 5 - Bản Thường",25000,25000,0,0
TIKI,nha-sach-tiki,192909304,"Lên Tàu Cùng Socrates - Đi Tìm Ý Nghĩa Cuộc Sống Từ Các Triết Gia",103900,195000,91100,47
TIKI,nha-sach-tiki,195885680,"Tiệm Trừ Yêu Kì Ảo -  Tập 18",34100,35000,900,3
TIKI,nha-sach-tiki,81224320,"Nước Ép Xanh Chữa Lành Cơ Thể",124600,179000,54400,30
TIKI,nha-sach-tiki,54051754,"19 Năm Mưu Sát - Tập 1 (Trinh Thám Trung Quốc)",74000,115000,41000,36
TIKI,nha-sach-tiki,54051756,"19 Năm Mưu Sát - Tập 2 (Trinh Thám Trung Quốc)",74000,115000,41000,36
TIKI,nha-sach-tiki,77230663,"Combo 2 Cuốn: Tâm Lý Học Tội Phạm",200000,288000,88000,31
TIKI,nha-sach-tiki,76175424,"Vụ Án Mạng Ở Nhà Khách Núi Hakuba",101000,138000,37000,27
TIKI,nha-sach-tiki,100958444,"Hạnh Phúc Cầm Tay (Tái Bản)",52000,75000,23000,31
TIKI,nha-sach-tiki,189641379,"Anh Em Nhà Motohashi - Tập 1",53900,68000,14100,21
TIKI,nha-sach-tiki,116406678,"Quản Lý Nghiệp (Tái Bản)",40800,59000,18200,31
TIKI,nha-sach-tiki,59293803,"A Holistic Approach To IELTS Writing",131000,189000,58000,31
TIKI,nha-sach-tiki,140635217,"Mất Kết Nối (Khám Phá Các Nguyên Nhân Thực Của Trầm Cảm Và Các Giải Pháp Bất Ngờ)",166000,250000,84000,34
TIKI,nha-sach-tiki,162201947,"One Piece - Tập 98: “Phút Huy Hoàng Của Những Trung Thần",25000,25000,0,0
TIKI,nha-sach-tiki,124639646,"Bé chinh phục 2000 từ vựng tiếng Anh - My First 2000 English words",62400,120000,57600,48
TIKI,nha-sach-tiki,149180057,"Đừng Cố Làm Người Tốt Trong Mắt Tất Cả Mọi Người",86000,108000,22000,20
TIKI,nha-sach-tiki,595724,"Giáo Trình Chuẩn HSK 4 Bài Học (Tập 1)",171000,228000,57000,25
TIKI,nha-sach-tiki,10397239,"Chiến Lược Dữ Liệu",114000,158000,44000,28
TIKI,nha-sach-tiki,46789754,"Hiểu Hết Về Kinh Doanh",283000,380000,97000,26
TIKI,nha-sach-tiki,187843301,"How Technology Works – Hiểu hết về công nghệ",242000,330000,88000,27
TIKI,nha-sach-tiki,194104226,"Mô Hình Can Thiệp Sớm Denver Cho Trẻ Tự Kỷ - Thúc Đẩy Kỹ Năng Ngôn Ngữ, Học Tập Và Tương Tác",110200,210000,99800,48
TIKI,nha-sach-tiki,190240560,"Bộ Sách Tô Màu - Bé Làm Họa Sĩ",19000,25000,6000,24
TIKI,nha-sach-tiki,140360874,"Những Đòn Tâm Lý Trong Bán Hàng (Tái Bản)",80620,139000,58380,42
TIKI,nha-sach-tiki,10383904,"Tôi Là Bêtô",65000,95000,30000,32
TIKI,nha-sach-tiki,190708154,"Dragon Quest - Dấu Ấn Roto (Dragon Quest Saga Emblem Of Roto) Perfect Edition Tập 8 [Tặng Kèm Bookmark PVC]",70000,75000,5000,7
TIKI,nha-sach-tiki,176654072,"Bộ 5 bút chì gỗ 2B HB Deli - Có bán lẻ 1 chiếc - Nhiều loại mẫu mã màu sắc - Phù hợp cho học sinh sinh viên tập viết vẽ tranh",1700,3420,1720,50
TIKI,nha-sach-tiki,77105810,"Nỗi Đau Của Chàng Werther (Bìa Cứng)",63300,85000,21700,26
TIKI,nha-sach-tiki,58342212,"Set 3 cuốn Moi Moi và những người bạn - Dành cho trẻ từ 0-2 tuổi",75600,117000,41400,35
TIKI,nha-sach-tiki,105614684,"Bút gel 0.5mm Deli nhiều màu lựa chọn - Bút bi nước -  1 chiếc - Mực đỏ / Xanh / Đen - A116",7200,7200,0,0
TIKI,nha-sach-tiki,137161811,"Bút gel bấm ngòi 0.5mm nhiều màu Deli - Độ dài mực lên tới 1000m - 12 màu mực - 1 chiếc - EG118",5000,10800,5800,54
TIKI,nha-sach-tiki,100347903,"Nói Một Cách Đơn Giản",90000,129000,39000,30
TIKI,nha-sach-tiki,73125816,"Digital Marketing - Từ Chiến Lược Đến Thực Thi (Tái Bản 2020)",167000,220000,53000,24
TIKI,nha-sach-tiki,50685547,"Bản Đồ (Bản Thông Thường)",237000,345000,108000,31
TIKI,nha-sach-tiki,138226289,"Storytelling With Data: Let’S Practice! - Thực Hành Kể Chuyện Thông Qua Dữ Liệu!",277800,399000,121200,30
TIKI,nha-sach-tiki,195801646,"Ninja Rantaro - Tập 60",37100,40000,2900,7
TIKI,nha-sach-tiki,176906726,"Chân Dung Thật - Thấu Hiểu Khách Hàng Chỉ Bằng Những Cuộc Trò Chuyện",211000,245000,34000,14
TIKI,nha-sach-tiki,72542509,"Raw Vegan – Sức Mạnh Chữa Lành Của Thực Vật (Tặng kèm bookmark)",63900,92000,28100,31
TIKI,nha-sach-tiki,509829,"Giấy Double A A4 DL70",85500,90000,4500,5
TIKI,nha-sach-tiki,84950232,"Hoa Sen Trên Tuyết (Tái Bản)",68100,98000,29900,31
TIKI,nha-sach-tiki,115873770,"Sách: Thay Đổi Một Suy Nghĩ Thay Đổi cả Cuộc Đời",120000,160000,40000,25
TIKI,nha-sach-tiki,196001724,"Dưới Cánh Đại Bàng (Bìa Mềm)",95100,138000,42900,31
TIKI,nha-sach-tiki,10325548,"How Food Works - Hiểu Hết Về Thức Ăn",223000,300000,77000,26
TIKI,nha-sach-tiki,62648441,"The Customer Rules - 39 Nguyên Tắc Cốt Lõi Để Mang Tới Dịch Vụ Đỉnh Cao",174000,220000,46000,21
TIKI,nha-sach-tiki,45663835,"Lạc Quan Tếu – Irrational Exuberance",299000,299000,0,0
TIKI,nha-sach-tiki,193978836,"Trí Óc Minh Mẫn: Để Não Bộ Sắc Bén Ở Mọi Lứa Tuổi",164400,249000,84600,34
TIKI,nha-sach-tiki,193736891,"Tâm Lý Học Xã Hội - Đi Tìm Chất Gây Nghiện Trong Mỗi Con Người",99600,139000,39400,28
TIKI,nha-sach-tiki,130997085,"Chuyện Con Chó Tên Là Trung Thành",34000,45000,11000,24
TIKI,nha-sach-tiki,148761077,"Khách Sạn Mặt Nạ 1",136000,175000,39000,22
TIKI,nha-sach-tiki,144203242,"9 Lần Khởi Nghiệp - Chuyện Kể Về Những Thất Bại Và Thành Công Của Một Triệu Phú",149000,199000,50000,25
TIKI,nha-sach-tiki,180851000,"Bảy Thanh Hung Giản 3 Mưa Phùn Chôn Nho - Truy Lùng Báo Săn Giá",182000,235000,53000,23
TIKI,nha-sach-tiki,72818335,"Bộ Thẻ học Thông minh - 416 Thẻ Flashcards Tiếng Anh - 16 Chủ đề mới nhất",65790,129000,63210,49
TIKI,nha-sach-tiki,193434494,"Shaman King - Tập 15",33800,35000,1200,3
TIKI,nha-sach-tiki,15397971,"Hà Nội Băm Sáu Phố Phường (Tái bản 2019)",37100,50000,12900,26
TIKI,nha-sach-tiki,95090804,"Bút dạ viết bảng Deli - xóa được - Mực xanh/đen/đỏ - 1 chiếc – EU00120/ EU00130 / EU00140",14400,14400,0,0
TIKI,nha-sach-tiki,78975610,"Siêu Tập Trung (Tái Bản)",90500,140000,49500,35
TIKI,nha-sach-tiki,197781968,"Migi & Dali Tập 3",37900,40000,2100,5
TIKI,nha-sach-tiki,197587849,"Yuri Espoir (Tập 3)",62700,79000,16300,21
TIKI,nha-sach-tiki,196001693,"Trí Tuệ Của Trái Tim",69500,88000,18500,21
TIKI,nha-sach-tiki,49181801,"Oxford Advanced Learner's Dictionary : Paperback - 10th Edition (With 1 Year's Access To Both Premium Online And App)",522660,562000,39340,7
TIKI,nha-sach-tiki,148760915,"Khách Sạn Mặt Nạ 2 - Đêm Trước Lễ Hội Hóa Trang",97000,125000,28000,22
TIKI,nha-sach-tiki,174427255,"Lốc Vở Kẻ Ngang Primer (120 trang - 200 trang | Giao mẫu ngẫu nhiên)",80070,157000,76930,49
TIKI,nha-sach-tiki,168946125,"Digital Marketing - Chiến Lược Là Lược Đi Để Chiến",111200,139000,27800,20
TIKI,nha-sach-tiki,152875147,"Miền Đất Hứa (A Promised Land) - Barack Obama (Bìa Cứng)",179000,768000,589000,77
TIKI,nha-sach-tiki,95997783,"Sách Luyện thi B1 Vstep 4 kỹ năng - Ôn thi chứng chỉ tiếng Anh B1 bậc 3 (bằng B1 tiếng Anh) theo Khung NLNN Việt Nam",300000,300000,0,0
TIKI,nha-sach-tiki,171825201,"Người Bà Tài Giỏi Vùng Saga – Tập 7",41600,52000,10400,20
TIKI,nha-sach-tiki,13446508,"Cánh Đồng Bất Tận (Tái Bản 2019)",65000,85000,20000,24
TIKI,nha-sach-tiki,165150439,"TalMud - Tinh Hoa Trí Tuệ Do Thái (Tái Bản)",73000,110000,37000,34
TIKI,nha-sach-tiki,55119955,"Cách Sống (Tái Bản 2020)",59000,85000,26000,31
TIKI,nha-sach-tiki,185888686,"Trường An Ly Ca 3 – Cao Sơn Lưu Thuỷ",134000,170000,36000,21
TIKI,nha-sach-tiki,54383647,"Fullmetal Alchemist - Cang Giả Kim Thuật Sư - Fullmetal Edition Tập 4",64100,69000,4900,7
TIKI,nha-sach-tiki,87226754,"Một Cuốn Sách Buồn… Cười - Vui Vẻ Không Quạu Nha 2",52000,79000,27000,34
TIKI,nha-sach-tiki,195190272,"Nhất Quỷ Nhì Ma, Thứ Ba Takagi  - Tập 15",29000,30000,1000,3
TIKI,nha-sach-tiki,74285820,"Cơ Thể Tự Chữa Lành: Nước Ép Cần Tây",96000,148000,52000,35
TIKI,nha-sach-tiki,186271356,"Từ điển xây kênh từ cơ bản đến thành công",268000,268000,0,0
TIKI,nha-sach-tiki,189326210,"Nghệ thuật tư duy dựa trên dữ liệu - Để ra quyết điịnh thông minh hơn trong một thê giới không chắc chắn",85000,150000,65000,43
TIKI,nha-sach-tiki,9695881,"Nghệ Thuật đầu tư Dhandho - The Dhandho Investor",238000,238000,0,0
TIKI,nha-sach-tiki,75630595,"The Design Thinking Playbook- Thực Hành Tư Duy Thiết Kế",185400,299000,113600,38
TIKI,nha-sach-tiki,4080373,"90% Trẻ Thông Minh Nhờ Cách Trò Chuyện Đúng Đắn Của Cha Mẹ",31000,39000,8000,21
TIKI,nha-sach-tiki,177637709,"Làm Chủ Bình Minh - Sống Đời Xuất Chúng - CLB 5 Giờ Sáng (Robin Sharma)",109000,185000,76000,41
TIKI,nha-sach-tiki,195357774,"Máy Tính CASIO FX-880BTG - Màu Xanh Biển",708000,800000,92000,12
TIKI,nha-sach-tiki,160375101,"Ngữ pháp luyện thi IELTS - Grammar for ielts",88000,88000,0,0
TIKI,nha-sach-tiki,124767712,"Không Tự Khinh Bỉ - Không Tự Phí Hoài (Tái Bản)",85200,119000,33800,28
TIKI,nha-sach-tiki,101782486,"Làm Ra Làm, Chơi Ra Chơi (Tái Bản)",104200,159000,54800,34
TIKI,nha-sach-tiki,76014598,"Blue Ocean Strategy - Chiến Lược Đại Dương Xanh (Bìa Cứng) (Tái Bản)",150600,239000,88400,37
TIKI,nha-sach-tiki,73102465,"Bé Tô màu - Combo 11 cuốn",64900,127255,62355,49
TIKI,nha-sach-tiki,32415084,"Combo 2 cuốn Giáo Trình Hán Ngữ (Sách học Tiếng Trung dành cho người Việt): Giáo Trình Hán Ngữ Tập 1 + Giáo Trình Hán Ngữ Tập 2 (Học bằng App McBooks) - Tặng kèm bookmark GreenLife",170800,244000,73200,30
TIKI,nha-sach-tiki,53452969,"Khởi Nghiệp Du Kích - Kinh Doanh Ít Vốn - Vận Dụng Nguồn Lực Nhỏ Chiến Thắng Cuộc Chơi Lớn (Tái Bản)",155000,199000,44000,22
TIKI,nha-sach-tiki,73316970,"Osho - Ươm Mầm",75800,109000,33200,30
TIKI,nha-sach-tiki,196849409,"Gửi Em, Người Bất Tử - Tập 11 (Tái Bản 2022)",28900,30000,1100,4
TIKI,nha-sach-tiki,10678954,"Full bộ Ehon Nhật Bản cho bé 0-6 tuổi thông minh, sáng tạo",271000,390000,119000,31
TIKI,nha-sach-tiki,196849406,"Gửi Em, Người Bất Tử - Tập 9 (Tái Bản 2022)",21400,30000,8600,29
TIKI,nha-sach-tiki,121185870,"Và Rồi Núi Vọng",109000,148000,39000,26
TIKI,nha-sach-tiki,20520720,"Đối Thoại Với Thượng Đế ( Tái Bản )",73000,98000,25000,26
TIKI,nha-sach-tiki,73207098,"Làm Chủ - Mastery",128000,200000,72000,36
TIKI,nha-sach-tiki,196849403,"Gửi Em, Người Bất Tử - Tập 8 (Tái Bản 2022)",21400,30000,8600,29
TIKI,nha-sach-tiki,148750882,"Khi Mọi Thứ Sụp Đổ - Lời Khuyên Chân Thành Trong Những Thời Điểm Khó Khăn",82300,119000,36700,31
TIKI,nha-sach-tiki,52329765,"Biên Niên Ký Chim Vặn Dây Cót (Tái Bản 2020)",137000,199000,62000,31
TIKI,nha-sach-tiki,63187280,"Combo 2 Cuốn: Cơ Thể Tự Chữa Lành",222000,345000,123000,36
TIKI,nha-sach-tiki,37411897,"Sách Đen - Bộ Công Cụ Của Phụ Nữ Thành Đạt",55600,79000,23400,30
TIKI,nha-sach-tiki,196849389,"Gửi Em, Người Bất Tử - Tập 10 (Tái Bản 2022)",28900,30000,1100,4
TIKI,nha-sach-tiki,113656455,"Giáo Trình Tư Tưởng Hồ Chí Minh (Dành Cho Bậc Đại Học Hệ Không Chuyên Lý Luận Chính Trị) - Bộ mới năm 2021",55000,55000,0,0
TIKI,nha-sach-tiki,167301575,"Khí Chất Bao Nhiêu Hạnh Phúc Bấy Nhiêu (Tái Bản 2022)",103000,139000,36000,26
TIKI,nha-sach-tiki,1471887,"Tớ Muốn Ăn Tụy Của Cậu",72000,96000,24000,25
TIKI,nha-sach-tiki,40774181,"Combo Sách Tiếng hàn tổng hợp dành cho người Việt Nam - Sơ cấp 1 (Phiên bản 1 màu)",163800,234000,70200,30
TIKI,nha-sach-tiki,179546074,"Luật Hấp Dẫn - Quy Luật Về Sự Thịnh Vượng Và Thành Công",85900,129000,43100,33
TIKI,nha-sach-tiki,197781971,"Chòm Sao Linh Thú Tập 9",39100,40000,900,2
TIKI,nha-sach-tiki,50322710,"48 Nguyên Tắc Chủ Chốt Của Quyền Lực (Tái Bản 2020)",119000,200000,81000,41
TIKI,nha-sach-tiki,75615273,"Combo 3 Cuốn Sách Ehon: Buồn Ngủ Ơi Là Buồn Ngủ (Dành Cho Trẻ Từ 0 - 4 Tuổi)",75700,117000,41300,35
TIKI,nha-sach-tiki,273633981,"[ Trạm Đọc Official ] Sách: Tâm Lý Học Thành Công (Tái Bản)",149000,199000,50000,25
TIKI,nha-sach-tiki,191320058,"Set 6 Chiếc Bút Highlight Hai Đầu Bút Nhớ Dòng Đánh Dấu Dạ Quang Take Note Ghi Chú Deli - Bảng Màu Pastel Macaron - 33002 S605 S735 S134",29000,57600,28600,50
TIKI,nha-sach-tiki,545278,"Combo Sherlock Holmes Toàn Tập (Trọn Bộ 3 Tập)",156000,300000,144000,48
TIKI,nha-sach-tiki,147920907,"Combo Bộ 6 Cuốn: Thư Viện Song Ngữ Đầu Tiên Cho Bé (0-3 Tuổi)",80500,108000,27500,25
TIKI,nha-sach-tiki,195980676,"Phượng Hoàng Tái Sinh - 12 Phẩm Chất Quan Trọng Để Bứt Phá Sự Nghiệp Và Cuộc Sống",109440,152000,42560,28
TIKI,nha-sach-tiki,44627532,"Cẩm Nang Hướng Dẫn Thải Độc & Chế Độ Ăn Uống Lành Mạnh",98500,145000,46500,32
TIKI,nha-sach-tiki,109633951,"Combo 8 cuốn: Tô màu Nối số Thông minh",49920,96000,46080,48
TIKI,nha-sach-tiki,4255933,"Plato Và Con Thú Mỏ Vịt Bước Vào Quán Bar (Tái Bản 2018 )",74500,100000,25500,26
TIKI,nha-sach-tiki,76105910,"5 Ngôn Ngữ Yêu Thương - The Five Love Languages (Tái Bản)",89100,128000,38900,30
TIKI,nha-sach-tiki,192124393,"Ikigami - Tập 06",43600,45000,1400,3
TIKI,nha-sach-tiki,196849393,"Gửi Em, Người Bất Tử - Tập 4 (Tái Bản 2022)",21000,30000,9000,30
TIKI,nha-sach-tiki,10397241,"Sách Chữa Lành Nỗi Đau",68100,98000,29900,31
TIKI,nha-sach-tiki,36854641,"Sự Thật Về Thế Giới : Mười Lý Do Khiến Ta Hiểu Sai Về Thế Giới - Và Vì Sao Thế Gian Này Tốt Hơn Ta Tưởng",88200,160000,71800,45
TIKI,nha-sach-tiki,176906754,"Inspired - Kiến Tạo Sản Phẩm Công Nghệ Chiếm Trọn Trái Tim Người Dùng",228000,295000,67000,23
TIKI,nha-sach-tiki,10920495,"Dế Mèn Phiêu Lưu Ký",104000,150000,46000,31
TIKI,nha-sach-tiki,193211309,"Chuông Gió (Tập 2)",126000,174000,48000,28
TIKI,nha-sach-tiki,189350061,"Giá Mà Nỗi Buồn Có Thể Cầm Nắm Trên Tay - Tặng kèm 03 postcard",78000,109000,31000,28
TIKI,nha-sach-tiki,10767515,"Phân Tâm Học Nhập Môn",118000,159000,41000,26
TIKI,nha-sach-tiki,76013370,"Được Học - Educated (Tái Bản)",136000,182000,46000,25
TIKI,nha-sach-tiki,552393,"Hiểu Về Trái Tim",142000,158000,16000,10
TIKI,nha-sach-tiki,75338644,"Bảng viết, bảng vẽ cảm ứng điện tử thông minh tự động xóa cho bé - Hàng Chính Hãng VinBuy",65000,120000,55000,46
TIKI,nha-sach-tiki,176550203,"Cuộc Đời Ngắn Lắm Đừng Ôm Muộn Phiền",62900,88000,25100,29
TIKI,nha-sach-tiki,184475053,"Sa Vào Ánh Hào Quang Của Người – Tập 1",108000,132000,24000,18
TIKI,nha-sach-tiki,104651900,"Sách Seneca: Những Bức Thư Đạo Đức – Chủ nghĩa Khắc kỷ trong đời sống - Tập 1",149000,159000,10000,6
TIKI,nha-sach-tiki,196849400,"Gửi Em, Người Bất Tử - Tập 5 (Tái Bản 2022)",21400,30000,8600,29
TIKI,nha-sach-tiki,5067167,"Tôi Là Ai - Và Nếu Vậy Thì Bao Nhiêu? (Tái Bản 2018)",92700,126000,33300,26
TIKI,nha-sach-tiki,95218547,"Đọc Vị Mọi Vấn Đề Của Trẻ - Giải Mã Mọi Vấn Đề Về Nuôi Con Nhỏ: Ăn - Ngủ - Kỷ Luật Hành Vi (Tái Bản)",133000,199000,66000,33
TIKI,nha-sach-tiki,74460137,"Sách Bí Quyết Áp Dụng 7 Thói Quen Của Bạn Trẻ Thành Đạt (Khổ Nhỏ) (Tái Bản 2020)",75100,108000,32900,30
TIKI,nha-sach-tiki,106693398,"Combo 4 cuốn: Luyện viết (Theo chương trình mới - Bé vào lớp 1)",37440,72000,34560,48
TIKI,nha-sach-tiki,187622581,"Sách Sức Mạnh Của Sự Trầm Lắng",99840,128000,28160,22
TIKI,nha-sach-tiki,103471709,"Full bộ (10 quyển) Truyện cổ tích Việt Nam (Song ngữ Việt - Anh) (giao ngẫu nhiên)",62400,120000,57600,48
TIKI,nha-sach-tiki,38223395,"Tâm Lý Học Hài Hước (Tái Bản)",63600,89000,25400,29
TIKI,nha-sach-tiki,140360872,"Để Xây Dựng Doanh Nghiệp Hiệu Quả (Tái Bản)",92620,139000,46380,33
TIKI,nha-sach-tiki,196849396,"Gửi Em, Người Bất Tử - Tập 3 (Tái Bản 2022)",29500,30000,500,2
TIKI,nha-sach-tiki,100384412,"Vô Cùng Tàn Nhẫn Vô Cùng Yêu Thương (Tái Bản)",109620,189000,79380,42
TIKI,nha-sach-tiki,59078520,"Các phương pháp giao dịch ngắn hạn hiệu quả trên thị trường Forex – Day Trading and Swing Trading the Currency Market",299000,299000,0,0
TIKI,nha-sach-tiki,196150482,"Người nuôi ong thành Aleppo - The beekeeper of Aleppo (Aspen Words Literary Prize Winner)",108000,168000,60000,36
TIKI,nha-sach-tiki,193917227,"Mỹ Vị Hầm Ngục - 3 - Bản Đặc Biệt - Tặng Kèm Bìa 2 Mặt, Bộ Đôi Card Chiến Binh & Ẩm Thực",45000,70000,25000,36
TIKI,nha-sach-tiki,139979524,"Thiền - Osho (Tái Bản)",102000,149000,47000,32
TIKI,nha-sach-tiki,109322300,"Combo 8 cuốn Ehon Kỹ năng sống: Bon và Gia đình, Bạn bè",120640,232000,111360,48
TIKI,nha-sach-tiki,188534368,"Khúc Ngẫu Hứng Trước Ga Mahoro",135000,180000,45000,25
TIKI,nha-sach-tiki,95289208,"Người Bà Tài Giỏi Vùng Saga",83000,128000,45000,35
TIKI,nha-sach-tiki,95090643,"Bút màu marker chuyên nghiệp Deli -kèm túi vải - 30/40/60/80 Màu - 70806",232200,232200,0,0
TIKI,nha-sach-tiki,192475873,"Để Con Được Ốm",90100,120000,29900,25
TIKI,nha-sach-tiki,22878271,"Essential Grammar in Use Book with Answers Edition: A Self-Study Reference and Practice Book for Elementary Learners of English",165540,178000,12460,7
TIKI,nha-sach-tiki,116397449,"Người Tình Sputnik",64000,86000,22000,26
TIKI,nha-sach-tiki,186290802,"Bàn Có Năm Chỗ Ngồi (Tái Bản 2022)",25600,38000,12400,33
TIKI,nha-sach-tiki,184801142,"Cutie Pie – Em Ngoan, Lại Cho Là Em Ngốc - Bản thường (tặng kèm 1 bookmark in bồi 2 mặt)",146000,189000,43000,23
TIKI,nha-sach-tiki,88791130,"Gôm Tẩy 2B Deli, 40×22×12Mm, Đen - 1 Viên - E3043",7200,7200,0,0
TIKI,nha-sach-tiki,54422996,"Nóng Giận Là Bản Năng, Tĩnh Lặng Là Bản Lĩnh (Tái Bản 2020)",66800,89000,22200,25
TIKI,nha-sach-tiki,19349145,"Bí Mật Tư Duy Triệu Phú (Tái Bản 2019)",86000,108000,22000,20
TIKI,nha-sach-tiki,1565657,"Dốc Hết Trái Tim - Cách Starbucks Xây Dựng Công Ty Bằng Từng Tách Cà Phê (Tái Bản 2018)",99000,150000,51000,34
TIKI,nha-sach-tiki,129672282,"Từ vựng luyện thi IELTS - Vocabulary for Ielts with answers",56000,90000,34000,38
TIKI,nha-sach-tiki,3640421,"Đắc Nhân Tâm - Bản Dịch Gốc Từ Nguyễn Hiến Lê (Tặng Kèm Audio Book)",56100,90000,33900,38
TIKI,nha-sach-tiki,190701644,"Dám Mơ Lớn, Đừng Hoài Phí Tuổi Trẻ (Tái Bản) -Tặng kèm 1 bookmark 2 mặt",82100,119000,36900,31
TIKI,nha-sach-tiki,196849405,"Gửi Em, Người Bất Tử - Tập 7 (Tái Bản 2022)",21000,30000,9000,30
TIKI,nha-sach-tiki,2716247,"Quẳng Gánh Lo Đi Và Vui Sống (Bìa Cứng)",77300,108000,30700,28
TIKI,nha-sach-tiki,196849394,"Gửi Em, Người Bất Tử - Tập 6 (Tái Bản 2022)",21000,30000,9000,30
TIKI,nha-sach-tiki,145300494,"The Mastery Of Self - Hành Trình Thấu Hiểu Bản Thân Và Tìm Thấy Tự Do",119000,180000,61000,34
TIKI,nha-sach-tiki,136340700,"Trên Lưng Khổng Tượng - Kinh Doanh Online Trên Sàn Thương Mại Điện Tử - Khởi Nghiệp Với Bán Hàng Qua Mạng và Nhãn Hàng Riêng",155000,199000,44000,22
TIKI,nha-sach-tiki,185188826,"Fryderyk Chopin: Cuộc Đời Và Thời Đại ",374000,499000,125000,25
TIKI,nha-sach-tiki,91444567,"Sống Cuộc Đời Bạn Muốn",180000,220000,40000,18
TIKI,nha-sach-tiki,57350380,"Very Easy Toeic 1 - Introduction",159000,228000,69000,30
TIKI,nha-sach-tiki,184236581,"Năng Lực Của Sự Ngu Ngốc",168000,225000,57000,25
TIKI,nha-sach-tiki,77900446,"Thần Số Học: Thấu Hiểu Nhân Tâm",75800,109000,33200,30
TIKI,nha-sach-tiki,274175495,"Tĩnh Lặng",49200,69000,19800,29
TIKI,nha-sach-tiki,2812299,"Tiếng Nhật Cho Mọi Người - Sơ Cấp 1 - Bản Dịch Và Giải Thích Ngữ Pháp - Tiếng Việt (Bản Mới)",65000,100000,35000,35
TIKI,nha-sach-tiki,198016673,"Vua Sáng Chế - Tập 18",20000,20000,0,0
TIKI,nha-sach-tiki,186088879,"Beyond Order - Vượt Lên Trật Tự",257000,350000,93000,27
TIKI,nha-sach-tiki,12107394,"Barron's Essential Words For The Toeic (Tái Bản)",166000,238000,72000,30
TIKI,nha-sach-tiki,131401030,"Ayurveda",240000,240000,0,0
TIKI,nha-sach-tiki,57815506,"Sách Tư Duy Ngược Dịch Chuyển Thế Giới",123000,178000,55000,31
TIKI,nha-sach-tiki,73105037,"Combo 9 cuốn Tập tô - Tập viết chữ - Làm quen chữ cái/chữ số (Chuẩn bị vào lớp 1)",56160,108000,51840,48
TIKI,nha-sach-tiki,197634255,"Anh em phi hành gia - Tập 34",32000,45000,13000,29
TIKI,nha-sach-tiki,73139676,"Full bộ (20 quyển) Truyện kể Mầm non - Cổ tích - Ngụ ngôn Aesop (giao ngẫu nhiên)",107781,207271,99490,48
TIKI,nha-sach-tiki,167210783,"Trường An Ly Ca 1 – Máu Đỏ Hoa Đào",135000,175000,40000,23
TIKI,nha-sach-tiki,100958526,"Nhân Tố Enzyme - Thực Hành (Tái Bản 2021)",73000,109000,36000,33
TIKI,nha-sach-tiki,181379116,"Hackers Toeic Vocabulary (Tái Bản)",173800,279000,105200,38
TIKI,nha-sach-tiki,155115301,"Bộ "Chuyện xóm gà" 2",276000,348000,72000,21
TIKI,nha-sach-tiki,192339426,"Không Ai Sống Giống Ai Trong Cuộc Đời Này",112000,145000,33000,23
TIKI,nha-sach-tiki,190464440,"Ikigami - Tập 05",32000,45000,13000,29
TIKI,nha-sach-tiki,76541999,"Tăng tốc luyện đề thi Đánh giá năng lực (theo cấu trúc đề thi của Đại học Quốc gia TP. Hồ Chí Minh)",157000,225000,68000,30
TIKI,nha-sach-tiki,111285050,"Ai Lấy Miếng Pho Mát Của Tôi ? (Tái Bản)",47100,68000,20900,31
TIKI,nha-sach-tiki,196517619,"Thiếu Nữ (Shoujo)",97500,150000,52500,35
TIKI,nha-sach-tiki,191801175,"Nhịn Khô",98500,139000,40500,29
TIKI,nha-sach-tiki,186211127,"Khởi Nghiệp Kinh Doanh Online - Bán Hàng Hiệu Quả Trên Shopee",151000,199000,48000,24
TIKI,nha-sach-tiki,69219921,"OKRs - Hiểu Đúng, Làm Đúng - Cách Để Áp Dụng Thành Công OKRs Ngay Từ Đầu",150600,239000,88400,37
TIKI,nha-sach-tiki,3048355,"Nhà (Tái Bản)",70400,109000,38600,35
TIKI,nha-sach-tiki,135754581,"Những Câu Chuyện Truyền Cảm Hứng - I Will Be Better: Nguồn Năng Lượng Tích Cực",43000,58000,15000,26
TIKI,nha-sach-tiki,11357193,"Những Cuộc Phiêu Lưu Của Huckleberry Finn",63000,98000,35000,36
TIKI,nha-sach-tiki,8835165,"Ông Trăm Tuổi Trèo Qua Cửa Sổ Và Biến Mất (Tái Bản)",125000,190000,65000,34
TIKI,nha-sach-tiki,186434701,"Khi Bạn Đang Say Giấc, Ai Đó Đã Đạt Được Ước Mơ-Tặng kèm 01 bookmark",76100,108000,31900,30
TIKI,nha-sach-tiki,92492870,"Combo 6 Cuốn Ehon Nhật Bản : Ai Ở Sau Lưng Bạn Thế (Tái Bản)",161000,234000,73000,31
TIKI,nha-sach-tiki,53301006,"Sách Ping - Vượt Ao Tù Ra Biển Lớn (Tái Bản 2020)",64100,98000,33900,35
TIKI,nha-sach-tiki,171170802,"Kỹ thuật giao dịch nâng cao để kiếm tiền hàng ngày trên thị trường chứng khoán – Advanced Techniques in Day Trading",359000,359000,0,0
TIKI,nha-sach-tiki,107342987,"Bút bi nước khô nhanh Deli - 0.5mm - Bút viết thư pháp - Ống bút liền mực - Mực Xanh - 1 chiếc - S856",12600,12600,0,0
TIKI,nha-sach-tiki,22634335,"Kỹ Năng Quản Lý Nhân Sự Chuyên Nghiệp",82800,119000,36200,30
TIKI,nha-sach-tiki,58390336,"Python cơ bản",125000,125000,0,0
TIKI,nha-sach-tiki,68392386,"Stephen Hawking - Trả Lời Ngắn Gọn Những Câu Hỏi Lớn",55800,90000,34200,38
TIKI,nha-sach-tiki,9687409,"Thôi Miên Bằng Ngôn Từ",121580,169000,47420,28
TIKI,nha-sach-tiki,76401055,"Sét Bong Bóng Trang Trí Sinh Nhật FUNU Nhiều Mẫu Kèm Bơm Tay- Hàng Chính Hãng",116850,123000,6150,5
TIKI,nha-sach-tiki,189657596,"Komi - Nữ Thần Sợ Giao Tiếp Tập 11",25000,25000,0,0
TIKI,nha-sach-tiki,197602047,"Fullmetal Alchemist - Cang Giả Kim Thuật Sư - Fullmetal Edition Tập 9",61400,69000,7600,11
TIKI,nha-sach-tiki,190242074,"Chuông Gió (Tập 1) - Tặng kèm 1 bookmark",124000,174000,50000,29
TIKI,nha-sach-tiki,193981038,"Vua sáng chế - Tập 15",20000,20000,0,0
TIKI,nha-sach-tiki,188487640,"Dragon Ball Full Color - Phần Năm: Truy Lùng Cell Bọ Hung  - Tập 2 [Tặng Ngẫu Nhiên 1 Trong 2 Mẫu Postcard Nhân Vật]",68100,77000,8900,12
TIKI,nha-sach-tiki,2380007,"Khi Bạn Đang Mơ Thì Người Khác Đang Nỗ Lực",108800,136000,27200,20
TIKI,nha-sach-tiki,45349383,"Hashtag No.2 Fashion - Kinh Doanh Thời Trang Tại Thị Trường Việt Nam",153000,200000,47000,24
TIKI,nha-sach-tiki,193605374,"Làm Sao Để Che Giấu Một Đế Quốc - How To Hide An Empire",222000,299000,77000,26
TIKI,nha-sach-tiki,188940825,"Những Chàng Trai Ở Lộc Phong Quán – Tập 10 - Tặng 1 bookmark 2 mặt ",38100,48000,9900,21
TIKI,nha-sach-tiki,186434891,"Cá Cược Với Tình Yêu",95000,95000,0,0
TIKI,nha-sach-tiki,8886005,"Bay Trên Tổ Chim Cúc Cu (Tái Bản)",91500,118000,26500,22
TIKI,nha-sach-tiki,113583126,"Ngữ Pháp Tiếng Anh (Tái Bản)",57400,89000,31600,36
TIKI,nha-sach-tiki,90227346,"Sapiens: Lược Sử Loài Người Bằng Tranh - Tập 1: Khởi Đầu Của Loài Người",212100,345000,132900,39
TIKI,nha-sach-tiki,109018530,"Vườn Hoa Mạt Dược Ký Sự - Những Kỳ Án Nổi Tiếng Chưa Có Lời Giải (Tặng Kèm 1 Bookmark Chữ Nhật)",90100,139000,48900,35
TIKI,nha-sach-tiki,170094968,"Atlas Giải Phẫu Cơ Thể Người - Tái Bản",502000,680000,178000,26
TIKI,nha-sach-tiki,95090377," Bút màu sáp dầu học sinh hộp nhựa Deli - 12/18/24 màu - 72090/72091/72092",52200,52200,0,0
TIKI,nha-sach-tiki,187619074,"Quý Cô Tài Chính",103000,139000,36000,26
TIKI,nha-sach-tiki,13673970,"Combo Trinh Thám Giây Thứ 12 (2 Tập)",95000,276000,181000,66
TIKI,nha-sach-tiki,173093792,"Thao Túng Tâm Lý - Nhận Diện, Thức Tỉnh Và Chữa Lành Những Tổn Thương Tiềm Ẩn",126800,169000,42200,25
TIKI,nha-sach-tiki,170463582,"Siêu Nhí Biết Tuốt - 101 Bí Ẩn Kích Thích Tò Mò Của Các Bạn Nhỏ",124800,240000,115200,48
TIKI,nha-sach-tiki,58441509,"Ăn Uống Đúng Cách: Bộ Quy Tắc Ẩm Thực Lành Mạnh",86500,116000,29500,25
TIKI,nha-sach-tiki,77324132,"Phụ Nữ Hiểu Biết Sẽ Có Cuộc Sống Đẳng Cấp Hơn (Tặng Kèm Bookmark)",85900,119000,33100,28
TIKI,nha-sach-tiki,75813201,"Không Đến Một (Tái Bản - Bìa Cam)",79200,110000,30800,28
TIKI,nha-sach-tiki,185595374,"Picasso Và Bức Tranh Khiến Thế Giới Sửng Sốt",299000,399000,100000,25
TIKI,nha-sach-tiki,191506179,"Sách Bạn Thật Sự Là Ai?",60600,88000,27400,31
TIKI,nha-sach-tiki,174038838,"Here U Are – Tập 2 - Bản Thường: Tặng Kèm 1 Bookmark Bế Hình",88600,110000,21400,19
TIKI,nha-sach-tiki,335337,"Tôi Tài Giỏi - Bạn Cũng Thế",128050,135000,6950,5
TIKI,nha-sach-tiki,87389629,"OSHO - Sáng Tạo Bừng Cháy Sức Mạnh Bên Trong (Tái Bản)",72500,108000,35500,33
TIKI,nha-sach-tiki,195306000,"Tư trị thông giám - Tập 9",211000,285000,74000,26
TIKI,nha-sach-tiki,195801645,"Thực Học Của Inamori Kazuo: Quản Trị Và Kế Toán",64000,95000,31000,33
TIKI,nha-sach-tiki,176473191,"Bút màu marker lẻ chiếc 2 đầu to nhỏ nhiều màu thân bút vuông màu đen Deli - Tô màu vẽ tranh trang trí sổ tay - 70701",4000,9000,5000,56
TIKI,nha-sach-tiki,130314065,"Tâm lý thị trường chứng khoán - Hành vi đám đông và sự thật đằng sau những con sóng",37100,50000,12900,26
TIKI,nha-sach-tiki,193684717,"Từ Vũ Trụ Đến Trái Tim – Những Thông Điệp Yêu Thương",88100,89000,900,1
TIKI,nha-sach-tiki,137241842,"Trồng Một Nụ Cười - Cùng Trẻ Thực Hành Chánh Niệm",138000,199000,61000,31
TIKI,nha-sach-tiki,95090744," Bút chì lục giác Deli - loại 2B/HB - 30 chiếc/hộp - 58166 / 58167",45000,99000,54000,55
TIKI,nha-sach-tiki,56878836,"Sách Muôn Kiếp Nhân Sinh (Bìa Cứng) - Nguyên Phong",169000,228000,59000,26
TIKI,nha-sach-tiki,185024355,"Spy X Family 7",25000,25000,0,0
TIKI,nha-sach-tiki,142002263,"Muôn Kiếp Nhân Sinh 2 (Bìa Cứng)",338000,338000,0,0
TIKI,nha-sach-tiki,67477613,"Xin Bạn Hãy Ôm Lấy Trái Tim Mình Trước Đã (Tặng Kèm 1 Bookmark)",64800,96000,31200,33
TIKI,nha-sach-tiki,190214568,"Kỷ luật bản thân",132300,189000,56700,30
TIKI,nha-sach-tiki,193981046,"Tiệm trừ yêu kì ảo - Tập 17",33000,35000,2000,6
TIKI,nha-sach-tiki,117035933,"Sách: Hài Hước Một Chút Thế Giới Sẽ Khác Đi (Tái Bản)",64000,80000,16000,20
TIKI,nha-sach-tiki,32192510,"Madame Chic - Rất Thần Thái, Rất Paris",64000,99000,35000,35
TIKI,nha-sach-tiki,26593338,"Misty Morning Walk With Mother - Cùng Mẹ Đi Trong Sương Sớm",41000,85000,44000,52
TIKI,nha-sach-tiki,107363748,"Bút chì màu dạng cốc Deli - bút chì gỗ khô tự nhiên an toàn -  12/24/36/48 màu - 7070",52200,52200,0,0
TIKI,nha-sach-tiki,107802188,"Bí Mật Tư Duy Triệu Phú (Tái Bản)",75100,108000,32900,30
TIKI,nha-sach-tiki,75403873,"Bộ Màu Nước Solid Water Color Cao Cấp - Tặng Kèm 2 Bút Nước, 2 Mút, 1 Palette - Chuyên Dùng Cho Học Sinh, Sinh Viên, Vẽ Chuyên Nghiệp - Hàng Chính Hãng - VinBuy",65000,120000,55000,46
TIKI,nha-sach-tiki,126853168,"Thấu hiểu Hành vi giá Thị trường Tài chính (Understanding Price Action)",367000,367000,0,0
TIKI,nha-sach-tiki,189371286,"[ Gift] [Hàng Tặng Không Bán] Sổ Tay Sức Khỏe DHC",50000,50000,0,0
TIKI,nha-sach-tiki,117681065,"Sống Thực Tế Giữa Đời Thực Dụng (Tái Bản)",92400,129000,36600,28
TIKI,nha-sach-tiki,174377494,"Combo 10 cuốn Ehon Ươm mầm Tính cách",202800,390000,187200,48
TIKI,nha-sach-tiki,49249526,"Thiết Kế Cuộc Đời Thịnh Vượng - Design a Prosperous Life",299000,299000,0,0
TIKI,nha-sach-tiki,41131985,"Thực Hành 7 Thói Quen Của Bạn Trẻ Thành Đạt",54100,78000,23900,31
TIKI,nha-sach-tiki,106788395,"Toán Tư duy - Beginning Creative Math (Dành cho bé 4-6 tuổi/Song ngữ Việt - Anh)",57200,110000,52800,48
TIKI,nha-sach-tiki,544731,"Giáo Trình Chuẩn HSK 2 - Bài Học (Kèm file MP3)",149000,198000,49000,25
TIKI,nha-sach-tiki,140416366,"Hôm Nay Phải Mở Mang (Một Tựa Sách Của Ngày Ngày Viết Chữ Dành Cho Người Học Viết Và Làm Nghề Viết)",93500,119000,25500,21
TIKI,nha-sach-tiki,111290700,"Bố Già (Bìa Cứng) (Tái Bản)",149175,250000,100825,40
TIKI,nha-sach-tiki,178483666,"Những Lời Giáo Huấn Của Epictetus",171000,239000,68000,28
TIKI,nha-sach-tiki,23433003,"30 Chủ Đề Từ Vựng Tiếng Anh (Tập 1)",123000,190000,67000,35
TIKI,nha-sach-tiki,149573910,"Thiên Quan Tứ Phúc - Tập 4",110700,159000,48300,30
TIKI,nha-sach-tiki,142791749,"Sự Trỗi Dạy Và Suy Tàn Của Đế Chế Thứ 3 (Tái Bản)",275000,445000,170000,38
TIKI,nha-sach-tiki,4466841,"Trưởng Thành Sau Ngàn Lần Tranh Đấu (Tái Bản)",69100,95000,25900,27
TIKI,nha-sach-tiki,126474205,"Làm giàu từ chứng khoán bằng phương pháp VSA chính gốc: Nghiên cứu chuyên sâu về cách giao dịch của Wyckoff",499000,499000,0,0
TIKI,nha-sach-tiki,192125806,"Dạy con làm giàu - Tập 11 - Trường dạy kinh doanh cho những người thích giúp đỡ người khác (Tái Bản 2022)",53000,80000,27000,34
TIKI,nha-sach-tiki,116835635,"Tớ Học Lập Trình - Làm Quen Với Python",78300,105000,26700,25
TIKI,nha-sach-tiki,192692368,"Phương Pháp Thực Chiến Hiệu Suất Cao Đến Từ Nhà Quán Quân Giao Dịch Tài Chính",364000,364000,0,0
TIKI,nha-sach-tiki,197629362,"Bức Họa Múa Rối Xương (Combo tập 1+2)",217000,279000,62000,22
TIKI,nha-sach-tiki,174605333,"Châu Phi Nghìn Trùng (Tái Bản)",123000,165000,42000,25
TIKI,nha-sach-tiki,1445365,"Dưới Một Mái Nhà Ở Paris",87600,119000,31400,26
TIKI,nha-sach-tiki,971704,"Tạo Lập Mô Hình Kinh Doanh (Tái bản)",185400,299000,113600,38
TIKI,nha-sach-tiki,175845415,"Bí Quyết Tìm Kiếm Mặt Bằng Kinh Doanh - Đến Sahara Mở Quán Trà Đá - Bộ Sách Khởi Nghiệp Bán Lẻ",169000,199000,30000,15
TIKI,nha-sach-tiki,106997685,"Keo dán siêu chắc Sealant Fix - Giải pháp thay thế đinh vít",21000,21000,0,0
TIKI,nha-sach-tiki,95311757,"Lưu Thông Máu Tốt Hóa Giải Bách Bệnh",68800,99000,30200,31
TIKI,nha-sach-tiki,113655308,"Giáo Trình Kinh Tế Chính Trị Mác – Lênin (Dành Cho Bậc Đại Học Hệ Không Chuyên Lý Luận Chính Trị) - Bộ mới năm 2021",59000,59000,0,0
TIKI,nha-sach-tiki,190701636,"Yuri Espoir (Tập 2) - Bản thường: tặng kèm postcard",59100,79000,19900,25
TIKI,nha-sach-tiki,171549988,"Trường An Ly Ca 2 - Vén Mây Thấy Trời",127000,165000,38000,23
TIKI,nha-sach-tiki,193446626,"Chòm Sao Linh Thú Tập 8 [Tặng kèm Bookmark]",39000,40000,1000,3
TIKI,nha-sach-tiki,106149744,"Tôi Đã Kiếm 2.000.000 Đô La Từ Thị Trường Chứng Khoán Như Thế Nào (Tái Bản)",63220,109000,45780,42
TIKI,nha-sach-tiki,142675354,""Từ Điển" Sử Dụng Loài Người",75500,105000,29500,28
TIKI,nha-sach-tiki,50773990,"Triết Lý Kinh Doanh Của Kyocera",124000,175000,51000,29
TIKI,nha-sach-tiki,55605172,"Tắt Đèn (Tái Bản 2020)",33000,50000,17000,34
TIKI,nha-sach-tiki,137561095,"Combo 2 Cuốn Sách Tâm Lý Học Nhập Môn: Toàn Thư Tâm Lý Học + Từ Điển Tâm Lý",183000,254000,71000,28
TIKI,nha-sach-tiki,181699672,"Shuggie Bain: Chiếc Linh Hồn Nhỏ",156000,235000,79000,34
TIKI,nha-sach-tiki,110944248,"Tôi Không Thích Ồn Ào (Tặng Kèm Bookmark)(Tái Bản)",55000,75000,20000,27
TIKI,nha-sach-tiki,136232535,"Ux Content 4.0 (Chọn Đúng Chữ, Giữ Người Dùng)",117000,139000,22000,16
TIKI,nha-sach-tiki,273896677,"Trí Tuệ Do Thái",141000,189000,48000,25
TIKI,nha-sach-tiki,197602052,"Fullmetal Alchemist - Cang Giả Kim Thuật Sư - Fullmetal Edition Tập 7",62000,69000,7000,10
TIKI,nha-sach-tiki,53434797,"Sách Tài Chính Cá Nhân Cho Người Việt Nam - Tặng Khóa học Online về Tài chính",200000,200000,0,0
TIKI,nha-sach-tiki,96327064,"Bye Béo - Cách giảm 7kg trong 30 ngày",199000,199000,0,0
TIKI,nha-sach-tiki,98733259,"Những Tù Nhân Của Địa Lí - Khám Phá Sự Vận Hành Của Thế Giới Qua Những Tấm Bản Đồ - Phiên Bản Minh Hoạ Màu Dành Cho Độc Giả Trẻ",162000,230000,68000,30
TIKI,nha-sach-tiki,192124401,"Kingdom -Tập 31",43600,45000,1400,3
TIKI,nha-sach-tiki,185226873,"Achievers Grade 7 Student's Book with CLIL Book",251000,251000,0,0
TIKI,nha-sach-tiki,188039858,"Combo 4 Cuốn Sổ Tay Ghi Chép A5 Gáy Xoắn 120 Trang Kẻ Ngang Deli - Phù Hợp Làm Sổ Kế Hoạch Planner, Nhật Kí, Tập Vở Ghi Chép Bullet Journal - LA560-06",18000,37800,19800,52
TIKI,nha-sach-tiki,193099631,"Đại Gia Gatsby",59000,86000,27000,31
TIKI,nha-sach-tiki,197602124,"Fullmetal Alchemist - Cang Giả Kim Thuật Sư - Fullmetal Edition - Tập 6",61100,69000,7900,11
TIKI,nha-sach-tiki,187827390,"Gửi Tới Người Mùa Đông Này Sẽ Không Còn Nữa",95400,123000,27600,22
TIKI,nha-sach-tiki,3876677,"Hỏa Ngục",149000,239000,90000,38
TIKI,nha-sach-tiki,83664156,"Rio Book No.2 - Nhận Diện Thương Hiệu, Những Điểm Chạm Thị Giác (Tái Bản)",127000,170000,43000,25
TIKI,nha-sach-tiki,162832796,"Rilla Dưới Mái Nhà Bên Ánh Lửa",155000,200000,45000,23
TIKI,nha-sach-tiki,23437685,"English Vocabulary in Use: Pre-Intermediate and Intermediate Book with Answers: Vocabulary Reference and Practice (Kèm CD)",177600,193000,15400,8
TIKI,nha-sach-tiki,139979522,"Ăn Dặm Kiểu Nhật (Tái Bản)",127000,189000,62000,33
TIKI,nha-sach-tiki,105778970,"Nhật Ký Tarot",158000,199000,41000,21
TIKI,nha-sach-tiki,11336581,"Rich Habits - Thói Quen Thành Công Của Những Triệu Phú Tự Thân",110000,158000,48000,30
TIKI,nha-sach-tiki,106206473,"Thân Gửi Sở Thú",61100,79000,17900,23
TIKI,nha-sach-tiki,187933551,"Reiki - Nghệ Thuật Chữa Lành Bằng Năng Lượng",131600,189000,57400,30
TIKI,nha-sach-tiki,57590002,"Fullmetal Alchemist - Cang Giả Kim Thuật Sư - Fullmetal Edition Tập 5",61000,69000,8000,12
TIKI,nha-sach-tiki,188663311,"Khi Bạn Đang Mơ Thì Người Khác Đang Nỗ Lực (2022)",91200,136000,44800,33
TIKI,nha-sach-tiki,43859629,"Người giàu nhất thành Babylon - phiên bản đầy đủ thêm 2 chương mới",54000,80000,26000,33
TIKI,nha-sach-tiki,192474352,"Vẻ Đẹp Của Sự Vừa Đủ",114000,136000,22000,16
TIKI,nha-sach-tiki,56377199,"Giải Mã Siêu Trí Tuệ",126000,169000,43000,25
TIKI,nha-sach-tiki,897016,"Combo Sân Chơi Trí Tuệ Của Chim Đa Đa (Bộ 6 Cuốn)",125000,180000,55000,31
TIKI,nha-sach-tiki,178514165,"Dọc Đường",124000,160000,36000,23
TIKI,nha-sach-tiki,54433518,"Combo Sách Học Tiếng Anh Little Stories 1 (5 Cuốn)",226000,325000,99000,30
TIKI,nha-sach-tiki,191571530,"Văn Phòng Thám Tử Quái Vật - Tập 09",29100,30000,900,3
TIKI,nha-sach-tiki,140635218,"Nuôi Dạy Đứa Trẻ Tự Chủ",130000,179000,49000,27
TIKI,nha-sach-tiki,147802908,"Trong Cái Không Có Gì Không ? - Thiền Sư Thích Nhất Hạnh (NXB KĐ - bìa cứng)",144000,160000,16000,10
TIKI,nha-sach-tiki,193917225,"Vẽ Vời Vẩn Vơ - 3",19000,58000,39000,67
TIKI,nha-sach-tiki,67991600,"Nghệ Thuật Từ Chối – Cách Nói Không Mà Vẫn Có Được Đồng Thuận",56000,82000,26000,32
TIKI,nha-sach-tiki,174449882,"“Lần Đầu Làm Sếp” – (Your First Leadership Job)",137000,195000,58000,30
TIKI,nha-sach-tiki,104315085,"Tư Duy Logic (Tái Bản)",71800,110000,38200,35
TIKI,nha-sach-tiki,143185998,"Ăn Dặm Không Phải Là Cuộc Chiến (Tái Bản)",197000,289000,92000,32
TIKI,nha-sach-tiki,192677821,"Sổ tay công thức giải nhanh Toán 12",59000,98000,39000,40
TIKI,nha-sach-tiki,168367080,"Thông Não Ielts Reading Cùng Linear",432000,499000,67000,13
TIKI,nha-sach-tiki,3640427,"Quẳng Gánh Lo Đi Và Vui Sống (Nguyễn Hiến Lê - Bộ Sách Sống Sao Cho Đúng)",56100,90000,33900,38
TIKI,nha-sach-tiki,150956757,"Combo 8 cuốn Túi tô màu Tập làm họa sĩ nhí",43680,84000,40320,48
TIKI,nha-sach-tiki,110965784,"Keo Dán Giày Siêu Chắc Chống Nước Tốt Seaglue 100g",69000,79000,10000,13
TIKI,nha-sach-tiki,11806671,"Combo Doraemon Truyện Tranh Màu Kỹ Thuật Số (6 Tập)",161000,180000,19000,11
TIKI,nha-sach-tiki,76278485,"Ảo Dạ (Tái Bản)",133000,179000,46000,26
TIKI,nha-sach-tiki,149257065,"Keanu Reeves - Ma Trận Cuộc Đời (Bí Ẩn Đằng Sau Người Đàn Ông Tử Tế Nhất Hành Tinh)",80000,168000,88000,52
TIKI,nha-sach-tiki,189641377,"Kombucha - Tuyệt Đỉnh Thức Uống Lên Men",249000,320000,71000,22
TIKI,nha-sach-tiki,131879454,"Combo Philip Kotler: Tiếp Thị 5.0 - Công Nghệ Vị Nhân Sinh Và Tiếp Thị 4.0 - Dịch Chuyển Từ Truyền Thống Sang Công Nghệ Số",223250,235000,11750,5
TIKI,nha-sach-tiki,65786287,"Triệu phú thức tỉnh - bí kíp để khơi dòng suối nguồn thịnh vượng trong tâm thức",214400,268000,53600,20
TIKI,nha-sach-tiki,116158321,"7 Chiến Lược Thịnh Vượng Và Hạnh Phúc (Tái Bản 2021)",68000,85000,17000,20
TIKI,nha-sach-tiki,185889844,"Tại Sao Chúng Tôi Muốn Bạn Giàu",89000,135000,46000,34
TIKI,nha-sach-tiki,177736624,"Mặc Kệ Thiên Hạ - Sống Như Người Nhật (Tái Bản)",71000,94000,23000,24
TIKI,nha-sach-tiki,195291930,"Bốn Thỏa Ước",84000,130000,46000,35
TIKI,nha-sach-tiki,58971674,"Sách Nghệ Thuật Bán Hàng Của Người Do Thái (Tái Bản 2020)",61100,88000,26900,31
TIKI,nha-sach-tiki,178032047,"Fullmetal Alchemist - Cang Giả Kim Thuật Sư - Fullmetal Edition Tập 14 [Tặng Kèm Bookmark Pvc]",61100,69000,7900,11
TIKI,nha-sach-tiki,65008052,"Từ Điển Anh - Anh - Việt",208600,298000,89400,30
TIKI,nha-sach-tiki,148802204,"Chuyện Trà - Lịch Sử Một Thức Uống Lâu Đời Của Người Việt (Bìa Mềm)",216000,290000,74000,26
TIKI,nha-sach-tiki,52798281,"Phương Pháp Giáo Dục Sớm Montessori Cho Trẻ Từ
0 – 3 Tuổi",63000,99000,36000,36
TIKI,nha-sach-tiki,85923342,"Minh Triết Trong Ăn Uống Của Phương Đông (Tái Bản)",122000,168000,46000,27
TIKI,nha-sach-tiki,121372698,"NGÀI CÓC ĐI GẶP BÁC SĨ TÂM LÝ ( BÌA CỨNG)",152500,219000,66500,30
TIKI,nha-sach-tiki,163165281,"Mong Mẹ Hãy Yêu Lấy Chính Mình",72100,99000,26900,27
TIKI,nha-sach-tiki,74981856,"Gửi Bạn, Người Đã Kiệt Sức Vì Những Chịu Đựng Âm Thầm [Tặng Kèm: 1 Bookmark Daisy]",66700,96000,29300,31
TIKI,nha-sach-tiki,1734377,"Những Chú Chó Bán Hàng",89000,140000,51000,36
TIKI,nha-sach-tiki,193605360,"Chuyện Xưa Tôi Nhớ Người Cũ Đã Quên (Lam – Lê)",64500,89000,24500,28
TIKI,nha-sach-tiki,7644510,"Lòng Tốt Của Bạn Cần Thêm Đôi Phần Sắc Sảo",80500,108000,27500,25
TIKI,nha-sach-tiki,185435293,"Nhân Sinh Nơi Nơi Đều Là Tu Hành ( Tặng 1 Bookmark 02 mặt + 1 Sổ phụ chương khổ 12x16cm)",144000,145000,1000,1
TIKI,nha-sach-tiki,146223395,"Cách thức kinh doanh và đầu cơ cổ phiếu! – How to Trade in Stocks",349000,349000,0,0
TIKI,nha-sach-tiki,174215331,"Ajin - Boxset Số 2 (Tập 7 - 12) - Tặng Kèm Bookmark 3D",214000,300000,86000,29
TIKI,nha-sach-tiki,114765005,"Vụng Trộm Yêu Anh - Tập 1+2 (Tặng Kèm: 02 Bookmark 2 Mặt Theo Bìa)",178000,249000,71000,29
TIKI,nha-sach-tiki,121185868,"Vang Bóng Một Thời (Việt Nam Danh Tác)",58000,76000,18000,24
TIKI,nha-sach-tiki,191571328,"Black Jack (Bản Đặc Biệt) - Tập 12",134000,135000,1000,1
TIKI,nha-sach-tiki,127077157,"Bà Tổng Thống Trước Họng Súng - Hai Số Phận - Phần III",114000,169000,55000,33
TIKI,nha-sach-tiki,28292286,"Combo 30 Chủ Đề Từ Vựng Tiếng Anh (2 Tập)",245000,380000,135000,36
TIKI,nha-sach-tiki,192909296,"Anh Em Phi Hành Gia - Tập 31",32600,45000,12400,28
TIKI,nha-sach-tiki,75636226,"Phương pháp VPA - Kỹ thuật nhận diện Dòng Tiền Thông Minh bằng Hành Động Giá kết hợp Khối Lượng Giao Dịch",357000,357000,0,0
TIKI,nha-sach-tiki,104273017,"Combo 2 Tập: Tăng Thông Khí - Bản Thường - (Tặng Kèm 2 Bookmark In 2 Mặt)(Bìa Mềm)",182000,258000,76000,29
TIKI,nha-sach-tiki,186265452,"My Hero Academia - Học Viện Siêu Anh Hùng Tập 29: Bakugo Katsuki: Trỗi Dậy",25000,25000,0,0
TIKI,nha-sach-tiki,167686691,"Sách Tổng Ôn Cấp Tốc Toán Học 12, Sách Ôn Thi THPT Quốc Gia Moon",149000,200000,51000,26
TIKI,nha-sach-tiki,184779709,"Xã Hội Học - Khái Lược Những Tư Tưởng Lớn",284000,390000,106000,27
TIKI,nha-sach-tiki,184629090,"Lấy Nước Đường Xa",68800,99000,30200,31
TIKI,nha-sach-tiki,9490657,"Hệ thống giao dịch Ichimoku Charts - Ichimoku Kinko Clouds (Phiên bản sách năm 2018)",330000,330000,0,0
TIKI,nha-sach-tiki,184782104,"Cha Mẹ Độc Hại (Tái Bản)",110000,148000,38000,26
TIKI,nha-sach-tiki,165030714,"Black Jack 07 (Bìa Mềm)",28000,30000,2000,7
TIKI,nha-sach-tiki,467896,"Trà Hoa Nữ (Tái Bản)",33000,50000,17000,34
TIKI,nha-sach-tiki,84950236,"Người Nhạy Cảm Trong Thế Giới Vô Cảm",56100,85000,28900,34
TIKI,nha-sach-tiki,110447680,"Kế Hoạch Marketing Trên Một Trang Giấy (Những Chỉ Dẫn Dễ Hiểu Nhất Cho Một Kế Hoạch Marketing Thông Minh)",104200,159000,54800,34
TIKI,nha-sach-tiki,69624539,"Khoa Học Về Yoga",223000,300000,77000,26
TIKI,nha-sach-tiki,187001113,"Giấy bọc sách vở / Giấy gói quà / giấy bao tập / giấy bao vở học sinh, sinh viên size A4, B5, A5 cao cấp – 24 cuốn",49000,88000,39000,44
TIKI,nha-sach-tiki,13061338,"Series Địch Công Kỳ Án Tập 15 - Hoa Văn Cây Liễu",49500,99000,49500,50
TIKI,nha-sach-tiki,186202768,"Và Rồi Tháng 9 Không Có Cậu Đã Tới (Tái Bản)",75800,106000,30200,28
TIKI,nha-cua-doi-song,206165460,"Cây lau nhà VILEDA Turbo Easy Wring&Clean đầu lau tam giác, gồm xô giặt và cây lau nhà - TSU162214",579000,579000,0,0
TIKI,nha-cua-doi-song,73785488,"Bộ 3 nồi inox 4 đáy Nagakawa NAG1306 (16cm, 20cm, 24cm) - Quai mạ vàng - Dùng trên mọi loại bếp - Hàng Chính Hãng",528000,1000000,472000,47
TIKI,nha-cua-doi-song,28619438,"Thang nhôm rút gọn SUMIKA SK320 - Chiều cao tối đa 3.2m, chiều dài rút gọn 0.8m, hợp kim nhôm cao cấp, khóa chốt chắc chắn, đế cao su chống trượt, nhỏ gọn, di chuyển tiện lợi",1139000,1500000,361000,24
TIKI,nha-cua-doi-song,73124602,"Bình Giữ Nhiệt Bằng Thép Không Gỉ Lock&Lock Vacuum Bottle LHC6180SLV (800ML) - Màu",352000,677000,325000,48
TIKI,nha-cua-doi-song,99868980,"Bình Giữ Nhiệt Locknlock Bucket Tumbler 540ml LHC4269WHT",284000,473000,189000,40
TIKI,nha-cua-doi-song,193108477,"Bộ Ghế Lười K-Bean Canvas Xám Xanh ",1400000,1400000,0,0
TIKI,nha-cua-doi-song,272363198,"Chảo chống dính Elmich EL7103Max size",261000,314250,53250,17
TIKI,nha-cua-doi-song,169848307,"Kệ Wifi Treo Tường 2 Tầng Không Cần Khoan Để Đầu Thu Kỹ Thuật Số, Remote, Điện Thoại - IG407",56000,60000,4000,7
TIKI,nha-cua-doi-song,51699604,"Ghế lười Dream Micro  HomeDream - HOMEDREAM-MRH",1000000,1000000,0,0
TIKI,nha-cua-doi-song,271063530,"Mua 3 Tặng 2 Bộ 3 Đôi Găng Tay Cao Su Ngọc Trai Tay Lửng Size L",99000,159000,60000,38
TIKI,nha-cua-doi-song,53789448,"Bộ cây lau nhà tự vắt thông minh, chổi lau nhà 360 độ, lau sạch khô nhanh - Parroti Pro PR01",419000,799000,380000,48
TIKI,nha-cua-doi-song,15737169,"Đế Đèn LED 3D Có Điều Khiển Remote 16 Màu Đèn",75000,75000,0,0
TIKI,nha-cua-doi-song,33067171,"Áo mưa dây kéo vải dù tổ ong chống thấm ( nhiều màu)",95000,95000,0,0
TIKI,nha-cua-doi-song,181971817,"Nệm cao su thiên nhiên Rosi massage Thắng Lợi, Đệm cao su thiên nhiên hàng chính hãng",3350000,3350000,0,0
TIKI,nha-cua-doi-song,193176687,"Bộ Ghế Lười Dream Mickey Đen Home Dream",1300000,1300000,0,0
TIKI,nha-cua-doi-song,58804363,"Dụng Cụ Băm Rau Củ Quả Lock&amp;Lock Quick Chopper CKS310BLU",112000,216000,104000,48
TIKI,nha-cua-doi-song,248184506,"Combo 2 nắp bồn cầu thông minh dùng cơ Bumia bidet, tự rửa vệ sinh hậu môn và vệ sinh cho phụ nữ , vòi xịt vệ sinh thông minh, mã BM-01V",2879000,2879000,0,0
TIKI,nha-cua-doi-song,84566545,"Ổ cắm điện đa năng kết hợp ổ cắm USB Nakagami chất lượng cao công nghệ Nhật Bản - Màu ngẫu nhiên",159000,159000,0,0
TIKI,nha-cua-doi-song,83412126,"Bình Giữ Nhiệt Lock&Lock Energetic One-Touch Tumbler LHC3249 - 550ML",264000,528000,264000,50
TIKI,nha-cua-doi-song,11488920,"Bình Giữ Nhiệt Lock&Lock RigaTumbler (Shanghai) LHC4160RED  897ml - màu Red",372000,715000,343000,48
TIKI,nha-cua-doi-song,1657931,"Vợt Muỗi Sunhouse SHE-E200 - Vàng",72000,119000,47000,39
TIKI,nha-cua-doi-song,99994000,"Bình giữ nhiệt có ống hút Lock&Lock Bucket Tumbler with Straw LHC4268 540ml - Màu",284000,473000,189000,40
TIKI,nha-cua-doi-song,122692850,"Cây chà sàn thông minh cao cấp, chổi chà sàn đa năng 2 trong 1, cọ sàn và gạt nước – Parroti Easy ES02",129000,199000,70000,35
TIKI,nha-cua-doi-song,54484578,"Đèn Bàn Học LED USB Di Động Cao Cấp Có Thể Gập Hai Chỗ – 03 Chế Độ Ánh Sáng Vàng Bảo Vệ Mắt Chống Cận eLights - Đèn Cắm Dây",185000,199000,14000,7
TIKI,nha-cua-doi-song,186558014,"Combo 10 Móc Dán Tường Treo Đồ Đa Năng Siêu Chịu Lực",25000,25000,0,0
TIKI,nha-cua-doi-song,187636657,"Keo Dán Giày Đa Năng Dán Mọi Loại Giày, Chống Thấm",45000,45000,0,0
TIKI,nha-cua-doi-song,17423771,"5 Viên Pin CR2032 3V Panasonic Lithium thay pin Smartkey , Cmos , Pin thay Airtag - Hàng chính hãng",77000,100000,23000,23
TIKI,nha-cua-doi-song,99621372,"Bình giữ nhiệt Lock&amp;Lock Belt Bottle LHC4267IVY490ml - Màu",284000,473000,189000,40
TIKI,nha-cua-doi-song,104270135,"Bình Giữ Nhiệt LocknLock Featherlight One-touch Tumbler 500ml LHC3257WHT - Màu trắng",269000,517000,248000,48
TIKI,nha-cua-doi-song,75614459,"Thùng rác treo tủ bếp có nắp đậy thông minh, thùng rác treo tường dán tường, có thanh trượt cửa bếp – Parroti Bin BN01/BIN01",299000,299000,0,0
TIKI,nha-cua-doi-song,92453371,"Áo Mưa Cánh Dơi Có Kiếng Đèn, Áo Mưa Kiếng Đèn Vải Dù Loại Siêu Dày, Hàng Việt Nam, Khổ To Rộng, Chống Thấm Hiệu Quả, Phù Hợp Nam Và Nữ, Có Túi Đựng, Có Lựa Chọn Màu Sắc",130000,130000,0,0
TIKI,nha-cua-doi-song,193213376,"Bộ Ghế Lười I-Relax Xanh Đen Home Dream",1250000,1250000,0,0
TIKI,nha-cua-doi-song,116819040,"Thước Dây 1,5m - YOGA QG, Thước Dây May Má, Đo Chiều Cao Cho Bé, Đo Kích Thước Ba Vòng",9999,9999,0,0
TIKI,nha-cua-doi-song,107961500,"Ly Nhựa 2 Lớp LocknLock Double Wall Cold Cup Cherry Blossom 750ml HAP509WHT - Màu",130000,217000,87000,40
TIKI,nha-cua-doi-song,2119173,"Cây Lau Nhà Dạng Xịt Nước Lock&Lock ETM472",280000,539000,259000,48
TIKI,nha-cua-doi-song,273554952,"Phin nhôm hoa văn Trung Nguyên - Màu vàng",79000,79000,0,0
TIKI,nha-cua-doi-song,48045630,"5 Viên Pin Smartkey - Cmos Panasonic CR2032 - Hàng Chính Hãng",80000,100000,20000,20
TIKI,nha-cua-doi-song,52574827,"Ô (dù) tự động 2 chiều cao cấp DandiHome chống UV",104500,110000,5500,5
TIKI,nha-cua-doi-song,92521124,"Ủng Bọc Giày Đi Mưa Chống Nước Có Đế Chống Trơn Trượt Cao Cấp",39900,39900,0,0
TIKI,nha-cua-doi-song,217695866,"Bóng đèn LED Bulb MPE LBD E27 - Tiết kiệm điện, Tiêu chuẩn Châu Âu, Thương hiệu Việt Nam - Hàng Chính Hãng",41000,67000,26000,39
TIKI,nha-cua-doi-song,71890908,"Bộ lau nhà xoay 360 độ Sunhouse KS-CL330S",231000,406000,175000,43
TIKI,nha-cua-doi-song,71178441,"Áo Mưa Bít Dù Trơn, Áo Mưa Kín Người Vải Dù Siêu Dày, Chống Thấm Hiệu Quả, Phù Hợp Nam Và Nữ, Có Túi Đựng, Có Lựa Chọn Màu Sắc",115000,115000,0,0
TIKI,nha-cua-doi-song,173211404,"Ghế Xoay Văn Phòng Ngồi Làm Việc Công Thái Học Deli - Tay Gập Thông Minh, Có Ngả Lưng, Lưới Thoáng Khí, Chân Xoay Tiện Ích, Đệm Ghế Êm Aí - Phù Hợp Học Sinh, Văn Phòng, Game Thủ, Gaming - Hàng Chính Hãng - E4928 / E4929 / E4925 / E4926G",886000,1618200,732200,45
TIKI,nha-cua-doi-song,73125530,"Hộp cơm thủy tinh kèm muỗng đũa LocknLock LLG991CLNVY 930ml - Màu Navy",188000,362000,174000,48
TIKI,nha-cua-doi-song,273624233,"Bình giữ nhiệt LocknLock Metro Two Way LHC4272/LHC4274 - Hàng chính hãng",315000,605000,290000,48
TIKI,nha-cua-doi-song,90531871,"Đèn Pixar, Đèn Bàn Học Chống Cận Thị, Đèn Đọc Sách, Đèn Làm Việc Bảo Vệ Mắt - Hàng Chính Hãng Moontronics",139000,139000,0,0
TIKI,nha-cua-doi-song,892121,"Pin Max 8 + 4 Viên Energizer E91 BP8+4 AA",152000,180000,28000,16
TIKI,nha-cua-doi-song,2119169,"Bộ Cây Lau Nhà Lock&Lock Squeeze Flat Mop ETM471",509000,979000,470000,48
TIKI,nha-cua-doi-song,184126392,"Bình giữ nhiệt 450ml kèm cốc đẹp lõi INOX 304 cao cấp giữ nhiệt tới 8 tiếng chống tràn có cốc uống, có thể dùng làm quà tặng độc đáo",72995,72995,0,0
TIKI,nha-cua-doi-song,56941523,"Ly nhựa 2 lớp LocknLock kèm ống hút HAP507 750ml",113000,217000,104000,48
TIKI,nha-cua-doi-song,94778000,"Ô Dù che nắng, che mưa, có nút bấm 2 chiều, hàng chất lượng, dễ thương, thiết kế sang trọng và bền bỉ, ô dù có lựa chọn màu sắc",196000,196000,0,0
TIKI,nha-cua-doi-song,273663747,"Kèn Melodion/ Pianica/ Melodica Suzuki MX-37C - Hàng Chính Hãng",1039000,1039000,0,0
TIKI,nha-cua-doi-song,3480627,"Bộ Cây Lau Nhà Xoay Tay Compact Spin Mop Lock&Lock ETM466: Thùng Giặt + Cây + Bông Lau",480000,924000,444000,48
TIKI,nha-cua-doi-song,46202190,"Combo nhiều túi lưới giặt đồ cho máy giặt bảo vệ quần áo chống biến dạng chất lượng tốt dây kéo lưới mịn Polyester",42000,42000,0,0
TIKI,nha-cua-doi-song,120552065,"Bình giữ nhiệt inox 304 Elmich EL-8013OL dung tích 480ml",139000,389000,250000,64
TIKI,nha-sach-tiki,157255019,"Bộ Màu Nước Nén Water Color Cao Cấp 24 36 48 Màu Tặng Bút Lông Nước, Mút, Cọ, Tẩy, Bút Chì, Gọt, Màu Trắng Deli - Chuyên Dùng Cho Học Sinh, Sinh Viên, Vẽ Mĩ Thuật Chuyên Nghiệp - Ô tổ ong - 73936",135000,268200,133200,50
TIKI,nha-sach-tiki,110583137,"Bút highlight nhấn dòng dạ quang Deli - Cam/ Vàng/ Xanh Lá/ Hồng/ Xanh Dương - S625",8333,17400,9067,52
TIKI,nha-sach-tiki,185242029,"Vũ Điệu Quỷ Satan",123000,158000,35000,22
TIKI,nha-sach-tiki,49722650,"12 Quy Luật Cuộc Đời: Thần Dược Cho Cuộc Sống Hiện Đại",194000,300000,106000,35
TIKI,nha-sach-tiki,62648437,"Kinh Doanh Dịch Vụ Tại Việt Nam - Tự Tay Vận Hành Hoạt Động Marketing Của Bạn",144000,190000,46000,24
TIKI,nha-sach-tiki,447164,"Tôi Vẽ - Phương Pháp Tự Học Vẽ Truyện Tranh",73000,100000,27000,27
TIKI,nha-sach-tiki,169621653,"Đến Ngày Gặp Anh",103800,115000,11200,10
TIKI,nha-sach-tiki,194205624,"Pippi Tất Dài",92000,125000,33000,26
TIKI,nha-sach-tiki,150783204,"Combo 10 miếng dán keo 2 mặt xốp siêu dính",20000,20000,0,0
TIKI,nha-sach-tiki,155049277,"IELTS Key Writing - Công Thức Học Nhanh IELTS Writing Task 1",78000,119000,41000,34
TIKI,nha-sach-tiki,273645890,"Trạm Đọc | Thuật Tẩy Não",141000,189000,48000,25
TIKI,nha-sach-tiki,6915413,"Nghệ Thuật Tối Giản: Có Ít Đi, Sống Nhiều Hơn (Tái bản)",69700,108000,38300,35
TIKI,nha-sach-tiki,80141519,"Hackers IELTS Basic- Writing",115420,199000,83580,42
TIKI,nha-sach-tiki,77982978,"The Master COACH - Con Đường Trở Thành Nhà Khai Vấn Tài Ba",97000,150000,53000,35
TIKI,nha-sach-tiki,57386279,"Quạt xếp, quạt vải cầm tay họa tiết hoa anh đào 21*38 cm+ Tặng kèm hình dán-Quạt xếp cầm tay nhỏ gọn phong cách",59000,73750,14750,20
TIKI,nha-sach-tiki,75953557,"Tâm Lý Học Về Tiền",132300,189000,56700,30
TIKI,nha-sach-tiki,160488838,"Axit Và Kiềm Trong Thực Dưỡng (Tái Bản)",53500,75000,21500,29
TIKI,nha-sach-tiki,74608742,"Vừa Đủ - Đẳng Cấp Sống Của Người Thụy Điển (Tái Bản)",64000,98000,34000,35
TIKI,nha-sach-tiki,13101929,"Series Địch Công Kỳ Án Tập 13 - Địch Gia Bát Án",66000,137000,71000,52
TIKI,nha-sach-tiki,158641027,"Kẻ Nhắc Tuồng (Tái Bản)",117000,155000,38000,25
TIKI,nha-sach-tiki,115897817,"Kỷ Luật Mềm Trong Gia Đình: Giáo Dục Trẻ 3 - 10 Tuổi Dành Cho Gia Đình Việt",118000,165000,47000,28
TIKI,nha-sach-tiki,181656866,"Lịch Sử Israel - Câu Chuyện Về Sự Hồi Sinh Của Một Dân Tộc (Daniel Gordis)",291000,389000,98000,25
TIKI,nha-sach-tiki,192788797,"Fly Me To The Moon - Tóm Lại Là Em Dễ Thương, Được Chưa - Tập 2",45000,55000,10000,18
TIKI,nha-sach-tiki,26272210,"Mọi người đều nói dối - Dữ liệu lớn, Dữ liệu mới và những điều Internet tiết lộ về chính chúng ta",127000,150000,23000,15
TIKI,nha-sach-tiki,87960389,"Keo Siêu Dính Đa Năng Deli - 7Ml/ 20Ml - 7140/7149",16200,16200,0,0
TIKI,nha-sach-tiki,81437585,"Tiếng Triều Dâng",105000,140000,35000,25
TIKI,nha-sach-tiki,173650547,"30 Chuyên Đề Ngữ Pháp Tiếng Anh Cô Trang Anh: Sách ID Tổng ôn Ngữ pháp Tiếng Anh Moonbook",189000,250000,61000,24
TIKI,nha-sach-tiki,155463014,"Quốc Gia Khởi Nghiệp - Câu Chuyện Về Nền Kinh Tế Thần Kỳ Của Israel (Tái Bản)",121220,209000,87780,42
TIKI,nha-sach-tiki,130233550,"Vượt Qua Âu Lo, Chữa Lành Tâm Trí - Kiểm Soát Trầm Cảm Trong 7 Tuần Bằng Liệu Pháp Nhận Thức Hành Vi",137000,189000,52000,28
TIKI,nha-sach-tiki,184466858,"Tâm Lý Học - Những Thí Nghiệm Não Bộ Chưa Được Tiết Lộ",93100,125000,31900,26
TIKI,nha-sach-tiki,104074993,"Nhảy Nhảy Nhảy (Tái Bản)",116000,169000,53000,31
TIKI,nha-sach-tiki,196204932,"[A3/A4/A5/A6] Giấy Vẽ Màu Nước Tệp 16 Tờ 300Gsm A3 / A4 / A5 / A6 Chuyên Dụng Hạng Hoạ Sĩ Watercolor Paper Cao Cấp Finenolo Deli - Dùng Cho Màu Nước Gouache Acrylic Nhiều Cọ - EC270",29000,63000,34000,54
TIKI,nha-sach-tiki,184774171,"Đũa - Chuyện Linh Dị",214000,289000,75000,26
TIKI,nha-sach-tiki,169262882,"Combo 2 cuốn Giáo Trình Hán Ngữ (Sách học Tiếng Trung dành cho người Việt) Giáo Trình Hán Ngữ Tập 1 + Giáo Trình Hán Ngữ Tập 2 (Phiên bản mới - Học bằng App McBooks)",170800,244000,73200,30
TIKI,nha-sach-tiki,153521902,"Những Người Phụ Nữ Bé Nhỏ",89800,129000,39200,30
TIKI,nha-sach-tiki,97825967,"Tuyển Tập Những Câu Chuyện Hay Nhất Của AESOP (Song Ngữ Anh - Việt)",72600,108000,35400,33
TIKI,nha-sach-tiki,132355750,"Võ Nguyên Giáp - Hào Khí Trăm Năm (Tái Bản)",116000,200000,84000,42
TIKI,nha-sach-tiki,101801426,"Sách IRED Books - ĐÚNG VIỆC - Một góc nhìn về câu chuyện KHAI MINH (Tái Bản) - Giản Tư Trung",125000,125000,0,0
TIKI,nha-sach-tiki,143226162,"Tỷ Phú Bán Giày (Tái Bản)",104200,159000,54800,34
TIKI,nha-sach-tiki,160081248,"Gấu Pooh Xinh Xắn",69700,90000,20300,23
TIKI,nha-cua-doi-song,206165460,"Cây lau nhà VILEDA Turbo Easy Wring&Clean đầu lau tam giác, gồm xô giặt và cây lau nhà - TSU162214",579000,579000,0,0
TIKI,nha-cua-doi-song,28619438,"Thang nhôm rút gọn SUMIKA SK320 - Chiều cao tối đa 3.2m, chiều dài rút gọn 0.8m, hợp kim nhôm cao cấp, khóa chốt chắc chắn, đế cao su chống trượt, nhỏ gọn, di chuyển tiện lợi",1139000,1500000,361000,24
TIKI,nha-cua-doi-song,51699604,"Ghế lười Dream Micro  HomeDream - HOMEDREAM-MRH",1000000,1000000,0,0
TIKI,nha-cua-doi-song,73785488,"Bộ 3 nồi inox 4 đáy Nagakawa NAG1306 (16cm, 20cm, 24cm) - Quai mạ vàng - Dùng trên mọi loại bếp - Hàng Chính Hãng",528000,1000000,472000,47
TIKI,nha-cua-doi-song,193108477,"Bộ Ghế Lười K-Bean Canvas Xám Xanh ",1400000,1400000,0,0
TIKI,nha-cua-doi-song,94724913,"Ron Dán Che Khe Cửa ,Chân Cửa,Khung Cửa CTFAST Chống Bụi, Ngăn Côn Trùng, Chống Ồn, Chống Thoát Nhiệt Điều Hòa, Chống Va Đập Cửa - Mẫu Cải Tiến 2021 ( Hàng Chính Hãng )",49000,68000,19000,28
TIKI,nha-cua-doi-song,146262084,"Gối Ngủ Memory Foam NOOZ Ruột Gối Cao Su Non Giúp Nâng Đỡ Đốt Sống Cổ Chống Đau Vai Gáy Ngủ Sâu Hỗ Trợ Chống Trào Ngược Phù Hợp Với Mọi Tư Thế Nằm Vỏ Gối Tencel",339000,560000,221000,39
TIKI,nha-cua-doi-song,78025846,"Khăn tắm Bamboo Life BL058 hàng chính hãng được làm từ sợi tre thiên nhiên mềm mại kháng khuẩn siêu thấm hút an toàn cho da",59000,59000,0,0
TIKI,nha-cua-doi-song,273554952,"Phin nhôm hoa văn Trung Nguyên - Màu vàng",79000,79000,0,0
TIKI,nha-cua-doi-song,272363198,"Chảo chống dính Elmich EL7102Max size",222000,269250,47250,18
TIKI,nha-cua-doi-song,271063530,"Mua 3 Tặng 2 Bộ 3 Đôi Găng Tay Cao Su Ngọc Trai Tay Lửng Size L",99000,159000,60000,38
TIKI,nha-cua-doi-song,181971817,"Nệm cao su thiên nhiên Rosi massage Thắng Lợi, Đệm cao su thiên nhiên hàng chính hãng",3350000,3350000,0,0
TIKI,nha-cua-doi-song,122700651,"Cây lau kính, gạt chùi kính đa năng 2 đầu trong 1 - Parroti Shiny SN01",129000,199000,70000,35
TIKI,nha-cua-doi-song,21441057,"Chảo Chống Dính Đá Sunhouse SBD18 - 18cm",187000,260000,73000,28
TIKI,nha-cua-doi-song,241804451," Móc INOX 304 Treo Đồ nặng, treo thớt, nồi niêu INOX 304 [CHỐNG NƯỚC, CHỐNG RỈ] Dán Mọi Bề Mặt",15000,15000,0,0
TIKI,nha-cua-doi-song,119195755,"Bộ lau nhà tự vắt thông minh, chổi lau nhà 360 độ, lau sạch khô nhanh - Parroti ProMax PX01",519000,849000,330000,39
TIKI,nha-cua-doi-song,248184506,"Combo 2 nắp bồn cầu thông minh dùng cơ Bumia bidet, tự rửa vệ sinh hậu môn và vệ sinh cho phụ nữ , vòi xịt vệ sinh thông minh, mã BM-01V",2879000,2879000,0,0
TIKI,nha-cua-doi-song,177610565,"Đèn Pin Siêu Sáng US ARMY Mã XML-T6 Cao Cấp Vỏ Hợp Kim Chống Nước Sử Dụng Pin Có Thể Sạc Lại Tặng Hộp Full Box- HÀNG CHÍNH HÃNG",108000,258000,150000,58
TIKI,nha-cua-doi-song,57867024,"Bộ Lau Nhà Xoay 360 Độ Sunhouse Ks-Cl350PO",337000,513000,176000,34
TIKI,nha-cua-doi-song,120759154,"Bó 100 Dây Thít, Dây Rút, Lạt Nhựa Đủ Mọi Kích Cỡ Tiện Lợi",24000,30000,6000,20
TIKI,nha-cua-doi-song,165013585,"Ổ Cắm Điện Dài VINAVU Kèm Cổng USB Công Tắc Riêng Chịu Tải 2500W, Chống Giật, Chống Cháy",199000,199000,0,0
TIKI,nha-cua-doi-song,106457363,"Túi Giữ Nhiệt Đựng Hộp Cơm 2 Ngăn – Chọn Màu Túi Giữ Nhiệt Đựng Cặp Lồng Cơm – Nhiều Màu – Chống Thấm Nước Chính Hãng",45000,70000,25000,36
TIKI,nha-cua-doi-song,54145105,"Cọ Bồn Cầu Toilet, Cọ Vệ Sinh Cao Cấp - Parroti Silicon SL01 – Có Bình Đựng Nước Tẩy, Cây Gắp Tóc Tiện Dụng",88000,89000,1000,1
TIKI,nha-cua-doi-song,115092053,"Bộ ga giường poly cotton LIDACO drap giường đủ size nệm 1m2, 1m4, 1m6, 1m8",119000,120000,1000,1
TIKI,nha-cua-doi-song,147265074,"Vỉ 2 VPin AA , Pin AAA DURACELL 1,5V Siêu Bền - Hàng chính hãng",30000,30000,0,0
TIKI,nha-cua-doi-song,273360410,"Kèn Melodion/ Pianica/ Melodica Valote VM-32K, VM-37K Túi Vải Nhiều Màu Sắc - Hàng Chính Hãng",259000,259000,0,0
TIKI,nha-cua-doi-song,273663747,"Kèn Melodion/ Pianica/ Melodica Suzuki MX-37C - Hàng Chính Hãng",1039000,1039000,0,0
TIKI,nha-cua-doi-song,217695866,"Bóng đèn LED Bulb MPE LBD E27 - Tiết kiệm điện, Tiêu chuẩn Châu Âu, Thương hiệu Việt Nam - Hàng Chính Hãng",41000,67000,26000,39
TIKI,nha-cua-doi-song,163550425,"Nệm Bông Gòn Xuất Nhật, Nệm Trải Sàn Tiện Lợi, Đệm Văn Phòng Size 1m x 2m; 1.4m x 2m; 1.6m x 2m",387000,500000,113000,23
TIKI,nha-cua-doi-song,182971940,"Bình giữ nhiệt LocknLock có 2 nắp thay thế New Clip Tumbler 540ml LHC4279",270000,520000,250000,48
TIKI,nha-cua-doi-song,98562149," 328 Cái Ống Co Nhiệt Cách Nhiệt Ống Co Phân Loại Điện Tử",28989,28989,0,0
TIKI,nha-cua-doi-song,1399571,"Gối Memory Foam 50D Hình Cong Lock&Lock HLW111 (50 x 30 cm) - Trắng",290000,483000,193000,40
TIKI,nha-cua-doi-song,84886093,"Vợt muỗi thông minh 3in1 SUNHOUSE SHE-PRO11.W",208000,344000,136000,40
TIKI,nha-cua-doi-song,1024190,"Bộ 3 Hộp Cơm Giữ Nhiệt Lock&amp;Lock Mushroom LHC8025SLV - Bạc",524000,1007000,483000,48
TIKI,nha-cua-doi-song,183907622,"Cây Lăn Bụi Quần Áo, Ghế Sofa - Tặng Kèm 2 lõi lăn",31000,55000,24000,44
TIKI,nha-cua-doi-song,273348701,"Bộ lọc nước sinh hoạt 3 cấp 10" lọc zen 21 - Hàng chính hãng",256500,270000,13500,5
TIKI,nha-cua-doi-song,143841853,"Bình Giữ Nhiệt Coffee Bugu Mini Inox 304 LI-02 – Hàng Chính Hãng",108000,150000,42000,28
TIKI,nha-cua-doi-song,119203295,"Combo 5 Khăn Lau Bếp, Lau Kính Siêu Thấm Hút Parroti - Fiber FB02",47000,89000,42000,47
TIKI,nha-cua-doi-song,112321595,"Đèn Học Chống Cận Thị, Đèn Đọc Sách, Đèn Làm Việc Để Bàn Chống Chói Mắt Lóa Mắt Bảo Vệ Mắt Chống Cận Thị, Cảm Ứng Siêu Sáng - VinBuy",164000,300000,136000,45
TIKI,nha-cua-doi-song,73147684,"Thanh xốp gắn chân cửa chống kẹt chân cho bé, bịt khe hở, chắn gió, chặn côn trùng",8000,13999,5999,43
TIKI,nha-cua-doi-song,92385690,"Áo Mưa Cánh Dơi 2 Đầu Vải Dù Loại Siêu Dày, Hàng Việt Nam Chất Lượng Cao, Khổ To Rộng Phù Hợp Cho 2 Người, An Toàn Cho Người Sử Dụng, Có Túi Đựng Dễ Bảo Quản.",140000,140000,0,0
TIKI,nha-cua-doi-song,52756206,"1kg Túi Đựng Rác Tự Phân Hủy Sinh Học Gimex II (full size)",28000,28000,0,0
TIKI,nha-cua-doi-song,71924330,"Bộ Chổi Quét Nhà Lock&Lock Gồm Cây Chổi và Dụng Cụ Hốt ETM465",257000,428000,171000,40
TIKI,nha-cua-doi-song,186627908,"Ghế Gác Chân Công Thái Học Ergonomic Footrest, Ghế Kê Chân Ghế Gác Chân Văn Phòng",189000,280000,91000,33
TIKI,nha-cua-doi-song,52504270,"Chiếu Mây Điều Hòa Cao Cấp Loại dày",169000,300000,131000,44
TIKI,nha-cua-doi-song,119007194,"Thanh 4 Móc Treo Dán Tường, Móc Treo Đồ Đa Năng Parroti Handy HD41",21900,36000,14100,39
TIKI,nha-cua-doi-song,181410158,"Bàn Làm Việc Đa Năng Decor Phong Cách Gaming Thương Hiệu IGA - GM62",293000,320000,27000,8
TIKI,nha-cua-doi-song,185756654,"Cây chà sàn nhà tắm Kitimop-Z4 chổi cọ sàn và gạt nước đa năng 2 trong 1, cọ sạch khe hẹp và góc tường",49000,75000,26000,35
TIKI,nha-cua-doi-song,32328782,"Phin Nhôm Cà Phê Tráng Men Đen Trung Nguyên  ",79000,79000,0,0
TIKI,nha-cua-doi-song,15737169,"Đế Đèn LED 3D Có Điều Khiển Remote 16 Màu Đèn",75000,75000,0,0
TIKI,nha-cua-doi-song,119030223,"Keo Dán Giày, Gỗ, Nhựa, Sứ Siêu Dính Chống Thấm Đa Năng Deli - 7Ml / 20Ml - 7140 / 7149",8000,16200,8200,51
TIKI,nha-cua-doi-song,892141,"Pin Max 8 + 4 Viên Energizer E92 BP8+4 AAA",152000,180000,28000,16
TIKI,nha-cua-doi-song,185910176,"Giấy Nến Vàng Lót Nồi Chiên Không Dầu Sạch Sẽ Tiện Dụng An Toàn Cho Sức Khỏe - 1 set 50 Tờ",85000,85000,0,0
TIKI,nha-cua-doi-song,57806524,"Áo Mưa Bộ Vải Dù Cao Cấp Cho Bé Từ 3 -10 Tuổi, Chống Thấm, Che Kín Người An Toàn Cho Bé, Lựa Chọn Màu Sắc Phù Hợp Giới Tính (Giao Màu - Mẫu Ngẫu Nhiên)",110000,110000,0,0
TIKI,nha-cua-doi-song,138952791,"Móc Treo Cây Lau Nhà Dán Tường Đa Năng Chịu Lực Tốt, 2 Trong 1 - Parroti Keeper KP03",22900,42000,19100,45
TIKI,nha-cua-doi-song,1651191,"Kệ Đỡ Màn Hình Máy Tính Monitor Stand Walnut Plyconcept MSM01003 (490 x 200 mm) - Nâu Đậm",290000,380000,90000,24
TIKI,nha-cua-doi-song,58357614,"Đèn bắt muỗi, ruồi và các loại côn trùng Con Dơi",390000,390000,0,0
TIKI,nha-cua-doi-song,153066085,"Pin CR2032 Lithium 3V Maxell cao cấp Made In Japan - Hàng chính hãng",26000,30000,4000,13
TIKI,nha-cua-doi-song,184245786,"Túi đựng hộp cơm giữ nhiệt, túi đựng đồ ăn trưa văn phòng có lớp lót nhôm giữ nhiệt dày dặn, kích thước lớn tiện lợi",59000,59000,0,0
TIKI,nha-cua-doi-song,52484490,"Keo Dán Chống Thấm Siêu Dính Nhật Bản Bosui Dài 5m ",13000,14999,1999,13
TIKI,nha-cua-doi-song,46163430,"Sáo Recorder Soprano Yamaha YRS-24B Tone C (Đô) - Kèm Móng Gảy DreamMaker",129000,129000,0,0
TIKI,nha-cua-doi-song,64988886,"Bình giữ nhiệt Lock&amp;Lock Flat nắp gỗ 400ml - LHC4227WHT - Màu",278000,534000,256000,48
TIKI,nha-cua-doi-song,173732608,"Combo Khăn Lau Đa Năng 2 Mặt Siêu Thấm , Khăn Lau Bếp , Khăn Lau Kính , Khăn Lau Chén Bát , Khăn Lau Tay , Khăn Lau Ô Tô PaKaSa",38000,38000,0,0
TIKI,nha-cua-doi-song,75664370,"GỐI MỀN BIỆT ĐỘI RU NGỦ 3 IN 1 - BỘ CHĂN GỐI VĂN PHÒNG SIÊU MỊN -MẪU 2021",199000,199000,0,0
TIKI,nha-cua-doi-song,104680895,"Cây Lau Nhà Đơn MyJae Sợi Microfiber Xoay 360 Độ Phù Hợp Cho Nhiều Loại Thùng Lau 134cm",199000,330000,131000,40
TIKI,nha-cua-doi-song,122911188,"Găng tay cao su siêu dai rửa bát, bao tay cao su rửa chén, vệ sinh nhà cửa, an toàn, không mùi hôi Parroti Active AT01",47000,89000,42000,47
TIKI,nha-cua-doi-song,148713415,"Tua Vít Cầm Tay Nhỏ Gọn, Tiện Dụng Lắp Ráp Và Sửa Chữa Vật Dụng Gia Đình (5mmx155mm)",27000,27000,0,0
TIKI,nha-cua-doi-song,119112667,"Combo 2 Miếng Lau Nhà Parroti ProMAX - Kích Thước 38 x12 CM",85000,145000,60000,41
TIKI,nha-cua-doi-song,14681534,"Bộ tua vít sửa chữa đồng hồ điện thoại",31160,32800,1640,5
TIKI,nha-cua-doi-song,2151853,"Ly Giữ Nhiệt Lock&Lock Swing Tumbler LHC4138SLV",374000,623000,249000,40
TIKI,nha-cua-doi-song,273244363,"Kệ Sách Gỗ 5 Tầng, Giá Sách Đứng Cạnh Bàn Làm Việc - GP189",318000,346000,28000,8
TIKI,nha-cua-doi-song,162548473,"Hộp Đựng Giày Nhựa Cứng Cao Cấp Size Lớn Cửa Nam Châm Lắp Ráp Tiện Lợi Song Anh- Hàng Chính Hãng",95000,95000,0,0
TIKI,nha-cua-doi-song,177969021,"Bộ Hộp Cơm Giữ Nhiệt 2GOOD Lunch Box HC02 (2000ml) - Kèm Muỗng và Đũa Inox 304",590000,590000,0,0
TIKI,nha-cua-doi-song,131407951,"Bàn làm việc bàn hoc chữ k",372240,396000,23760,6
TIKI,nha-cua-doi-song,36560504,"Bình Nước Lock&Lock One Touch ABF687LPIK 500ml",151000,290000,139000,48
TIKI,nha-cua-doi-song,200960836,"Dây Đèn Led Fairy Light Trang Trí Giáng Sinh Biểu Tượng Cây Thông, Người Tuyết, Ông Già Noel - Chính Hãng NAVIVU",79000,79000,0,0
TIKI,nha-cua-doi-song,71206737,"Đèn Pin Laser 303 - Hàng Chính Hãng",133400,145000,11600,8
TIKI,nha-cua-doi-song,110001215,"Nẹp Dây Điện Dán Tường Siêu Dính ,Kẹp Dây Điện Cố Định Và Giữ Dây Điện Siêu Sốc an toàn tiện lợi dễ lắp đặt",11699,11699,0,0
TIKI,nha-cua-doi-song,117353723,"Chiếu ngủ văn phòng cao cấp",45000,45000,0,0
TIKI,nha-cua-doi-song,127031393,"Ca nước giữ nhiệt LocknLock Metro Mug LHC4219MIT 475ml - Màu",304000,506000,202000,40
TIKI,nha-cua-doi-song,165256438,"Khăn mặt sợi tre Bamboo&Love 30x50 mềm mại kháng khuẩn siêu thấm hút an toàn cho da ngay cả với trẻ sơ sinh",23700,23900,200,1
TIKI,nha-cua-doi-song,138507381,"Chai xịt chuột thái land rat off",83000,83000,0,0
TIKI,nha-cua-doi-song,2153015,"Bộ Vít 24 Món Xiaomi Wiha Precision Screwdriver",399000,490000,91000,19
TIKI,nha-cua-doi-song,10227148,"Dụng Cụ Mài Dao 3 Lớp Lock&Lock CKK112 (245 x 53 x 72 mm)",165000,275000,110000,40
TIKI,nha-cua-doi-song,63051860," Đèn Học Làm Việc Đọc Sách Để Bàn Pixar Chống Cận Thị Bảo Vệ Mắt - Hàng Chính Hãng eLights",159000,219000,60000,27
TIKI,nha-cua-doi-song,44620765,"Đèn Pin Led Siêu Sáng Mini Có Sạc USB Có Hỗ Trợ Sạc Dự Phòng Lại Cho Điện Thoại Khẩn Cấp - Hàng Chính Hãng",85000,129000,44000,34
TIKI,nha-cua-doi-song,174236741,"Găng tay cao su tự nhiên Lock&amp;Lock ETM830 (có móc treo)",31000,56000,25000,45
TIKI,nha-cua-doi-song,149573787,"Thùng rác thông minh cảm ứng tự động M&L-FH-2 phong cách Hàn Quốc",479000,479000,0,0
TIKI,nha-cua-doi-song,75615959,"Combo 5 khăn lau đa năng siêu thấm hút, khăn size lớn (30x40 cm) khăn lau kính, ô tô, mặt bàn, bếp Parroti Fiber FB01",48000,89000,41000,46
TIKI,nha-cua-doi-song,128969410,"Kệ Sách Để Bàn, Giá Sách Thiết Kế Hiện Đại Thương Hiệu IGA - GP157",187000,205000,18000,9
TIKI,nha-cua-doi-song,104110135,"Bàn chải nhà tắm, cọ bồn rửa Parroti Clever CR01",55000,99000,44000,44
TIKI,nha-cua-doi-song,118858137,"Nạo Gọt Rau Củ Quả  Inox 304 Hàng Cao Cấp - Mua 1 Lần Dùng Mãi Mãi",70000,70000,0,0
TIKI,nha-cua-doi-song,149617968,"Thùng đựng gạo thông minh M&L Royalcare 6068 - bao gồm khay đựng ngũ cốc - chống ẩm mốc côn trùng - đồ gia dụng tiện ích",469000,469000,0,0
TIKI,nha-cua-doi-song,57999394,"Bộ Ga Gối Cotton Đũi Tici LIDACO Cao Cấp - Xanh Mint",149000,220000,71000,32
TIKI,nha-cua-doi-song,52187161,"Giá Treo Ổ Điện Dán Tường Tiết Kiệm Không Gian",6000,9000,3000,33
TIKI,nha-sach-tiki,189940724,"Triệu Phú Khu Ổ Chuột",94000,126000,32000,25
TIKI,nha-sach-tiki,141483251,"Sách: Thai Giáo Theo Chuyên Gia - 280 Ngày Mỗi Ngày Đọc 1 Trang (Tái Bản)",88000,110000,22000,20
TIKI,nha-sach-tiki,69337681,"Nhà Tư Tưởng Lớn - Nietzsche Trong 60 Phút",63000,96000,33000,34
TIKI,nha-sach-tiki,114689806,"Full combo (Bộ 10 cuốn) Ehon song ngữ Kỹ năng - Màu sắc - Hình khối - Nhận biết",182000,350000,168000,48
TIKI,nha-sach-tiki,5154511,"Bà Nội Găngxtơ (Tái Bản)",57500,75000,17500,23
TIKI,nha-sach-tiki,124767704,"Bạn Đắt Giá Bao Nhiêu? (Tái Bản)",86400,119000,32600,27
TIKI,nha-sach-tiki,83432000,"Sách Người trong muôn nghề: Ngành Kinh tế có gì?",173000,189000,16000,8
TIKI,nha-sach-tiki,194110075,"Bẩm thầy Tường có thầy Vũ đến tìm - tập 2",115000,115000,0,0
TIKI,nha-sach-tiki,271536000,"Chú Thuật Hồi Chiến Tập 3: Cá Con Và Trừng Phạt Ngược",29800,30000,200,1
TIKI,nha-sach-tiki,176550199,"Hội Chứng Trầm Cảm Cười: Đằng Sau Nụ Cười Hạnh Phúc Là Những Nỗi Đau",81100,109000,27900,26
TIKI,nha-sach-tiki,157432540,"Thư Tình Gửi Một Người (Trịnh Công Sơn) (Tái Bản)",112000,195000,83000,43
TIKI,nha-sach-tiki,73795265,"Sách Hợp Nhất Với Vũ Trụ (Bìa Mềm) (Tái Bản 2020)",68100,88000,19900,23
TIKI,nha-sach-tiki,137751490,"[Tặng Bút Lông + Lau Bảng] Bảng từ trắng treo tường viết bút lông Deli Nhiều kích cỡ - Dùng Cho Văn Phòng, Trường Học, Tập Vẽ, Ghi Chú Công Thức Nấu Ăn, Trang Trí Nhà Cửa",405000,405000,0,0
TIKI,nha-sach-tiki,67040880,"Thân Mật Cội Nguồn Của Hạnh Phúc (Tái Bản 2020)",68100,98000,29900,31
TIKI,nha-sach-tiki,48592472,"Combo Truyện Tranh Song Ngữ Việt - Anh Cho Bé (12 Tập)",135000,180000,45000,25
TIKI,nha-sach-tiki,47323853,"Chinh Phục Luyện Thi Vào Lớp 10 Môn Tiếng Anh Theo Chủ Đề",105000,159000,54000,34
TIKI,nha-sach-tiki,14100920,"Bánh Mì Kẹp Chuột (Tái Bản 2019)",58800,79000,20200,26
TIKI,nha-sach-tiki,138269668,"Từ Điển Tiếng Việt (Hoàng Phê)(Tái Bản)",442000,495000,53000,11
TIKI,nha-sach-tiki,71880692,"600 Câu Hỏi Dùng Cho Sát Hạch, Cấp Giấy Phép Lái Xe Cơ Giới Đường Bộ",45000,45000,0,0
TIKI,nha-sach-tiki,187009994,"Lôi Thần Và Nhân Viên Văn Phòng (Tập 5)",51200,66000,14800,22
TIKI,nha-sach-tiki,196395463,"Dưới cánh đại bàng (bìa mềm)",117300,138000,20700,15
TIKI,nha-sach-tiki,107409375,"Tiếng Anh 6 I-Learn Smart World - Workbook (Sách Bài Tập)",68000,68000,0,0
TIKI,nha-sach-tiki,127654481,"Tiệm Café Bên Rìa Thế Giới",70000,108000,38000,35
TIKI,nha-sach-tiki,188694727,"Tập viết tiếng Thái",34000,50000,16000,32
TIKI,nha-sach-tiki,181379111,"Vô Cùng Tàn Nhẫn Vô Cùng Yêu Thương Tập 4",86420,149000,62580,42
TIKI,nha-sach-tiki,185410021,"Set Decal Bọc Sách Vở Dán Bìa Trong Suốt Chống Nước Nhiều Kích Cỡ Deli - Bọc SGK Vở Sổ Tay Ghi Chép Truyện Tiều Thuyết - Lưu Trữ Bền Đẹp - 70603 / 70602 / 70601",27000,48600,21600,44
TIKI,nha-sach-tiki,36727163,"Người Nam Châm (Tái Bản 2019)",55000,79000,24000,30
TIKI,nha-sach-tiki,45438055,"BỘ SÁCH HỌC TIẾNG ANH lITTLE STORIES",421000,650000,229000,35
TIKI,nha-sach-tiki,99992416,"Fullmetal Alchemist - Cang giả kim thuật sư - Fullmetal Edition - Tập 10",65600,69000,3400,5
TIKI,nha-sach-tiki,11347711,"All The Rule - Sống Bản Lĩnh Theo Cách Một Quý Cô",62100,96000,33900,35
TIKI,nha-sach-tiki,184226848,"Sợi tóc - Thạch Lam (Bìa mềm)",26700,35000,8300,24
TIKI,nha-sach-tiki,188536931,"Gửi Người Bí Ẩn Thân Thương (Truyện Tranh)",91100,109000,17900,16
TIKI,nha-sach-tiki,5112975,"Marketing giỏi phải kiếm được tiền - The end of marketing as we know it",299000,299000,0,0
TIKI,nha-sach-tiki,149942445,"Sức Mạnh Thương Mại Điện Tử - 12 Tháng Kiếm 1 Triệu Đô Bằng Kinh Doanh Online - Bộ Sách Trên Lưng Khổng Tượng",142000,199000,57000,29
TIKI,nha-sach-tiki,46009013,"Fullmetal Alchemist - Cang Giả Kim Thuật Sư - Fullmetal Edition Tập 2",61100,69000,7900,11
TIKI,nha-sach-tiki,182149648,"Nước Ép Trị Liệu Và Chế Độ Ăn Theo Phương Pháp Cơ Thể Tự Chữa Lành",149300,199000,49700,25
TIKI,nha-sach-tiki,108261352,"Tự Học Ngữ pháp Tiếng Anh Bằng Mindmap Tập 2",108000,145000,37000,26
TIKI,nha-sach-tiki,13065341,"Series Địch Công Kỳ Án Tập 16 - Quảng Châu Án",101000,158000,57000,36
TIKI,nha-sach-tiki,73810559,"Combo 3 Cuốn: Hiệu Ứng Chim Mồi Tập 1 + 2 + 3",182000,265000,83000,31
TIKI,nha-sach-tiki,146988856,"Lựa Chọn Đúng Quan Trọng Hơn Nỗ Lực - 6 Bước Để Ra Quyết Định Hoàn Hảo",110000,170000,60000,35
TIKI,nha-sach-tiki,120357410,"Thực Hành Khởi Nghiệp - Từng Bước Nhỏ Làm Chủ Doanh Nghiệp Lớn",125000,169000,44000,26
TIKI,nha-sach-tiki,147920905,"Đường Mây Qua Xứ Tuyết (Tái Bản)",82100,118000,35900,30
TIKI,nha-sach-tiki,185500894,"i-Learn Smart Start 5 Student's Book Special Edition",113000,113000,0,0
TIKI,nha-sach-tiki,11508322,"Nội Tình Của Ngoại Tình",141000,220000,79000,36
TIKI,nha-sach-tiki,1029894,"Tuần Của Bé - Bé Tinh Tế (Dành Cho Trẻ 3 - 6 Tuổi)",21850,23000,1150,5
TIKI,nha-sach-tiki,190705661,"Lại Thằng Nhóc Emil",84500,109000,24500,22
TIKI,nha-sach-tiki,25203389,"Advanced Grammar in Use Book with Answers  Edition: A Self-Study Reference and Practice Book for Advanced Learners of English",163800,178000,14200,8
TIKI,nha-sach-tiki,193450572,"Quái Mèo Độc Tấu",99200,119000,19800,17
TIKI,nha-sach-tiki,274145052,"Trạm Đọc| Hackers IELTS Basic: Reading + Writing + Speaking + Listening ( Dành cho người mới bắt đầu )",624000,836000,212000,25
TIKI,nha-sach-tiki,192339427,"Bà Bác Khủng Khiếp",116000,150000,34000,23
TIKI,nha-sach-tiki,102832719,"Thay Tư Duy Xoay Cục Diện - Ngưng Sống Cầm Chừng",96300,129000,32700,25
TIKI,nha-sach-tiki,181699658,"Chiến Lược Giao Dịch Của Jesse Livermore",110700,159000,48300,30
TIKI,nha-sach-tiki,89001327,"Giao Dịch Theo Xu Hướng Để Kiếm Sống",366000,366000,0,0
TIKI,nha-sach-tiki,176824204,"Tinh Hoa Kinh Tế Học (Tái Bản)",431000,555000,124000,22
TIKI,nha-sach-tiki,193895767,"THE DAILY STOIC – 366 CHIÊM NGHIỆM VỀ TRÍ TUỆ VÀ LÒNG CAN TRƯỜNG CÙNG NGHỆ THUẬT SỐNG",166400,239000,72600,30
TIKI,nha-sach-tiki,344788,"Bất Cứ Điều Gì Em Muốn",41400,69000,27600,40
TIKI,nha-sach-tiki,34751481,"Ngụ Ngôn Song Ngữ Anh - Việt: Kiến Và Chim Bồ Câu (Tái Bản 2019)",16800,28000,11200,40
TIKI,nha-sach-tiki,568762,"Tam Quốc Diễn Nghĩa (Trọn Bộ 04 Tập)",182000,350000,168000,48
TIKI,nha-sach-tiki,100202726,"Phương Pháp Wyckoff Hiện Đại - Kỹ thuật Nhận diện Xu hướng Thị trường Tiềm năng",356000,356000,0,0
TIKI,nha-sach-tiki,168559524,"Gia Đình Tỉnh Thức",149000,209000,60000,29
TIKI,nha-sach-tiki,155463025,"Nghệ Thuật Bán Hàng Bậc Cao - Bí Quyết Chốt Deal Mọi Thời Đại (Khổ Lớn)(Tái Bản)",128000,198000,70000,35
TIKI,nha-sach-tiki,114228620,"Combo Tiếng Hàn Tổng Hợp Sơ Cấp 1 Dành Cho Người Việt Nam Bản In Màu - Học Kèm App",249900,357000,107100,30
TIKI,nha-sach-tiki,188960732,"COMBO TỰ HỌC TAROT: Sách Nhật ký Tarot + Bộ Bài & Sách Hướng Dẫn (Tái bản 2022)",296000,398000,102000,26
TIKI,nha-sach-tiki,40933973,"Dịch Kinh Tường Giải (Di Cảo): Quyển Thượng (Tái Bản)",222000,340000,118000,35
TIKI,nha-sach-tiki,3526069,"Quản Trị Nguồn Nhân Lực",116000,116000,0,0
TIKI,nha-sach-tiki,89204253,"4000 Từ Vựng Và Mẫu Câu Tiếng Anh Thiết Yếu Cho Trẻ Em",177000,250000,73000,29
TIKI,nha-sach-tiki,195959545,"Chú Thuật Hồi Chiến - Tập 6 - Bản Thường - Tặng Kèm Obi Và Thẻ Bo Góc Nhựa",29100,30000,900,3
TIKI,nha-sach-tiki,185658131,"Dragon Quest - Dấu Ấn Roto (Dragon Quest Saga Emblem Of Roto) Perfect Edition Tập 7 [Tặng Kèm Bookmark PVC] ",67100,75000,7900,11
TIKI,nha-sach-tiki,115972858,"Sổ tay ghi chép lò xo màu pastel Deli - Giấy kẻ ngang 80 trang khổ A5 / B5 - Phù hợp làm sổ kế hoạch, sổ nhật kí, tập vở ghi chép - 24202 / 24203",33000,70200,37200,53
TIKI,nha-sach-tiki,58627102,"Sổ Tay Nhà Thôi Miên",98500,145000,46500,32
TIKI,nha-sach-tiki,193099629,"Chuyên Gia Kinh Tế Bước Vào Nhà Thổ Và Những Nơi Không Ngờ Khác Để Hiểu Về Rủi Ro",135000,175000,40000,23
TIKI,nha-sach-tiki,46723656,"Sách Tử Tế Đáng Giá Bao Nhiêu",67600,98000,30400,31
TIKI,nha-sach-tiki,67712912,"Phát Triển Trí Tuệ Cảm Xúc- Chúng Mình Tôn Trọng Cơ Thể Và Cảm Xúc Của Nhau",37100,50000,12900,26
TIKI,nha-sach-tiki,5743603,"Vật Lý Thiên Văn Cho Người Vội Vã",58700,80000,21300,27
TIKI,nha-sach-tiki,72202103,"Con Chim Xanh Biếc Bay Về (Nguyễn Nhật Ánh) (Bìa Mềm)",99000,150000,51000,34
TIKI,nha-sach-tiki,171212880,"Ikigai – Đi Tìm Lý Do Thức Dậy Mỗi Sáng",61800,89000,27200,31
TIKI,nha-sach-tiki,71094783,"Linh Hồn Của Tiền - The Soul Of Money",249000,249000,0,0
TIKI,nha-sach-tiki,45321630,"Bạn Chỉ Tưởng Là Mình Đang Rất Cố Gắng",93000,123000,30000,24
TIKI,nha-sach-tiki,95089986," Bút chì màu gốc dầu cao cấp Deli - 6565 / 6566 / 6567",250200,250200,0,0
TIKI,nha-sach-tiki,55589742,"Sách Bài Học Diệu Kỳ Từ Chiếc Xe Rác (Khổ Lớn) (Tái Bản)",71100,108000,36900,34
TIKI,nha-cua-doi-song,118966833,"Móc Treo Cây Lau Nhà Dán Tường Đa Năng  Chịu Lực Tốt - Parroti Keeper KP02",22900,42000,19100,45
TIKI,nha-cua-doi-song,74396976,"Máy xay tỏi ớt bằng tay Lock&Lock (Nhiều kích cỡ) - Hàng chính hãng, lực nghiền mạnh với 3 lưỡi dao thép không gỉ",129000,216000,87000,40
TIKI,nha-cua-doi-song,165404269,"Khăn tắm sợi tre Bamboo&Love 60x120cm mềm mại kháng khuẩn siêu thấm hút an toàn cho da ngay cả với trẻ sơ sinh",70000,70000,0,0
TIKI,nha-cua-doi-song,180378151,"Bình giữ nhiệt LocknLock Metro Drive LHC4277S 650ml - Kèm ống hút và cọ rửa",301000,579000,278000,48
TIKI,nha-cua-doi-song,189491905,"Nhang Sen Thuần Khiết Liên Tâm 20.5cm 160 cây - Ít khói, dịu nhẹ, 100% Đài sen thiên nhiên",75000,75000,0,0
TIKI,nha-cua-doi-song,17593518,"Bộ Hộp Cơm Giữ Nhiệt Thép Không Gỉ Lock & Lock LHC8031SLV - Bạc",668000,1285000,617000,48
TIKI,nha-cua-doi-song,147806385,"Đũa gắp thức ăn vặt DandiHome siêu nhẹ cho chơi game, làm việc văn phòng",13250,15000,1750,12
TIKI,nha-cua-doi-song,71005991,"Bình xịt dầu Lock&Lock 100ml kèm phểu và cọ rửa - CKO109",104000,174000,70000,40
TIKI,nha-cua-doi-song,3490669,"Cây lau nhà tự vắt thông minh Panda ",39794,41888,2094,5
TIKI,nha-cua-doi-song,178783625,"Combo 2 Giá đỡ bàn chải máy dán tường NAVIVU",50000,50000,0,0
TIKI,nha-cua-doi-song,57945711,"Hộp đựng bàn chải kem đánh răng nhà tắm tặng kèm 4 cốc-Kệ để đồ vệ sinh răng miệng dán tường (màu ngẫu nhiên)",168850,168850,0,0
TIKI,nha-cua-doi-song,134853381,"Bình giữ nhiệt LocknLock Feather Light Ring LHC4244PIK 460ml - Màu",313000,601000,288000,48
TIKI,nha-cua-doi-song,52578184,"Tuýp Keo Dán Đồ Gia Dụng Siêu Dính, Keo Dán Kim Loại Cao Cấp",15000,15000,0,0
TIKI,nha-cua-doi-song,259514693,"Cây chà sàn nhà tắm Kitimop-Z1 chổi cọ sàn và gạt nước đa năng 2 trong 1, cán hợp kim nhôm tăng giảm chiều dài 65-125cm",145000,215000,70000,33
TIKI,nha-cua-doi-song,162526068,"Đất trồng cây SOILMIX cho hoa hồng, cây cảnh, sen đá, rau sạch hữu cơ, bổ sung phân bón vi sinh, trichoderma, đá perlite",50000,50000,0,0
TIKI,nha-cua-doi-song,102488853,"Thùng Đựng Gạo Cao Cấp 5kg & 10kg - Thùng Đựng Gạo Nắp Đậy Thông Minh, Thiết Kế Hiện Đại & Đẹp Mắt, Chất Liệu ABS &PP An Toàn Chống Nước, Chống Ẩm Mốc, Mối Mọt - Hàng Nhập Khẩu",206000,343500,137500,40
TIKI,nha-cua-doi-song,121396300,"Dây rút nhựa 10cm ,15cm, 20cm, 25cm, 30cm ( Khoảng 80 sợi/bịch )",3900,3900,0,0
TIKI,nha-cua-doi-song,82875291,"Bộ 2 thùng vải, hộp vải đựng đồ đa năng -Màu Nâu Kem + Tặng kèm dây cột tóc- Hộp vải đựng quần áo 2 size đựng quần áo, đồ lót, giày, văn phòng phẩm, đồ dùng cá nhân rất tiện lợi-Bộ 2 hộp vải đựng đồ vải canvas siêu xinh có nắp đậy, tủ vải đựng đồ hộp cái ",109000,141700,32700,23
TIKI,nha-cua-doi-song,206485076,"Hương nhang sạch Dương Minh nhang 20cm và 30cm 100% thành phần tự nhiên các loại nhang Cam Sả nhang Bồ Kết nhang Bắc nhang Thảo Mộc nhang Quế nhang Khuynh Diệp và Trầm Hương cao cấp",45000,60000,15000,25
TIKI,nha-cua-doi-song,77775165,"Hộp Bảo Quản Thủy Tinh Lock&Lock LBG - Top Class (Nhiều Dung Tích)",102000,196000,94000,48
TIKI,nha-cua-doi-song,179370829,"GÓI 20 VIÊN KHĂN GIẤY NÉN HÀN QUỐC HÌNH VIÊN KẸO ĐA NĂNG",16999,16999,0,0
TIKI,nha-cua-doi-song,3927949,"Bộ sạc Energizer Charger kèm 4 pin Ener AA 2000mAh, tự ngắt sạc (CHVCM4)",447000,460000,13000,3
TIKI,nha-cua-doi-song,114204740,"Bình giữ nhiệt inox 304 Sunhouse 900ml KS-TU900I",149000,225000,76000,34
TIKI,nha-cua-doi-song,949687,"Kệ Đỡ Màn Hình Máy Tính Monitor Stand Plyconcept MSM01001 (490 x 200 mm) - Gỗ",250000,300000,50000,17
TIKI,nha-cua-doi-song,467912,"Máy Khoan Động Lực Bosch GSB 550 550W Set Và Bộ Dụng Cụ 100 Chi Tiết",1710000,2177000,467000,21
TIKI,nha-cua-doi-song,199728521,"Bộ lau nhà đa năng Space Saving Sunhouse KS-CL3211PW",310000,450000,140000,31
TIKI,nha-cua-doi-song,10032000,"Ổ cắm đa năng du lịch Adapter",30500,30500,0,0
TIKI,nha-cua-doi-song,21101765,"Bàn Học Bàn Làm Việc Kết Hợp Kệ Sách Thương Hiệu IGEA",670000,729000,59000,8
TIKI,nha-cua-doi-song,110894852,"Giấy Bạc Màng Nhôm MyJae Đài Loan Để Bảo Quản, Nướng Thức Ăn, Bọc Thực Phẩm 30cm x 14m",85000,119000,34000,29
TIKI,nha-cua-doi-song,57867023,"Cây Lau Nhà Xoay 360 Độ Sunhouse Ks-Mo350I",130000,200000,70000,35
TIKI,nha-cua-doi-song,185756969,"Cây lau kính đa năng Kitimop-3in1 có thiết kế thông minh gạt chùi kính 3 đầu trong 1, nhỏ gọn tiện lợi hiệu quả",39000,75000,36000,48
TIKI,nha-cua-doi-song,55669191,"Đèn Pixar, Đèn Học Chống Cận Thị, Đèn Đọc Sách, Đèn Làm Việc Để Bàn Chống Chói Mắt Lóa Mắt Bảo Vệ Mắt - Hàng Chính Hãng",250000,250000,0,0
TIKI,nha-cua-doi-song,19298165,"Áo Mưa Bộ Cho Bé Trai, Bé Gái ( số 1-5)",46000,46000,0,0
TIKI,nha-cua-doi-song,55900887,"Đèn Bàn Học Đọc Sách, Làm Việc (Học Sinh, Sinh Viên, Văn Phòng) LED Chống Cận, Cảm Ứng Nhôm Cao Cấp eLights",389000,449000,60000,13
TIKI,nha-cua-doi-song,121602582,"Bình xịt chống thấm tường, Keo chống dột xịt chống thấm nhà, mái tôn, bể nước 720ml Waterproof",58000,63000,5000,8
TIKI,nha-cua-doi-song,12030860,"Áo Mưa kín người Không Xẻ Tà Vải Dù Hàng Cao Cấp Chống Thấm Cực Tốt, Áo Mưa Đi Xe Máy",86000,86000,0,0
TIKI,nha-cua-doi-song,14640240,"Cân Điện Tử Nhà Bếp 5kg - Cân Chia Thực Phẩm Nhà Bếp - Cân Tiểu Ly 5kg",90000,135000,45000,33
TIKI,nha-cua-doi-song,68716605,"Dao Làm Bếp Đa Năng Sunhouse KS-KN165KS",74000,117000,43000,37
TIKI,nha-cua-doi-song,13309367,"Ổ điện thông minh có 6 phích cắm 3 cổng USB (Giao Màu Ngẫu Nhiên)",44000,44000,0,0
TIKI,nha-cua-doi-song,53518638,"2 Móc Dán Tường Giữ Dây Cắm Điện Phích Cắm Loại Trong Suốt",8950,8950,0,0
TIKI,nha-cua-doi-song,144752155,"Khăn lau đa năng H600 Khăn lau tay bát đĩa nhà bếp vải mềm mịn thấm nước siêu nhanh tiện lợi an toàn",1700,1700,0,0
TIKI,nha-cua-doi-song,35905855,"Cây Lau Nhà Pva Lock&Lock ETM481 - PP, 33 x 6 x 132 cm - Màu Trắng",280000,539000,259000,48
TIKI,nha-cua-doi-song,58002786,"Vòi bơm dây dẫn nước rửa chén gắn chậu rửa Hobby home decor NRC2 đầu bơm inox 304 có van 1 chiều gắn chai nước rửa chén",205000,279000,74000,27
TIKI,nha-cua-doi-song,137671794," Cân Tiểu Ly Nhà Bếp Chống Nước Cao Cấp Khoảng Chính Xác 1g - 5kg ",165000,295000,130000,44
TIKI,nha-cua-doi-song,71111080,"Kệ Để Giày Dép Inox 5 Tầng Chính Hãng Amalife, Giá Để Giày Inox 5 Tầng - Chọn Màu",99000,99000,0,0
TIKI,nha-cua-doi-song,195852183,"Bình giữ nhiệt bằng thép không gỉ LocknLock Jumbo Tumbler LHC4300NVY 900ML",438000,730000,292000,40
TIKI,nha-cua-doi-song,3677799,"Hộp 6 Lõi  Lọc Nước BRITA Maxtra Plus Filter Cartridge",1849000,1849000,0,0
TIKI,nha-cua-doi-song,48510374,"Combo 300 Túi Lọc Rác Siêu Tiện dụng cho Bồn rửa Chén bát",129000,200000,71000,36
TIKI,nha-cua-doi-song,51476716,"Bộ 10 đôi đũa inox 304 - 316 DandiHome 2020 chống trơn trượt, sang trọng, tinh tế",300000,300000,0,0
TIKI,nha-cua-doi-song,696495,"Ổ Cắm Điện 4 Lỗ 3 Chấu 3m Philips SPN1348WB/74 (2500W)",328000,369000,41000,11
TIKI,nha-cua-doi-song,193433927,"Đèn Bàn Học Led Đọc Sách Làm Việc Học Tập Bảo Vệ Mắt Chống Cận - 2 Trục Đèn Chiếu Sáng - Gấp Gọn Tiện Lợi",569000,699000,130000,19
TIKI,nha-cua-doi-song,210760574,"Cây lau nhà tự vắt thông minh sợi microfiber",209000,209000,0,0
TIKI,nha-cua-doi-song,45300792,"Đồng hồ báo thức điện tử để bàn màn hình đa chức năng thời gian, lịch, báo thức, nhiệt độ DH89",50900,50900,0,0
TIKI,nha-cua-doi-song,208413993,"Bàn Làm Việc Phong Cách Bắc Âu Thương Hiệu IGEA (Không Bao Gồm Ghế)",275500,290000,14500,5
TIKI,nha-cua-doi-song,52885368,"1 Kg túi zip chỉ đỏ thương hiệu Gimex II",69000,69000,0,0
TIKI,nha-cua-doi-song,54130086,"Cây lau nhà tự vắt thông minh đa năng cao cấp Parroti Magic MG01 - Tặng 1 Miếng Lau",229000,349000,120000,34
TIKI,nha-cua-doi-song,155794592,"Kệ lò vi sóng đa năng Thép Carbon cao cấp Vando, kệ để đồ nhà bếp siêu chịu lực 300kg sơn tĩnh điện chống bong tróc, kệ nhà bếp",899000,1427000,528000,37
TIKI,nha-cua-doi-song,69929041,"Móc Treo Quần Áo, Móc Phơi Đồ Trẻ Em Inox Kẹp Chống Rơi, Móc Treo Tất, Vớ, Đồ Lót Nhiều Kiểu Dáng",35000,35000,0,0
TIKI,nha-cua-doi-song,54686184,"Bạt Áo Trùm Máy Giặt Cửa Trên, Cửa Ngang Vải Dù Siêu Dày, Chống Thấm Nước, Không Phai Màu - (Giao Màu - Họa Tiết Ngẫu Nhiên)",99999,99999,0,0
TIKI,nha-cua-doi-song,56880195,"Bình nước Lock&Lock Eco Bottle ABF664BLU 750ml - Màu",145000,242000,97000,40
TIKI,nha-cua-doi-song,141246639,"Hộp giữ nhiệt đựng đồ ăn có tay cầm Handle Food Jar LocknLock 700ml LHC8042NVY - Màu",416000,800000,384000,48
TIKI,nha-cua-doi-song,51662145,"Keo dán siêu dính X2000 (50g) dán gỗ, sắt, sứ, kim loại đa năng",18000,46900,28900,62
TIKI,nha-cua-doi-song,114789036,"Vòi Dẫn Nước Rửa Chén Bộ Đầu Vòi Dẫn Bơm Hút Xịt Nước Rửa Chén Dầu Rửa Bát Gắn Bồn Rửa Bát",59596,59596,0,0
TIKI,nha-cua-doi-song,55365176,"0.5kg túi zipper chỉ đỏ đựng thực phẩm",39000,39000,0,0
TIKI,nha-cua-doi-song,87873126,"Áo Mưa Bộ Vải Dù, Bộ Quần Áo Mưa Có Phản Quang Đủ Size, Chống Thấm Hiệu Quả, Phù Hợp Nam Và Nữ, Có Túi Đựng, Có Lựa Chọn Màu Sắc",150000,150000,0,0
TIKI,nha-cua-doi-song,7114709,"Đèn Pin Đội Đầu Sunhouse Cỡ Nhỏ She 5012",62000,99000,37000,37
TIKI,nha-cua-doi-song,35058677,"Vỉ 5 Viên Pin CR1632 ( CR 1632/5BE x 1 Vỉ ) Panasonic Lithium 3 V - Hàng Chính Hãng",87000,100000,13000,13
TIKI,nha-cua-doi-song,41430891,"Ổ Khóa 4 Số Có Đổi Mã Chữ U ZR-01",68000,96000,28000,29
TIKI,nha-cua-doi-song,109654810,"Bình xịt tưới cây MONROVIA 2 lít, phun sương tưới cây cảnh, vòi dài, tặng vòi ngắn, màu xanh, tiêu chuẩn Châu Âu",169000,169000,0,0
TIKI,nha-cua-doi-song,71999229,"Nồi Inox 3 Lớp Đáy Liền Elmich Trimax Classic 2408OL",700000,990000,290000,29
TIKI,nha-cua-doi-song,48055150,"Thảm Lau Chân Chống Trượt Siêu Thấm 40x60cm",93000,186000,93000,50
TIKI,nha-cua-doi-song,51554889,"Ron Dán Che Khe Cửa ,Chân Cửa Chống Gió Lùa, Chống Bụi Và Chống Côn Trùng - Hàng Chính Hãng Cuộn 2m",40000,52000,12000,23
TIKI,nha-cua-doi-song,578967,"Chảo Đá Chống Dính Siêu Bền Sunhouse SBD28 28cm",273000,430000,157000,37
TIKI,nha-cua-doi-song,85029598,"Ổ cắm Điện Quang ĐQ 002A-02 (3 lỗ)",95000,95000,0,0
TIKI,nha-cua-doi-song,58828647,"Xe đẩy hàng 4 bánh SUMIKA T150 - Khung thép, tay cầm gấp mở tiện lợi, tải trọng 150kg",880000,1350000,470000,35
TIKI,nha-cua-doi-song,161225352,"Miếng dán đỡ kệ gỗ, chia ngăn tủ, không cần đóng đinh",22000,22000,0,0
TIKI,nha-cua-doi-song,134582052,"ĐỆM TRẢI SÀN, NỆM, TOPPER HÀNG XUẤT NHẬT",242000,269900,27900,10
TIKI,nha-cua-doi-song,217714140,"Móc Dán Tường INOX 304 Treo Đồ nặng, Treo Thớt, Nồi Niêu Treo Đồ Đa Năng [CHỐNG NƯỚC, CHỐNG RỈ] Dán Mọi Bề Mặt",15000,15000,0,0
TIKI,nha-cua-doi-song,19719366,"Võng dù 2 lớp BAN MAI, gọn nhẹ 230x145 cm, nặng 600gr (Giao màu ngẫu nhiên)",129000,150000,21000,14
TIKI,nha-cua-doi-song,178068438,"Khăn giấy cuộn đa năng, lau bếp, lau kính, chén bát, lau tay (50 khăn/cuộn, 25cm x25cm) - Parroti Bingo NG01",38900,78000,39100,50
TIKI,nha-sach-tiki,68456842,"Bài Tập Tiếng Anh 8 - Không Đáp Án",27100,40000,12900,32
TIKI,nha-sach-tiki,195190269,"Combo Anime Comics: One Piece Film Strong World (2 Cuốn)",153000,154000,1000,1
TIKI,nha-sach-tiki,138934620,"Red Nile - Tiểu Sử Của Dòng Sông Vĩ Đại Nhất Thế Giới",243400,399000,155600,39
TIKI,nha-sach-tiki,66698344,"Sách Bài Học Diệu Kỳ Từ Chiếc Xe Rác (Khổ Nhỏ) (Tái Bản 2020)",61100,88000,26900,31
TIKI,nha-sach-tiki,171055469,"TikTok Tất Tần Tật",113000,158000,45000,28
TIKI,nha-sach-tiki,38265901,"Điều Quan Trọng Nhất – The Most Important Thing",299000,299000,0,0
TIKI,nha-sach-tiki,67060012,"Phát Triển Trí Tuệ Cảm Xúc- Cảm Xúc Của Con Màu Gì?",37100,50000,12900,26
TIKI,nha-sach-tiki,138504809,"EQ - Đừng Để Cảm Xúc Hạ Gục Bản Thân",115000,159000,44000,28
TIKI,nha-sach-tiki,58732189,"Liệu Pháp Tâm Lý: Ứng Dụng Màu Sắc Thay Đổi Cuộc Sống",113000,159000,46000,29
TIKI,nha-sach-tiki,190708149,"Chitose Trong Chai Ramune – Tập 1 - Bản Phổ Thông - [Tặng Bookmark Bế Hình Có Chân Đế]",105000,105000,0,0
TIKI,nha-sach-tiki,172206434,"Huyền Thuật Và Các Đạo Sĩ Tây Tạng (Tái Bản)",75100,108000,32900,30
TIKI,nha-sach-tiki,143513113,"Con Yêu Bố Chừng Nào",59000,79000,20000,25
TIKI,nha-sach-tiki,74856421,"Hạnh Phúc Trong Công Việc",109220,159000,49780,31
TIKI,nha-sach-tiki,11368983,"Combo Giáo Trình Chuẩn HSK 2 - Bài Học (Kèm 1 MP3) và Giáo Trình HSK 2 - Sách Bài Tập (Kèm MP3) ( Tặng Kèm Viết )",308800,386000,77200,20
TIKI,nha-sach-tiki,51845986,"Chinh Phục Luyện Thi Vào 10 Môn Ngữ Văn Theo Chủ Đề",105000,159000,54000,34
TIKI,nha-sach-tiki,59478514,"Combo 2 Cuốn: Osho Đàn Ông + Osho Phụ Nữ",165000,228000,63000,28
TIKI,nha-sach-tiki,159259322,"Nhớ Hà Nội, Thương Sài Gòn",102000,129000,27000,21
TIKI,nha-sach-tiki,176824199,"Thần Số Học - Làm Chủ Cuộc Đời",98500,138000,39500,29
TIKI,nha-sach-tiki,22725674,"Kinh Nghiệm Từ Nước Nhật - Giúp Con Tự Lập Từ 0-6 Tuổi",45100,62000,16900,27
TIKI,nha-sach-tiki,1534613,"Giáo Trình Chuẩn HSK 5 Bài Học (Tập 1)",209000,278000,69000,25
TIKI,nha-sach-tiki,2583023,"Bé Nhanh Nhẹn",11500,23000,11500,50
TIKI,nha-sach-tiki,8886001,"Giết Con Chim Nhại (Tái Bản)",93100,120000,26900,22
TIKI,nha-sach-tiki,165030729,"Những Kẻ Âu Lo",97600,180000,82400,46
TIKI,nha-sach-tiki,193895769,"Cao Thủ "Đổi Đen Thay Trắng" - Tập 6 (Tiểu thuyết)",121500,159000,37500,24
TIKI,nha-sach-tiki,7369223,"Cho Tôi Xin Một Vé Đi Tuổi Thơ",61000,90000,29000,32
TIKI,nha-sach-tiki,110112108,"Phương Pháp Đầu Tư Warren Buffett",110000,169000,59000,35
TIKI,nha-sach-tiki,197656790,"Kaguya-Sama: Cuộc Chiến Tỏ Tình - Tập 1 - Tặng Kèm Lót Ly",38800,40000,1200,3
TIKI,nha-sach-tiki,197751561,"MONSTER #8 - Tập 5",52200,58000,5800,10
TIKI,nha-sach-tiki,192125793,"Harry Potter và tên tù nhân ngục Azkaban (Tái Bản 2022)",132000,205000,73000,36
TIKI,nha-sach-tiki,58547334,"Bài Tập Tiếng Anh 9 - Không Đáp Án (Tái Bản 2020)",40000,52000,12000,23
TIKI,nha-sach-tiki,194959693,"Hàn Quốc Quốc Gia Gây Sững Sờ",197000,225000,28000,12
TIKI,nha-sach-tiki,102629342,"999 Lá Thư Gửi Cho Chính Mình (**) - Tập 2 - Mong Bạn Trở Thành Phiên Bản Hạnh Phúc Nhất (Tái bản)",92800,129000,36200,28
TIKI,nha-sach-tiki,143676192,"Màu Acrylic tuýp mini chuyên nghiệp Deli - 5ml/tuýp - Vẽ vải / Vẽ quần áo / Vẽ giày - 12/18/24 màu",75600,75600,0,0
TIKI,nha-sach-tiki,187827433,"Sau Tang Lễ",82900,145000,62100,43
TIKI,nha-sach-tiki,71957923,"Sách Ehon - Combo 4 cuốn Bạn là ai vậy - Dành cho trẻ từ 0 - 3 tuổi",100000,156000,56000,36
TIKI,nha-sach-tiki,181379287,"Tốc Độ Của Niềm Tin (The Speed Of Trust)(Tái Bản 2022)",139000,175000,36000,21
TIKI,nha-sach-tiki,181699688,"Husky Và Sư Tôn Mèo Trắng Của Hắn - Tập 3",127000,169000,42000,25
TIKI,nha-sach-tiki,50668886,"Thiện, Ác Và Smart Phone (Tái Bản)",76000,105000,29000,28
TIKI,nha-sach-tiki,46849710,"Robinson Crusoe ",125000,190000,65000,34
TIKI,nha-sach-tiki,191636255,"Chòm Sao Linh Thú Tập 7 [Tặng Kèm Bookmark]",37000,40000,3000,8
TIKI,nha-cua-doi-song,11203853,"Bộ 10 đinh treo tranh, mắc màn loại 4 chân",13992,13992,0,0
TIKI,nha-cua-doi-song,110756858,"Set 200 Găng Tay Nilon Trong Suốt Sử Dụng Một Lần Tiện Lợi ",18394,18394,0,0
TIKI,nha-cua-doi-song,41886085,"Túi Đựng Ly Giữ Nhiệt Lớn 900ml - Nhiều Hoa Văn",40000,40000,0,0
TIKI,nha-cua-doi-song,54122078,"Pin AAAA Energizer E96 BP2",67000,80000,13000,16
TIKI,nha-cua-doi-song,63133571,"Mền lông cừu xanh dương đậm cao cấp A - 1m8x2m",165000,180000,15000,8
TIKI,nha-cua-doi-song,22081865,"TÚI ÁO BÌNH GIỮ NHIỆT TIỆN LỢI",40000,40000,0,0
TIKI,nha-cua-doi-song,146887829,"Đèn Pixar, Đèn Bàn Học Chống Cận Thị, Đèn Đọc Sách LED, Đèn Làm Việc Bảo Vệ Mắt, đèn học để bàn, đèn học cho học sinh sinh viên, đèn trang trí decor - Hàng Chính Hãng dododios",148000,148000,0,0
TIKI,nha-cua-doi-song,153291977,"Băng Keo Chống Thấm, Chống Dột Dán Siêu Dính Trên Mọi Bề Mặt, Dán Mái Tôn, Dán Tường, Dán Ống Nước - PucaMart",13000,18999,5999,32
TIKI,nha-cua-doi-song,86376338,"Đèn ngủ Oval cắm điện 10 cấp độ sáng có remote - đèn ngủ thông minh - hẹn giờ - 2 cổng USB sạc nhanh mới 2021",99000,99000,0,0
TIKI,nha-cua-doi-song,16166750,"ÁO MƯA BIT CƠ BẢN",85000,85000,0,0
TIKI,nha-cua-doi-song,54485029,"Đèn Bàn Học Đọc Sách LED Chống Cận 03 Chế Độ Ánh Sáng Bảo Vệ Mắt Có Hộp Bút Và Giá Để Điện Thoại eLights",179000,220000,41000,19
TIKI,nha-cua-doi-song,76046302,"Móc treo quần áo gắn sau cánh cửa tử HOBBY MTGC Nice Day 6 chấu - 2 màu tùy chọn",28000,79000,51000,65
TIKI,nha-cua-doi-song,3677797,"Hộp 3 Lõi Lọc Nước BRITA Maxtra Plus Filter Cartridge",599000,949000,350000,37
TIKI,nha-cua-doi-song,146384829,"Ghế xoay văn phòng công thái học ergonomic có ngả lưng Premium 02, ghế xoay Gaming cao cấp nhập khẩu",1064000,2490000,1426000,57
TIKI,nha-cua-doi-song,1453915,"Ly Giữ Nhiệt Bằng Thép Không Gỉ Lock&Lock Clip Tumbler LHC4151BLK (540ml) - Đen",304000,506000,202000,40
TIKI,nha-cua-doi-song,81936300,"BIG SIZE -Túi Đựng Quần Áo Khung Thép 88L: 60x40x35 (cm) Morning House- Gấp gọn tiện lợi, bảo quản quần áo bền đẹp",88000,88000,0,0
TIKI,nha-cua-doi-song,55875210,"Tủ Vải Đựng Đồ Khung Thép Chịu Lực, Túi Đựng Chăn Màn Quần Áo miDoctor Tiện Lợi - Giao Màu Ngẫu Nhiên",88000,89000,1000,1
TIKI,nha-cua-doi-song,130767592,"Ổ cắm Điện Quang ĐQ ESK 5W. SM740SL (4 lỗ 3 chấu dây 5 mét màu Trắng Đỏ)",158480,198100,39620,20
TIKI,nha-cua-doi-song,48175867,"KỆ TRANG TRÍ VUÔNG 2 TẦNG - CAO 50CM x DÀI 35CM x RỘNG 35CM ",150000,150000,0,0
TIKI,nha-cua-doi-song,655378,"Đèn Tích Điện Đa Năng 360 Cỡ Trung Sunhouse SHE-6848LA - Trắng",201000,331000,130000,39
TIKI,nha-cua-doi-song,77448059,"Cốc giữ nhiệt LocknLock LHC4247PIK Table Mug 473ml",252000,484000,232000,48
TIKI,nha-cua-doi-song,51105287,"Bộ 4 ống hút Inox 304 kèm cọ rửa DandiHome",33000,39000,6000,15
TIKI,nha-cua-doi-song,162112460,"Thùng Rác Tròn Chân Đạp 6l Phù Hợp Văn Phòng, Gia Đình, Phòng Bếp Tiện Nghi Sang Trọng",129000,129000,0,0
TIKI,nha-cua-doi-song,7635008,"Bộ 2 cuộn túi hút chân không một mặt nhám rộng",60000,60000,0,0
TIKI,nha-cua-doi-song,27609461,"Dụng cụ thông tắc bồn cầu, cống bằng khi nén áp lực siêu mạnh",185000,185000,0,0
TIKI,nha-cua-doi-song,53307149,"Bộ tua vít đa năng sửa chữa điện thoại 25 in 1 vít từ tính chất liệu cao cấp S2",38880,38880,0,0
TIKI,nha-cua-doi-song,52006431,"Hộp đựng thìa đũa cá nhân DandiHome (màu ngẫn nhiên)",26500,30000,3500,12
TIKI,nha-cua-doi-song,165346784,"Khăn gội sợi tre Bamboo&Love 35x75cm mềm mại kháng khuẩn siêu thấm hút an toàn cho da ngay cả với trẻ sơ sinh",34900,58000,23100,40
TIKI,nha-cua-doi-song,73529777,"Kệ chén bát đa năng bằng thép carbon không gỉ, chống xước, sơn đen tĩnh điện, giá bát trên bồn rửa ráo nước cho nhà bếp sạch sẽ VANDO",319000,349000,30000,9
TIKI,nha-cua-doi-song,32178097,"Chảo Sâu Lòng NAG2653 Đáy Từ 5 Lớp Chống Dính Vung Kính Siêu Bền Nagakawa (26cm) - Dùng Trên Mọi Loại Bếp - Hàng Chính Hãng",333000,585000,252000,43
TIKI,nha-cua-doi-song,272453821,"[Tặng Bông Lau] Bộ Lau Nhà MyJae Đài Loan Sợi Microfiber Xoay Siêu Tốc 360 Độ Thông Minh 129.5cm",699000,990000,291000,29
TIKI,nha-cua-doi-song,193709920,"Bình Đựng Nước 1L Bao Bì Dễ Thương Có Vạch Báo Giờ Uống Nước Chia Lượng Nước Deli - Nhựa Cao Cấp An Toàn Đầy Đủ Kiểm Định Chất Lượng Phủ Hợp Bình Nước Thể Thao Cho Bé Tới Trường - VS822 VS823",99000,178200,79200,44
TIKI,nha-cua-doi-song,466737,"Hộp Cơm Cắm Điện - Hộp Hâm Nóng Văn Phòng 2 Tầng Life360 EL-ALS263 (Tím) - Hàng Chính Hãng",456000,749000,293000,39
TIKI,nha-cua-doi-song,197412247,"[ TikiNow giao hàng ] Ghế chỉnh dáng ngồi đúng Roichen - Hàn Quốc. Sản phẩm dành cho Nam. Nhập khẩu Hàn Quốc (Made in Korea). Hàng chính hãng Roichen",785000,898000,113000,13
TIKI,nha-cua-doi-song,90523892,"Ly Giữ Nhiệt Lock&Lock Energetic One Touch Tumbler LHC3249 (550ml) - Hàng Chính Hãng, Bằng Thép Không Gỉ Inox 316L, Nắp Mở Một Chạm, Tặng Ống Hút Và Cọ Rửa",289000,488000,199000,41
TIKI,nha-cua-doi-song,74598515,"Đệm ngồi 3D Silicon cao cấp thoáng khí chống đau mỏi - Hàng nhập khẩu",149000,149000,0,0
TIKI,nha-cua-doi-song,191820658,"Gối Cao Su Thiên Nhiên Gummi Cookie Thiết Kế Vòm Cong Tối Ưu Giúp Giảm Đau Cổ Vai Gáy Vượt Trội",489000,720000,231000,32
TIKI,nha-cua-doi-song,72904497,"Kệ Nhà Tắm Kèm Nhả Kem Đánh Răng Tự Động 2 Cốc OENON Lắp Đặt Dán Tường - OEKEM",159000,300000,141000,47
TIKI,nha-cua-doi-song,54483857,"Đèn Bàn Học Đọc Sách, Làm Việc (Học Sinh, Sinh Viên, Văn Phòng) LED Chống Cận, Cảm Ứng Tích Điện Pin 2500mAh Elights BT-618",49000,49000,0,0
TIKI,nha-cua-doi-song,139562345,"Khăn mặt khô  Animerry dùng 1 lần lau khô, lau ướt - Giấy lau mặt dùng một lần",12900,18500,5600,30
TIKI,nha-sach-tiki,181802012,"Set 50/100 tem dán cảm ơn khách và lưu ý quay video mở hàng (8x10cm) (1.025) - tem dán đơn hàng, kiện hàng dành cho shop",40000,40000,0,0
TIKI,nha-sach-tiki,102893964,"Combo 5-10-20 Bút Bi Thiên Long TL-027 - Mực Xanh/Đen/Đỏ/Tím",23000,23000,0,0
TIKI,nha-sach-tiki,14136016,"Phía Nam Biên Giới, Phía Tây Mặt Trời (Tái Bản 2018)",63300,85000,21700,26
TIKI,nha-sach-tiki,186265453,"Komi - Nữ Thần Sợ Giao Tiếp Tập 10 [Tặng Kèm PVC Card]",25000,25000,0,0
TIKI,nha-sach-tiki,73685374,"Combo Trinh Thám Đen: Cô Dâu Đen + Ám Ảnh Đen + Điểm Hẹn Đen + Kết Hôn Với Người Chết",199500,399000,199500,50
TIKI,nha-sach-tiki,189765038,"Python lập trình thuật toán",95000,95000,0,0
TIKI,nha-sach-tiki,186578226,"Hy vọng mong manh",118000,158000,40000,25
TIKI,nha-sach-tiki,58067801,"Luyện Kỹ Năng Phát Âm Tiếng Anh (Trình Độ Sơ Cấp) - English Pronunciation In Use (Elementary)",80000,80000,0,0
TIKI,nha-sach-tiki,52788074,"Khu Vườn Mùa Hạ (Tái Bản 2020)",50500,68000,17500,26
TIKI,nha-sach-tiki,4978895,"Biết Chính Mình",60700,85000,24300,29
TIKI,nha-sach-tiki,27971953,"Lược Sử Tôn Giáo",96300,129000,32700,25
TIKI,nha-sach-tiki,197652268,"Như Cơn Gió Thoảng - Nghĩ Về Những Qui Luật Cuộc Sống",103500,115000,11500,10
TIKI,nha-sach-tiki,1362559,"Cổ Phiếu Thường, Lợi Nhuận Phi Thường (Tái Bản)",127400,199000,71600,36
TIKI,nha-sach-tiki,192909289,"Quán Rượu Dị Giới "Nobu" - Tập 09",31500,40000,8500,21
TIKI,nha-sach-tiki,13312178,"Combo Tôi Tự Học và Óc Sáng Suốt ( Tặng Kèm Sổ Tay )",181350,181350,0,0
TIKI,nha-sach-tiki,10379317,"Nghệ Thuật Giao Tiếp Để Thành Công (Tái Bản 2019)",98020,169000,70980,42
TIKI,nha-sach-tiki,83396665,"Hướng dẫn khởi động & 200 tư thế Yoga từ cơ bản đến nâng cao",128000,185000,57000,31
TIKI,nha-sach-tiki,68049234,"Đừng Để Mất Bò - 7 Bước Quản Lý Cửa Hàng Hiệu Quả Và Chống Thất Thoát",149000,169000,20000,12
TIKI,nha-sach-tiki,48329799,"Tự Học Toàn Diện Hóa Học - Từ Cơ Bản Đến Nâng Cao Lớp 9",65000,99000,34000,34
TIKI,nha-sach-tiki,105614665,"Bút bi bấm ngòi 0.7mm mực xanh Deli - Màu sắc theo lựa chọn -  1 chiếc - EQ199-BL",7200,7200,0,0
TIKI,nha-sach-tiki,101325467,"Bộ Truyện Tranh Gieo Hạt Cùng Vĩ Nhân (Tập 1-10)",270000,270000,0,0
TIKI,nha-sach-tiki,195521211,"Diệt Slime Suốt 300 Năm, Tôi Levelmax Lúc Nào Chẳng Hay (Tập 11)",119000,159000,40000,25
TIKI,nha-sach-tiki,145977548,"Kiếp Người - Vĩnh Cửu Và Vô Thường ",56100,79000,22900,29
TIKI,nha-sach-tiki,141472522,"Sách: Cẩm Nang Tuổi Dậy Thì Dành Cho Bạn Gái (Tái Bản)",80000,100000,20000,20
TIKI,nha-sach-tiki,90679276,"Mở Cửa Tương Lai",129000,200000,71000,36
TIKI,nha-sach-tiki,92996206,"Kinh Yoga Của Patanjali",60700,85000,24300,29
TIKI,nha-sach-tiki,177569697,"Perfect Ielts Vocabulary (Tái Bản)",162200,259000,96800,37
TIKI,nha-sach-tiki,176831144,"Combo 23 Tập Thanh Gươm Diệt Quỷ (Tập 1-23)",499000,575000,76000,13
TIKI,nha-sach-tiki,15256884,"Đầu Tư Tài Chính (Investments)",610000,659000,49000,7
TIKI,nha-sach-tiki,191655862,"[Combo Manga] Diệt Slime Suốt 300 Năm, Tôi Levelmax Lúc Nào Chẳng Hay (Tập 8 + 9)",148000,184000,36000,20
TIKI,nha-sach-tiki,152743081,"Bàn Tay Ánh Sáng",193000,269000,76000,28
TIKI,nha-sach-tiki,464132,"Truyện Kiều",24000,35000,11000,31
TIKI,nha-sach-tiki,194959695,"Thế Giới Mênh Mông Buồn Vui Cất Vào Lòng",65200,90000,24800,28
TIKI,nha-sach-tiki,71898415,"Cơ Thể Ta Đã Hai Triệu Năm - Giải Mã Các Căn Bệnh Thời Hiện Đại",54800,79000,24200,31
TIKI,nha-sach-tiki,187827438,"Vọng Lâu Tử Thần",72400,120000,47600,40
TIKI,nha-sach-tiki,75601401,"Nghệ Thuật Bán Hàng Bằng Câu Chuyện",135360,188000,52640,28
TIKI,nha-sach-tiki,160370181,"Khói Trời Lộng Lẫy (Tập Truyện Ngắn Nguyễn Ngọc Tư)(Tái Bản)",60800,90000,29200,32
TIKI,nha-sach-tiki,185500892,"i-Learn Smart Start 5 Workbook Special Edition",81000,81000,0,0
TIKI,nha-sach-tiki,44976191,"Economix - Các Nền Kinh Tế Vận Hành (Và Không Vận Hành) Thế Nào Và Tại Sao?",114000,152000,38000,25
TIKI,nha-sach-tiki,57211757,"Utopia - Địa đàng trần gian (Tái Bản 2020)",43300,60000,16700,28
TIKI,nha-sach-tiki,122869197,"túi giấy đựng quà các cỡ loại đẹp có nắp",9000,14400,5400,38
TIKI,nha-sach-tiki,167149888,"Khám Phá Đứa Trẻ Bên Trong Bạn",98500,139000,40500,29
TIKI,nha-sach-tiki,113656189,"Giáo Trình Lịch Sử Đảng Cộng Sản Việt Nam (Dành Cho Bậc Đại Học Hệ Không Chuyên Lý Luận Chính Trị) - Bộ mới năm 2021",84000,84000,0,0
TIKI,nha-sach-tiki,32219488,"Doanh Nghiệp Của Thế Kỷ 21 (Tái Bản 2019)",62200,100000,37800,38
TIKI,nha-sach-tiki,146271773,"Nghiệp Tình Yêu - Karma Of Love (Tái Bản 2021)",175200,199000,23800,12
TIKI,nha-sach-tiki,1007137,"Tự Học 2000 Từ Vựng Tiếng Anh Theo Chủ Đề",45500,65000,19500,30
TIKI,nha-sach-tiki,191919683,"Tro tàn của Angela",171000,220000,49000,22
TIKI,nha-sach-tiki,88592202,"Tiny Habits : Thói quen tí hon - Tiềm năng khổng lồ",299000,299000,0,0
TIKI,nha-sach-tiki,176550198,"Nam Hải Dị Nhân Liệt Truyện",353000,500000,147000,29
TIKI,nha-sach-tiki,111582624,"Trải Nghiệm Apple - Xây Dựng Lòng Trung Thành Không Chỉ Từ Sản Phẩm",197000,239000,42000,18
TIKI,nha-sach-tiki,117254518,"Thiên Nga Hoang Dã",271000,350000,79000,23
TIKI,nha-sach-tiki,192733741,"Mùi hương - Tái Bản",85800,115000,29200,25
TIKI,nha-sach-tiki,100947280,"Những Phương Thức Phục Hồi Sức Khỏe Theo Tự Nhiên (Tái Bản)",70800,99000,28200,28
TIKI,nha-sach-tiki,152743069,"FPT Bí Lục - Khám Phá Văn Hoá Doanh Nghiệp Tại FPT",138000,199000,61000,31
TIKI,nha-sach-tiki,186229224,"Bộ Sách Khởi Nghiệp Kinh Doanh Online - Marketing và Bán Hàng Hiệu Quả Với Thương Mại Điện Tử Tại Việt Nam",277000,378000,101000,27
TIKI,nha-sach-tiki,182736915,"Combo 3 Cuốn Sách: Cuộc Hành Hương Nội Tại - Chính Trực - Giác Ngộ",325100,467000,141900,30
TIKI,nha-sach-tiki,185409035,"Bút Bi Nước Mực Gel Bấm Ngòi 0.5mm Deli - Có Ngòi Thay Thế Viết Trơn Đều Phù Hợp Ghi Chép Văn Phòng Học Sinh Sổ Tay - A575",2000,5400,3400,63
TIKI,nha-sach-tiki,184419723,"Sapiens Lược Sử Loài Người (Tái Bản 2022)",185400,299000,113600,38
TIKI,nha-sach-tiki,188128048,"Ikigami - Tập 04",32100,45000,12900,29
TIKI,nha-sach-tiki,181122317,"Chân Trần Chí Thép (Tái Bản 2022)",114000,168000,54000,32
TIKI,nha-sach-tiki,49002497,"Tâm Bệnh Học",82900,145000,62100,43
TIKI,nha-sach-tiki,149534865,"Bảy Thanh Hung Giản 2 - Hổ Phách Đỏ Son - Gió Cuốn Cát Bụi",171000,230000,59000,26
TIKI,nha-sach-tiki,113540588,"Thiên Táng",74400,96000,21600,23
TIKI,nha-sach-tiki,7958959,"5 Điểm Chết Trong Teamwork",79300,128000,48700,38
TIKI,nha-sach-tiki,48629547,"Tiền Không Mua Được Gì (What money can't buy?) - Michael Sandel Tác giả Phải Trái Đúng Sai",78000,125000,47000,38
TIKI,nha-sach-tiki,48362502,"Sang Chấn Tâm Lý - Hiểu Để Chữa Lành",225000,350000,125000,36
TIKI,nha-sach-tiki,2903309,"Khéo Ăn Nói Sẽ Có Được Thiên Hạ ( Tái Bản )",104000,130000,26000,20
TIKI,nha-sach-tiki,14655498,"Bút bi TriTouch ngòi 0.7mm (hộp 12 cái)",54000,54000,0,0
TIKI,nha-sach-tiki,160585830,"Tôi Thích Tin Tức Tố Của Cậu - Tập 2 (Tặng Kèm Bookmark)",146000,169000,23000,14
TIKI,nha-sach-tiki,195801705,"Một Nửa Chiếc Va Li",116000,130000,14000,11
TIKI,nha-sach-tiki,32720778,"Sách tiếng Anh - Principles: Life and Work",483600,520000,36400,7
TIKI,nha-sach-tiki,21146016,"Tinh Mắt Bắt Hình – Nông Trại",41500,60000,18500,31
TIKI,nha-sach-tiki,185232575,"Tiếng Anh 3 Extra and Friends Activity book (Sách bài tập)",65000,65000,0,0
TIKI,nha-sach-tiki,55119185,"Sách Nghĩ Giàu và Làm Giàu (Bìa Cứng) (Tái Bản 2020)",117000,168000,51000,30
TIKI,nha-sach-tiki,102832718,"Thay Tư Duy Xoay Cục Diện - Vĩnh Biệt Lối Mòn",84100,119000,34900,29
TIKI,nha-sach-tiki,56757447,"Tiền Đẻ Ra Tiền: Đầu Tư Tài Chính Thông Minh",95100,139000,43900,32
TIKI,nha-sach-tiki,197634256,"Black Jack - Tập 14 (Bìa Cứng)",134000,135000,1000,1
TIKI,nha-sach-tiki,198016658,"Birdmen - Tập 8",29000,30000,1000,3
TIKI,nha-sach-tiki,123236564,"Combo 6 cuốn: Miếng dán Thông minh cho bé (Phát triển EQ - IQ) - My First Sticker Book",131040,252000,120960,48
TIKI,nha-sach-tiki,151597556,"American Jetstream Pre-Intermediate A Student's book & Workbook ( không kèm CD)",207000,207000,0,0
TIKI,nha-cua-doi-song,84699481,"Đèn Bàn Học Đọc Sách Làm Việc LED Chống Cận Bảo Vệ Mắt – Cảm Ứng Tích Hợp Sạc Không Dây - Vùng Sáng 3000-6500K – 5 Cấp Độ Điều Chỉnh – Phiên Bản Nâng Cấp Cổng Type-C",649000,799000,150000,19
TIKI,nha-cua-doi-song,73116895,"Găng tay nướng bánh cách nhiệt Baking Gloves ",50000,50000,0,0
TIKI,nha-cua-doi-song,113458874,"Tủ Để Đồ Thông Minh S Smart Tận Dụng Không Gian Cạnh Cửa Sổ - GP131",406000,444000,38000,9
TIKI,nha-cua-doi-song,579928,"Chảo Sâu Chống Dính Sunhouse SHS20 20cm",130000,180000,50000,28
TIKI,nha-cua-doi-song,100522012,"Cây Lau Nhà Thông Minh, Chổi Lau Nhà 360 Độ Đa Năng (Không Bao Gồm Thùng Vắt) - Parroti MOP-PR01",209000,269000,60000,22
TIKI,nha-cua-doi-song,14981747,"01 hộp đũa Inox 304 cao cấp DandiHome (10 đôi) - Cá chép vượt cổng Vũ Môn",300000,300000,0,0
TIKI,nha-cua-doi-song,25412653,"Cây lăn bụi quần áo đa năng kèm 2 cục dự phòng",13000,25000,12000,48
TIKI,nha-cua-doi-song,477936,"Lõi Lọc Kova-Barrier Tiêu Chuẩn - FC-STD",183000,235000,52000,22
TIKI,nha-cua-doi-song,579854,"Nồi Nấu Bột Chống Dính Nắp Kính Sunhouse SHG-MP14 14cm",122000,180000,58000,32
TIKI,nha-cua-doi-song,174378686,"Miếng gảy đàn, Pick - Alice AP-ALT - Dành cho Guitar, Ukulele, Bass - Dày 0.46mm, Colorful Celluloid - Màu ngẫu nhiên - Hàng chính hãng",14000,14000,0,0
TIKI,nha-cua-doi-song,134621577,"[Nhập CECAMP70KD1 giảm 70k đơn 999k] Bộ Dao 7 Món Lock&amp;Lock CKK301",1594000,2657000,1063000,40
TIKI,nha-cua-doi-song,88241130,"Khăn trải bàn nhựa PVC không thấm nước, khăn trai bàn có hoạ tiết đẹp phù hợp với mọi nhà",55000,55000,0,0
TIKI,nha-cua-doi-song,51530502,"GƯƠNG KỆ ĐỨNG KHUNG GỖ HÀN QUỐC - MIRROR SHELF - D41 X R35 X C160 - 2 MÀU LỰA CHỌN",415000,420000,5000,1
TIKI,nha-cua-doi-song,72332230,"GỐI CHỮ U CAO SU NON - GỐI TỰA CỔ CHO DÂN VĂN PHÒNG, LÁI XE, DU LỊCH",99000,99000,0,0
TIKI,nha-cua-doi-song,10017811,"Súng bắn keo nến 20w +Tặng 10 cây keo nến ",44300,44300,0,0
TIKI,nha-cua-doi-song,54476660,"Đèn Bàn Học Đọc Sách, Làm Việc (Học Sinh, Sinh Viên, Văn Phòng) Cao Cấp Kẹp Bàn – 03 Mức Độ Ánh Sáng Vàng Bảo Vệ Mắt Chống Cận Pin 2500 mAh",149000,149000,0,0
TIKI,nha-cua-doi-song,80901951,"Kéo Nhật Nội Địa SK5 Siêu Sắc, Kéo Nhà Bếp, Kéo Cắt Gà, Cắt Vịt, Cắt Thịt Các Loại",79000,79000,0,0
TIKI,nha-cua-doi-song,31206755,"Hộp 40 viên pin Maxell AAA",122000,130000,8000,6
TIKI,nha-cua-doi-song,195968874,"Đèn LED Mini Móc Khóa Siêu Sáng Tiện Dụng US ARMY,  Đèn Pin COB Dã Ngoại Thường Ngày, Sạc TYPE-C Tiện Dụng Dung Lượng PIN 500mAh  Full Hộp Sạc- HÀNG CHÍNH HÃNG",63000,178000,115000,65
TIKI,nha-cua-doi-song,197799361,"Combo 2 Bộ Chuyển Đổi Ổ Cắm 2 Chấu Thành 3 Chấu",27094,28520,1426,5
TIKI,nha-cua-doi-song,146509745,"Bộ Hộp Cơm Giữ Nhiệt Văn Phòng Cao Cấp Cắm Điện inox 3 tầng - Chính hãng dododios",189000,189000,0,0
TIKI,nha-cua-doi-song,56612464,"Hộp Cơm Giữ Nhiệt INOX304 Hiện Đại Kèm Hộp Đựng Canh Soup",177650,187000,9350,5
TIKI,nha-cua-doi-song,143217219,"Kệ Đa Năng Lưu Trữ Đồ Dùng, Giá Sách Có Bánh Xe Thương Hiệu IGA - GP173",293000,318000,25000,8
TIKI,nha-cua-doi-song,176592358,"Cây lau nhà tự vắt đa năng Sunhouse KS-MO3211PW",181000,263000,82000,31
TIKI,nha-cua-doi-song,241805597,"Móc Dán Tường, Móc Dính Tường Treo Đồ Nặng Siêu Dính Inox 304 - Treo Thớt, Nồi Niêu Xong Chảo, Treo Đồ Đa Năng",12000,12000,0,0
TIKI,nha-cua-doi-song,17000892,"Ô gấp gọn chống tia UV ",35000,35000,0,0
TIKI,nha-cua-doi-song,172447892,"Bộ 6 túi giặt siêu dày 3 lớp cao cấp - Combo 6 túi lưới bảo vệ quần áo dùng cho máy giặt siêu bền tiện dụng chính hãng",165000,250000,85000,34
TIKI,nha-cua-doi-song,63821690,"Vòi Lavabo lạnh - 01 đường nước - tay gật gù Yamato cao cấp",169000,200000,31000,16
TIKI,nha-cua-doi-song,105717965,"Bình Giữ Nhiệt 2GOOD FLASK WM-02 Sport Lid (946ml) - Hàng Chính Hãng",399000,399000,0,0
TIKI,nha-cua-doi-song,274121764,"Ruột Gối Ôm Gòn Cozy Thuần Việt - Sợi Gòn Cao Cấp, Êm Ái - Kích Thước 20x100",220000,350000,130000,37
TIKI,nha-cua-doi-song,70820849,"Pin CR2032 Energizer 3V vỉ 5 viên",59000,100000,41000,41
TIKI,nha-cua-doi-song,579962,"Bộ Nồi 5 Đáy Cao Cấp Núm Vàng Sunhouse SH781 Quay Mạ Vàng Cao Cấp (16cm, 20cm, 24cm) - Dùng Cho Mọi Loại Bếp - Hàng Chính Hãng",487000,960000,473000,49
TIKI,nha-cua-doi-song,70898819,"Giấy ăn giấy gấu trúc Ycool -khăn giấy rút 300 tờ 1bịch 10 gói mẫu trắng",45000,45000,0,0
TIKI,nha-cua-doi-song,59047203,"Bộ 10 đầu tưới nắp chai nhỏ giọt tự động thông minh có điều chỉnh ( tưới hoa, cây cảnh )",29000,29000,0,0
TIKI,nha-cua-doi-song,199581980,"Kệ Sách Gỗ Để Bàn Thương Hiệu IGA - GP62",100000,109000,9000,8
TIKI,nha-cua-doi-song,120470943,"Bình Nước Thuỷ Tinh Luminarc Bucolique 1.3L - LUBIN1806 ",136000,136000,0,0
TIKI,nha-cua-doi-song,134242996,"Ly Nhựa Có Ống Hút Lock&amp;Lock HAP507YEL",113000,217000,104000,48
TIKI,nha-cua-doi-song,112760341,"Thùng rác treo tủ bếp có nắp đậy thông minh, thùng rác treo tường dán tường, có thanh trượt cửa bếp – Parroti Bin BN02",169000,299000,130000,43
TIKI,nha-cua-doi-song,128584341,"Ổ cắm đa năng USB Rạng Đông dài 3m Model: OC02.USB 3C/3M/10A",277200,308000,30800,10
TIKI,nha-cua-doi-song,51541280,"Hộp Cơm Cắm Điện - Hộp Hâm Nóng Văn Phòng 2 Tầng ArirangLife EL-ALS263 (Hồng) - Hàng chính hãng",455000,749000,294000,39
TIKI,nha-cua-doi-song,72049662,"Combo 6 Túi Giặt Lưới Bảo Vệ Quần Áo, túi lưới mịn polyester bảo quản quần áo",99000,99000,0,0
TIKI,nha-cua-doi-song,52238726,"Mùng Chụp Tự Bung Cao Cấp Siêu Dày - Màu Xanh Da Trời  + Tặng kèm túi thơm thảo dược",155000,215000,60000,28
TIKI,nha-cua-doi-song,19929974,"Bộ 4 Ống Hút Thủy Tinh Chịu Nhiệt (2 Cong + 2 Thẳng) + 2 Cọ Rửa + 1 Túi Vải",69000,69000,0,0
TIKI,nha-cua-doi-song,70083074,"Ghế xếp thư giãn SUMIKA 199 - có lăn tay massage, khung vuông cao cấp, tải trọng 300kg",1165000,1580000,415000,26
TIKI,nha-cua-doi-song,89992214,"Kệ Góc Nhà Tắm INOX 304 dán tường gạch men siêu chắc",69000,125000,56000,45
TIKI,nha-cua-doi-song,146432055,"Túi Chân Không Tự Hút Đựng Chăn Mền Quần Áo Không Cần Dụng Cụ Hút",42000,42000,0,0
TIKI,nha-cua-doi-song,134515126,"Bình giữ nhiệt cho trẻ em LocknLock Cozy Kids Straw Tumbler LHC4236BLU 330ml - Màu",355000,592000,237000,40
TIKI,nha-cua-doi-song,71174837,"Đèn Pin Mini Siêu Sáng XML-T6 miDoctor - Chính Hãng",86000,86000,0,0
TIKI,nha-cua-doi-song,116048764,"Kệ sách tổ ong vân gỗ dễ dàng kết hợp với bàn làm việc chính hãng IGA - GP100",121000,130000,9000,7
TIKI,nha-cua-doi-song,53599746,"Combo Giá Treo Ổ Cắm Điện, Modem Dán Tường Tiện Dụng",19900,19900,0,0
TIKI,nha-cua-doi-song,71999227,"Bộ Nồi Inox 3 Lớp Đáy Liền Elmich Trimax Classic 2106OL Size 18,20,24cm",1591000,2870000,1279000,45
TIKI,nha-cua-doi-song,165109465,"Kệ Lò Vi Sóng 2 Tầng, Kệ Nhà Bếp Thương Hiệu IGA - GM52",155000,169000,14000,8
TIKI,nha-cua-doi-song,192258425,"Thảm Chùi Chân 4 Lớp Siêu Thấm Hút Nhiều Hoa Văn Độc Đáo",79000,79000,0,0
TIKI,nha-cua-doi-song,75340681,"Hộp Đựng Đồ Đa Năng TD1 – Túi Vải Đựng Quần Áo Chăn Màn Phong Cách Thụy Điển Sang Trọng, Lịch Sự – Hàng Chính Hãng",76000,130000,54000,42
TIKI,nha-cua-doi-song,68716607,"Dao Thái Sunhouse KS-KN165SS",73000,117000,44000,38
TIKI,nha-cua-doi-song,115532506,"Hộp Nhựa Đựng Thực Phẩm, Hộp Bảo Quản Thực Phẩm Tủ Lạnh Homepower Trong Suốt Có Khay Lót Đáy Giúp Ráo Nước, Vòng Ghi Chú Thời Gian Bảo Quản Tiện Lợi",129000,129000,0,0
TIKI,nha-cua-doi-song,803123,"Thùng rác nhựa Fitis Compact X PPL1-906",280000,350000,70000,20
TIKI,nha-cua-doi-song,17488465,"Vỉ 5 viên Pin GP 12V 23A",49000,49000,0,0
TIKI,nha-cua-doi-song,84746981,"Lọ đựng gia vị, dầu ăn, nước chấm bằng thủy tinh trong suốt kèm muỗng tiện lợi",10999,10999,0,0
TIKI,nha-cua-doi-song,199593599,"Kệ Sách Hình Cây Để Sàn",224000,245000,21000,9
TIKI,nha-cua-doi-song,89980825,"Bộ 2 nhả kem đánh răng tự động OENON, Kệ nhà tắm thông minh kèm cốc láp đặt dán tường - 2NHAKEM",229000,400000,171000,43
TIKI,nha-cua-doi-song,111511362,"Cuộn giấy lau nhà bếp đa năng 220 tờ màu trắng siêu dai có thể giặt được",9000,10500,1500,14
TIKI,nha-cua-doi-song,59259444,"Mùng chụp tự bung cao cấp FUNU - Màn chống muỗi thông minh - Hàng chính hãng (Sản xuất tại Việt Nam)",145700,155000,9300,6
TIKI,nha-cua-doi-song,169978766,"Túi Hút Chân Không Đựng Quần Áo, Chăn Ga Gối, Thú Bông Deli - Loại Dày Cao Cấp, Nhiều Hoạ Tiết, Bảo Vệ Quần Áo, Chăn Ga Khỏi Ẩm, Nấm Mốc, Chống Nước Tuyệt Đối",16000,35820,19820,55
TIKI,nha-cua-doi-song,59598451,"Miếng xốp bọc chân cửa chắn gió chống bụi, ngăn tiếng ồn, ngăn côn trùng 93 x 9.6cm",20000,20000,0,0
TIKI,nha-cua-doi-song,38059858,"Bộ 10 khăn lau 2 mặt siêu thấm- Khăn lau không phai màu không rụng sợi- nhanh khô- Khăn lau bếp, khăn lau kính, lau bát lau tay",9999,9999,0,0
TIKI,nha-cua-doi-song,270862516,"Gối cao su chống đau cột sống - Gối cao su dành cho người hay ngủ ngáy mỏi cổ vai gáy – Hàng chính hãng",127000,200000,73000,37
TIKI,nha-cua-doi-song,88925284,"Ổ Cắm Điện LIOA 10 ổ dây 3m(4D6S32) & 5m (4D6S52)",140000,140000,0,0
TIKI,nha-cua-doi-song,114976767,"Nệm foam Goodnight Massage bán chạy số 1 Việt Nam 9cm tại Vua Nệm - Cấu trúc lượn sóng duy trì tư thế tự nhiên của cột sống",4290000,4290000,0,0
TIKI,nha-cua-doi-song,157055245,"Combo 100 viên khăn giấy nén hình viên kẹo bỏ túi khi đi du lịch, 50 viên khăn lau mặt dạng nén dùng một lần siêu tiện lợi",35000,35000,0,0
TIKI,nha-cua-doi-song,54412879,"Lô 4 túi rác tiện dụng Soji - size 10L - 25L và 50L",33250,35000,1750,5
TIKI,nha-cua-doi-song,163827070,"Combo 2 hộp chia ngăn sắp xếp quần áo phong cách Nhật Bản VINAVU",190000,190000,0,0
TIKI,nha-cua-doi-song,146062295,"Bộ 2 Ốc Vít - Chốt Cao Su Cố Định Nắp Bồn Cầu",68000,68000,0,0
TIKI,nha-cua-doi-song,103780888,"Ổ cắm có dây - Ổ điện an toàn - Ổ cắm điện đa năng - Ổ cắm điện Lioa ( 4 - 6 - 10 ổ cắm ) dây 5m và 3m Lioa - hàng chính hãng cao cấp",62000,62000,0,0
TIKI,nha-cua-doi-song,14448546,"Bình Gas Bơm Bật Lửa BlueSky",55000,55000,0,0
TIKI,nha-cua-doi-song,169650796,"Màn chụp, mùng chụp đỉnh vuông Không chân viền cao cấp Một Cửa - Hàng chính hãng (Giao ngẫu nhiên)",313500,330000,16500,5
TIKI,nha-cua-doi-song,45404047,"[ĐẶC BIỆT] Nhang Xanh Trầm Hương Cao Cấp 15 năm -100g - mùi thơm tự nhiên, dịu ngọt của trầm - Nhang Thiền",123500,125000,1500,1
TIKI,nha-cua-doi-song,191822621,"Gối Foam Contour Doona Sofy Cấu Trúc Lượn Sóng Nâng Đỡ Định Hình Xương Cổ Và Đầu Hoàn Hảo",339000,600000,261000,44
TIKI,nha-cua-doi-song,31576989,"Quai xách Dây Dù bình giữ nhiệt 2GOOD Para Handle",65000,65000,0,0
TIKI,nha-cua-doi-song,163574367,"Nến Thơm Cenote 4 Mùi Cao Cấp, Có Nắp Tắt Lửa Không Khói, Dùng cho Phòng Khách, Spa, Khách sạn và Phòng Hát Karaoke",139000,139000,0,0
TIKI,nha-sach-tiki,170490710,"Bàn Về Cách Sống – Đối Thoại Giữa Triết Gia, Bác Sĩ Và Nhà Sư",99600,139000,39400,28
TIKI,nha-sach-tiki,153518828,"Hong Tay Khói Lạnh (Tản Văn Nguyễn Ngọc Tư)",62000,90000,28000,31
TIKI,nha-sach-tiki,174605338,"Bách Khoa Thư Về Nghệ Thuật",301400,499000,197600,40
TIKI,nha-sach-tiki,109298270,"Sách Cẩm Nang Con Gái (Tái Bản)",47500,68000,20500,30
TIKI,nha-sach-tiki,171549954,"Tâm Hồn Cao Thượng",150000,220000,70000,32
TIKI,nha-sach-tiki,145092110,"Cách Biến Đổi Câu Trong Tiếng Anh",57900,80000,22100,28
TIKI,nha-sach-tiki,130230750,"Combo 10 Tập - Truyện tranh song ngữ Việt-Anh dành cho trẻ em - Cùng học cư xử tốt",278000,280000,2000,1
TIKI,nha-sach-tiki,189643106,"Tự Tôn",117700,169000,51300,30
TIKI,nha-sach-tiki,77900450,"Đạo Phật Vỡ Lòng (Tái Bản)",49600,69000,19400,28
TIKI,nha-sach-tiki,194197858,"Achievers grade 7 Workbook",112000,112000,0,0
TIKI,nha-sach-tiki,165700192,"Lịch Sử Vú",173000,248000,75000,30
TIKI,nha-sach-tiki,72542474,"Biên Niên Cô Đơn (Bản Thông Thường)",72000,99000,27000,27
TIKI,nha-sach-tiki,5852521,"Combo Cà Phê Cùng Tony và Trên Đường Băng",186950,186950,0,0
TIKI,nha-sach-tiki,190705658,"Bật Khóc Ở H Mart",104000,140000,36000,26
TIKI,nha-sach-tiki,46259908,"Fibonacci Trading",299000,299000,0,0
TIKI,nha-sach-tiki,136539753,"Tự Chữa Lành Thông Qua Hiểu Biết Về Khoa Học Tâm Thức",85200,119000,33800,28
TIKI,nha-sach-tiki,189557422,"THINK OUT OF THE BOOK - Nghĩ Ngoài Sách Vở",190000,220000,30000,14
TIKI,nha-sach-tiki,193981040,"Birdmen - Tập 5",29000,30000,1000,3
TIKI,nha-sach-tiki,137241901,"Thần Số Học: Sức Mạnh Của Những Con Số",98500,139000,40500,29
TIKI,nha-sach-tiki,10244763,"Bút quay nghệ thuật - Era PS Mod",99000,99000,0,0
TIKI,nha-sach-tiki,170345811,"Phân Tích Khách Hàng For Dummies",159000,229000,70000,31
TIKI,nha-sach-tiki,75697497,"Lịch Sử Triết Học (Trọn Bộ 2 Tập) (Tập 1: Triết Học Cổ Đại Và Trung Đại + Tập 2: Triết Học Cận Đại Và Hiện Đại)",853000,900000,47000,5
TIKI,nha-sach-tiki,12533371,"Đạo Đức Kinh",66400,99000,32600,33
TIKI,nha-sach-tiki,69621516,"Combo sách: Bài thơ - bài hát - câu đố dành cho bé (tái bản 2020)",95000,135000,40000,30
TIKI,nha-sach-tiki,196001728,"Vạn Sắc Hư Vô",99000,150000,51000,34
TIKI,nha-sach-tiki,193177952,"Bản đặc biệt Tổng ôn 30 chuyên đề ngữ pháp tiếng anh cô Trang anh 2023",199000,300000,101000,34
TIKI,nha-sach-tiki,273714632,"Trí Tuệ Do Thái (Tái Bản)",140900,189000,48100,25
TIKI,nha-sach-tiki,127377217,"Sách Người Trong Muôn Nghề: Ngành Sáng tạo và Nghệ thuật có gì?",201000,219000,18000,8
TIKI,nha-sach-tiki,185055209,"Osho - Combo Sống Hài Hòa (Yêu, Cảm Xúc, Hiểu)",375000,524000,149000,28
TIKI,nha-sach-tiki,157468180,"Trọn Bộ 4 Quyển Sách Trên Lưng Khổng Tượng - Kinh Doanh Online Trên Sàn Thương Mại Điện Tử - Khởi Nghiệp Với Bán Hàng Qua Mạng và Nhãn Hàng Riêng",481000,796000,315000,40
TIKI,nha-sach-tiki,190242072,"Qủy Ấn - Bộ 2 tập ( Tập 1 và 2) - tặng kèm 1 bookmark",211000,291000,80000,27
TIKI,nha-sach-tiki,87149160,"Bộ Cọ Vẽ Chuyên Nghiệp Deli - Dùng Cho Màu Nước/Bột/Sơn Acrylic -Set 4/6 Cây- 73885/73866/73867",40000,88200,48200,55
TIKI,nha-sach-tiki,58067806,"Từ Vựng Tiếng Anh Thực Hành (Trình Độ Trung Cấp) - English Collocation In Use (Intermediate)",47000,80000,33000,41
TIKI,nha-sach-tiki,38436464,"Khác Biệt Để Bứt Phá (Tái Bản 2019)",89100,128000,38900,30
TIKI,nha-sach-tiki,192048663,"Sáng trăng",58000,75000,17000,23
TIKI,nha-sach-tiki,54614791,"Từ Điển Tâm Lý - Tính Cách Và Cảm Xúc Đến Từ Đâu ?",94000,128000,34000,27
TIKI,nha-sach-tiki,13797246,"Combo 6 Cuốn Ehon nhật bản - Giờ Chơi Của Bé ( Tái Bản )",125000,174000,49000,28
TIKI,nha-sach-tiki,6482397,"Hàn Quốc Dưới Chế Độ Độc Tài Phát Triển Park Chung Hee (1961 – 1979)(Tái Bản 2020)",76000,98000,22000,22
TIKI,nha-sach-tiki,160585764,"Veil - Thân Nhiệt Của Sắc Cam - Tập 1 (Tặng Kèm Postcard)",92200,109000,16800,15
TIKI,nha-sach-tiki,193896561,"Ninja Rantaro - Tập 59",37100,40000,2900,7
TIKI,nha-cua-doi-song,53647975,"1 Gối Ôm thương hiệu A có khóa kéo - an toàn sức khỏe, không chứa chất độc hại - êm ái, mềm mịn - KT",125000,150000,25000,17
TIKI,nha-cua-doi-song,20025334,"Bình Chữa Cháy Dạng Bột Khô ABC MFLZ-4Kg (Chữa cháy chất Rắn, Lỏng và Khí)",220000,380000,160000,42
TIKI,nha-cua-doi-song,162597633,"Combo 4 miếng dán đỡ kệ gỗ VINAVU, giúp chia ngăn tủ, không cần đóng đinh",24000,24000,0,0
TIKI,nha-cua-doi-song,153467342,"Xốp Chèn Cửa 95cm Chặn Đáy Khe Cửa, Cách Nhiệt, Cách Âm, Ngăn Côn Trùng, Thanh Chắn Khe Cửa",4000,26000,22000,85
TIKI,nha-cua-doi-song,91475535,"Áo Mưa Cánh Dơi Rằn Ri, Áo Mưa Xẻ Tà Màu Lính Vải Dù Siêu Dày 1M4, Chống Thấm Hiệu Quả, Phù Hợp Nam Và Nữ, Có Túi Đựng",130000,130000,0,0
TIKI,nha-cua-doi-song,54582729,"KỆ ĐẦU GIƯỜNG 1 TẦNG - TỦ ĐẦU GIƯỜNG - GỖ THÔNG NEWZEALAND - MÀU GỖ VÀNG NHẠT TỰ NHIÊN CÓ VÂN GỖ",109000,200000,91000,46
TIKI,nha-cua-doi-song,57272706,"Combo 200 túi lọc rác bồn rửa bát - Túi lưới lọc rác giúp ngăn chặn tắc đường ống",33030,33030,0,0
TIKI,nha-cua-doi-song,135321378,"Thanh Chặn Khe Cửa 95cm Đa Năng,Chặn Đáy Khe Cửa, Ngăn Côn Trùng, Chắn Gió Mùa, Ngừa Bụi Bẩn, Giảm Ồn",8000,13999,5999,43
TIKI,nha-cua-doi-song,190989483,"Bình giữ nhiệt Baby Inox 316 Elmich EL8017 dung tích 300ml",231000,319000,88000,28
TIKI,nha-cua-doi-song,79267304,"Túi rác tự hủy inochi tiện dụng SOJI có quai xuất nhật Dùng đựng rác gia đình ,Bao đựng rác văn phòng đủ size -màu đen mềm nhẹ dai túi rác tự hủy giúp bảo vệ môi trường",38000,45000,7000,16
TIKI,nha-cua-doi-song,125913928,"Móc dán tường trong suốt Móc treo đồ Móc dán tường 3D",700,1000,300,30
TIKI,nha-cua-doi-song,185380294,"Lưới Polyester Phủ Chống Thấm, Vải Polyester Gia Cố Chống Thấm Mái Nhà Sàn Nhà Khe Nứt Khổ 10 cm",77350,91000,13650,15
TIKI,nha-cua-doi-song,104681179,"Bông Lau Thay Thế MyJae Dạng Tròn Dành Cho Cây Lau Nhà Xoay 360 Độ",109000,200000,91000,46
TIKI,nha-cua-doi-song,193708669,"Bình Đựng Nước 2L Kèm Ống Hút Bao Bì Dễ Thương Có Vạch Báo Giờ Uống Nước Chia Lượng Nước Deli - Bình Nước 2 Lít Nhựa Cao Cấp An Toàn Đầy Đủ Kiểm Định Chất Lượng Phủ Hợp Bình Nước Thể Thao Cho Bé Tới Trường - VS818 VS819",85000,160200,75200,47
TIKI,nha-cua-doi-song,15343778,"Kệ góc nhà tắm dán tường inox 304 bóng Hobby Home Decor KG1 kèm keo dán và đinh ốc",249000,249000,0,0
TIKI,nha-cua-doi-song,272966734,"Ổ cắm điện 5 lỗ 2m Điện Quang SM750SL - Hàng Chính Hãng",175000,175000,0,0
TIKI,nha-cua-doi-song,34230976,"Bàn làm việc 2 tầng 80cm",210602,214900,4298,2
TIKI,nha-cua-doi-song,21301419,"Bàn để là quần áo dạng đứng",140000,140000,0,0
TIKI,nha-cua-doi-song,3526073,"Bộ Túi Hộp Cơm Thủy Tinh Lock&Lock 3EA LLG428M2 - Xanh Mint",343000,660000,317000,48
TIKI,nha-cua-doi-song,72044284,"BÀN LÀM VIỆC CHÂN GẤP GỌN 100CM - Nhiều màu sắc",392000,400000,8000,2
TIKI,nha-cua-doi-song,53830678,"1 cặp ruột gối hơi cao cấp - Gòn bông nhân tạo an toàn sức khỏe, không chứa chất độc hại - Có khóa kéo dễ dàng thêm bớt gòn bên trong - Êm ái, mềm mịn",60000,65000,5000,8
TIKI,nha-cua-doi-song,55202824,"Bình Nước Nhựa Nắp Vặn Dây Treo Họa Tiết Hươu Và Trăng Tiện Dụng Phù Hợp Với Mọi Lứa Tuổi 560ml",129000,258000,129000,50
TIKI,nha-cua-doi-song,66877902,"Đèn Ngủ Quả Cầu Mây Để Bàn SPEVI - Điều Chỉnh Độ Sáng, Làm Đèn Ngủ Trang Trí, Quà Sinh Nhật Cực Đáng Yêu, Đầu USB, Adapter USB Tiện Lợi, Đế Gỗ Xếp Sang Trọng, Bóng Đèn Led Vô Cùng Tiết Kiệm Điện - Hàng Chính Hãng",129000,246000,117000,48
TIKI,nha-cua-doi-song,137572447,"Bóng đèn LED Bulb PHILIPS Essential E27 - Tiết kiệm điện, Ánh sáng chất lượng cao - Hàng Chính Hãng",42000,66000,24000,36
TIKI,nha-cua-doi-song,202805092,"Bình Giữ Nhiệt 800ml Lock&Lock Vacuum Bottle LHC6180 - Hàng Chính Hãng, Bằng Thép Không Gỉ, Có Lưới Lọc Trà Bằng Inox, Mức Giữ Nhiệt Vượt Trội Tặng Kèm Ống Hút Inox",373000,697000,324000,46
TIKI,nha-cua-doi-song,75616917,"Khăn lau vuông đa năng tiện lợi có dây treo siêu thấm hút lau tay lau bếp vệ sinh nhà cửa 25x25cm",8000,8000,0,0
TIKI,nha-cua-doi-song,21782438,"Kìm  kẹp quả óc chó ,càng cua, ghẹ inox - 17x4.5cm 247g",26000,26000,0,0
TIKI,nha-cua-doi-song,21466758,"Đầu chuyển ổ cắm 3 chấu qua 2 chấu - Hàng nhập khẩu",11353,11950,597,5
TIKI,nha-cua-doi-song,97817455,"Bộ túi hộp cơm thủy tinh COBA'COOK. Gồm 3 hộp 400ml và 1 túi giữ nhiệt với 2 khóa kéo tiện dụng- CCR43BL",203000,316000,113000,36
TIKI,nha-cua-doi-song,54132706,"Bộ sạc Energizer Charger kèm 4 pin Ener AA 2000mAh, tự ngắt sạc (CHVCM4) ( Mẫu mới)",429800,449000,19200,4
TIKI,nha-cua-doi-song,70316883,"KỆ ĐỂ GIÀY DÉP GỖ THÔNG- Dài 50cm - 2T500",119000,119000,0,0
TIKI,nha-cua-doi-song,114621700,"Kệ để hồ sơ văn phòng tiện lợi, kệ sách để bàn nhỏ gọn gỗ MDF chống ẩm chất lượng cao",126000,171000,45000,26
TIKI,nha-cua-doi-song,59092666,"MÁY KHUẾCH TÁN TINH DẦU CHUYÊN DỤNG | Vân Gỗ Cao Cấp | Có Điều Khiển Từ Xa | Máy Phun Sương Tỏa Hương Tinh Dầu 500ML Cho Phòng Lớn",229000,476000,247000,52
TIKI,nha-cua-doi-song,162360312,"[HÀNG XỊN - CHỌN SIZE] Chiếu điều hòa sợi mây tổng hợp lót vải không dệt cao cấp hàng xuất khẩu 2 mặt giá rẻ 1m2 1m6 1m8 chính hãng",182000,300000,118000,39
TIKI,nha-cua-doi-song,135321411,"Giấy Bạc Tráng Nhôm, dán bếp tăng thẩm mỹ và rất sạch sẽ(2M)",16000,35000,19000,54
TIKI,nha-cua-doi-song,263488472,"Tủ kệ sách để bàn H6689 nhiều màu tiện ích ( Ngẫu nhiên )",48000,58000,10000,17
TIKI,nha-cua-doi-song,64618364,"Day Đèn LED Siêu Sáng 5050 RGB Chống Nước Quấn Cây Trang Trí Ngoài Trời",112000,112000,0,0
TIKI,nha-cua-doi-song,95335291,"Combo 10 cặp kẹp dán tường thông minh - Không cần khoan lỗ, đục tường- Chịu lực lên đến 3Kg",35939,37830,1891,5
TIKI,nha-cua-doi-song,117195930,"Pin Maxell Super Đỏ - Hộp 40 Viên Pin Tiểu AA (2A) 1.5V",105000,105000,0,0
TIKI,nha-cua-doi-song,92441037,"[LOẠI XỊN - CÓ TẶNG BƠM TAY] Bộ 8 Túi Hút Chân Không Đựng Quần Áo, Chăn Màn CỠ ĐẠI Cao Cấp - Hàng chính hãng",198000,198000,0,0
TIKI,nha-sach-tiki,184334565,"Bút vẽ kỹ thuật / Bút vẽ nét/ bút lông kim Fine Pen cơ bản – chuyên nghiệp mực đen",22000,30000,8000,27
TIKI,nha-sach-tiki,191926693,"Trái cây đại chiến Zombie - Thế giới khủng long: Tập 9 - Trên đảo khủng long",58000,89000,31000,35
TIKI,nha-sach-tiki,196394972,"Thương Tiến Tửu - Tập 2",134000,169000,35000,21
TIKI,nha-sach-tiki,160585832,"Veil – Sắc Trắng Yêu Kiều - Tập 3 (Tặng Kèm Postcard)",90000,109000,19000,17
TIKI,nha-sach-tiki,196305158,"Vì Cuộc Đời Không Hẹn Lần Sau",106000,139000,33000,24
TIKI,nha-sach-tiki,176909238,"Hà Nội Còn Một Chút Này",84500,109000,24500,22
TIKI,nha-sach-tiki,71149569,"Cách kiếm lợi nhuận 18.000% từ thị trường chứng khoán - Trade Like An O'Neil Disciple",499000,499000,0,0
TIKI,nha-sach-tiki,273401813,"Tết Ở Làng Địa Ngục",116000,169000,53000,31
TIKI,nha-sach-tiki,76826978,"Sức Mạnh Chữa Lành Của Tinh Dầu",121000,169000,48000,28
TIKI,nha-sach-tiki,189326211,"Văn phòng thám tử quái vật - Tập 08",21100,30000,8900,30
TIKI,nha-sach-tiki,187843292,"Hoa trên mộ Algernon",112000,150000,38000,25
TIKI,nha-sach-tiki,142833447,"Sanctify - Tập 3",89700,109000,19300,18
TIKI,nha-sach-tiki,187827445,"Lược Sử Thời Gian",79000,115000,36000,31
TIKI,nha-sach-tiki,94132196,"Bộ Luật Lao Động Hiện Hành (Mới Nhất) Thông Qua Tại Kỳ Họp Thứ 8 Quốc Hội Khóa XIV",51000,119000,68000,57
TIKI,nha-sach-tiki,195827102,"(Bìa cứng in màu trên giấy cóuche - tặng kèm postcard) SƠN HẢI KINH – Lương Siêu biên soạn – Sam Trạch minh họa – An Lạc Group dịch – Wingbooks - NXB Kim Đồng",325000,325000,0,0
TIKI,nha-sach-tiki,146225297,"Flow - Dòng Chảy",175600,228000,52400,23
TIKI,nha-sach-tiki,980770,"Chí Phèo",31700,48000,16300,34
TIKI,nha-sach-tiki,173481387,"Eo Thon Nhỏ",163000,239000,76000,32
TIKI,nha-sach-tiki,446881,"Các Thế Giới Song Song (Tái Bản 2018)",95500,128000,32500,25
TIKI,nha-sach-tiki,185408437,"Bút Bi Nước Mực Gel Bấm Ngòi 0.5mm Deli - Mực Đen Nhanh Khô, Viết Đều, Trơn Tru, Phù Hợp Văn Phòng Học Sinh - S08-B",6000,11700,5700,49
TIKI,nha-sach-tiki,4077687,"Bài Tập Trắc Nghiệm Tiếng Anh 9 (Có Đáp Án)",37100,56000,18900,34
TIKI,nha-sach-tiki,148008757,"Combo 2 Cuốn "Tim Marshall": "Những Tù Nhân Của Địa Lý" + "Chia Rẽ - Tại Sao Chúng Ta Đang Sống Trong Thời Đại Của Những Bức Tường"",281000,410000,129000,31
TIKI,nha-sach-tiki,147220978,"Sự Tiến Hóa Của Tiền Tệ",111000,139000,28000,20
TIKI,nha-sach-tiki,53563837,"Combo Sách Nuôi Dạy Trẻ: Phương Pháp Giáo Dục Con Của Người Do Thái + Chờ Đến Mẫu Giáo Thì Đã Muộn +90% Trẻ Thông Minh Nhờ Cách Trò Chuyện Đúng Đắn Của Cha Mẹ + Cách Khen, Cách Mắng, Cách Phạt Con + Poster An Toàn(Tủ Sách Người Mẹ Tốt)",251350,251350,0,0
TIKI,nha-sach-tiki,76531748,"Sách DevUP",149000,149000,0,0
TIKI,nha-sach-tiki,158235745,"Phương Pháp Kaizen
 (The Kaizen Way)(Tái Bản)",75500,95000,19500,21
TIKI,nha-sach-tiki,188381614,"Thẻ học Thông minh (Size Lớn - 18 Chủ đề - 288 thẻ) - Song ngữ Anh - Việt - Thế giới Xung quanh",104000,200000,96000,48
TIKI,nha-sach-tiki,3152291,"Hướng Dẫn Giao Dịch Theo Sóng Elliott",369000,369000,0,0
TIKI,nha-sach-tiki,111537689,"Án Mạng Trên Sông Nile (Agatha Christie)(Tái Bản)",78700,135000,56300,42
TIKI,nha-sach-tiki,106365090,"Kinh Dịch Đạo Của Người Quân Tử - Nguyễn Hiến Lê (Tái Bản)",173000,268000,95000,35
TIKI,nha-sach-tiki,167940010,"Thao Túng Tâm Lý",118300,169000,50700,30
TIKI,nha-sach-tiki,112332742,"English Grammar In Use - 130 Bài Ngữ Pháp Tiếng Anh (Tái Bản)",115000,165000,50000,30
TIKI,nha-sach-tiki,185854305,"Full bộ 4 cuốn Truyện - Thơ - Đồng dao - Câu đố cho Trẻ mầm non (Giúp bé sáng dạ, thông minh, tập nói và đọc nhanh)",141999,278429,136430,49
TIKI,nha-sach-tiki,193450565,"Nam Đình Cốc Vi– Tập 7 -  Tặng 1 Postcard Nam Đình Cốc Vi",99200,119000,19800,17
TIKI,nha-sach-tiki,69219919,"Muôn Kiếp Nhân Sinh (Khổ Nhỏ)",73500,98000,24500,25
TIKI,nha-sach-tiki,161383826,"Đảo Mộng Mơ (Tái Bản)",55800,75000,19200,26
TIKI,nha-sach-tiki,17719704,"Hạn Chót Lúc Bình Minh",80000,122000,42000,34
TIKI,nha-sach-tiki,598974,"Dạy Con Làm Giàu 05 - Để Có Sức Mạnh Về Tài Chính",98200,160000,61800,39
TIKI,nha-sach-tiki,126742911,"Món Quà Của Linh Hồn - Sức Mạnh Chữa Lành Của Những Thữ Thách Trong Cuộc Sống",206000,289000,83000,29
TIKI,nha-sach-tiki,170706996,"Điểm Bùng Phát ( Tái Bản)",115800,179000,63200,35
TIKI,nha-cua-doi-song,48967324,"Khóa Vali Khóa Balo Mã Số Chữ Thập",29000,29000,0,0
TIKI,nha-cua-doi-song,67299755,"Giấy nến đục lỗ lót nồi chiên không dầu loại 4 lít, 4.5 lít, 5 lít, 6.5 lít - Size 21cm - 100 tờ - siêu tiện dung",29000,29000,0,0
TIKI,nha-cua-doi-song,164479566,"Ghế chỉnh dáng ngồi đúng - Roichen Hàn Quốc (Made in Korea). Dùng cho Nam, Nữ, Trẻ em. Hàng chính hãng",710000,750000,40000,5
TIKI,nha-cua-doi-song,52238368,"Chiếu điều hòa cao cấp Ánh Sao - Sợi mây tổng hợp + Tặng kèm túi thơm thảo dược - giao mẫu ngẫu nhiên",130000,140000,10000,7
TIKI,nha-cua-doi-song,75659112,"Kệ Sách Tổ Ong IGEA Đa Tầng Convent 234F - GP100",181000,198000,17000,9
TIKI,nha-cua-doi-song,71925401,"Đèn Bàn Học Đọc Sách, Đèn Bàn Làm Việc Sang Trọng, Đèn Ngủ Cao Cấp (Học Sinh, Sinh Viên, Văn Phòng) LED Chống Cận 03 Mức Độ Sáng, Cảm Ứng Tích Điện Pin 2500mAh - Hàng Chính Hãng - VinBuy",123000,260000,137000,53
TIKI,nha-cua-doi-song,169919224,"Kệ Để Kem Đánh Răng & Bàn Chải, Tặng Kèm Cốc - Kệ Nhà Tắm Dán Tường Thông Minh - Giá Treo Bàn Chải Đánh Răng Kiêm Để Đồ & Úp Cốc - Giao Màu Ngẫu Nhiên [HÀNG CHÍNH HÃNG",99000,120000,21000,18
TIKI,nha-cua-doi-song,686906,"Hộp Thủy Tinh Cao Tròn Glasslock MCCD072 (720ml)",144000,194000,50000,26
TIKI,nha-cua-doi-song,51373821,"Đèn bàn học led cảm ứng chính hãng Rạng Đông Model: RD RL 36 LED",203000,203000,0,0
TIKI,nha-cua-doi-song,54460849,"Bộ chăn ga gối cotton LIDACO PL1 - Caro Nâu (SP000661)",195000,276000,81000,29
TIKI,nha-cua-doi-song,58546654,"Đèn Pixar, Đèn Học Chống Cận Thị, Đèn Đọc Sách, Đèn Làm Việc Để Bàn Chống Chói Mắt Lóa Mắt Bảo Vệ Mắt + Bóng Đèn + Chân Kẹp + Chân Đế - Hàng Chính Hãng Amalife",165000,165000,0,0
TIKI,nha-cua-doi-song,52789105,"Đế Bình Giữ Nhiệt Silicone Boot 2GOOD Flask 900ml",50000,50000,0,0
TIKI,nha-cua-doi-song,53497035,"40 VIÊN PIN MAXELL AAA TEM BẠC - HÀNG CHÍNH HÃNG",51400,51400,0,0
TIKI,nha-cua-doi-song,263990262,"Lọ xay tiêu Inox 304 DandiHome cao cấp",56000,65000,9000,14
TIKI,nha-cua-doi-song,171797241,"{XẢ KHO} Cây Lau Nhà Thông Minh, Tự Động Tách Nước Bẩn, Tự Động Vắt Khô, Xoay 360 độ Hatachi  HTC - V6 - HÀNG CHÍNH HÃNG",512050,539000,26950,5
TIKI,nha-cua-doi-song,68413077,"Đèn đọc sách mini, pin sạc tiện dụng Baseus Comfort Reading Mini Clip Lamp ( Dịu mắt, chân kẹp, 3 mức sáng, 350mAh, 24h sử dụng)hàng nhập khẩu",215000,249000,34000,14
TIKI,nha-cua-doi-song,20103667,"Combo Cọ Rửa Dành Cho Ống Hút Inox và Ống Hút Thủy Tinh",28000,28000,0,0
TIKI,nha-cua-doi-song,57335326,"Ghế xếp thư giãn SUMIKA 179A - Khóa kim loại, khung thép tròn, tải trọng 200kg",765000,1000000,235000,24
TIKI,nha-cua-doi-song,163304843,"Máy phun rửa áp lực cao Karcher K2 Classic ",2222700,2390000,167300,7
TIKI,nha-cua-doi-song,152789537,"Combo 5 Đôi Đũa Thủy Tinh Đầu Đũa Vạt Xéo Trang Trí Họa Tiết Nhật Bản Phủ Bóng",70000,70000,0,0
TIKI,nha-cua-doi-song,19867726,"Võng lưới mềm dày 99, gỗ 50 (Giao màu ngẫu nhiên)",208000,350000,142000,41
TIKI,nha-cua-doi-song,135442410,"Máy Đo Khoảng Cách Laser Deli Chính Hãng Loại 40m / 50m / 60m Đa Năng - Dễ Dàng Sử Dụng Từ Xa - DL331050P / EDL4168",488000,896000,408000,46
TIKI,nha-cua-doi-song,241806648,"Móc Dán Tường Treo Chậu Rổ, Treo Đồ Đa Năng Inox 304 Jodily Sử Dụng Miếng Dán Thế Hệ Mới",20000,20000,0,0
TIKI,nha-cua-doi-song,152784110,"Khay Đá Silicon Có Nắp Đậy 14 Viên, Khay Đựng Đá Tủ Lạnh, Làm Đá Thạch Kem Bảo Quản Chống Mùi Tuyệt Đối- Hàng Loại 1",49000,49000,0,0
TIKI,nha-cua-doi-song,47163069,"Túi Đựng Chăn Mền Quần Áo Kháng Mốc Cỡ Lớn Nhiều Màu",58000,58000,0,0
TIKI,nha-cua-doi-song,178101136,"Bơm điện 2 chiều bơm và hút chân không cao cấp miDoctor",97000,180000,83000,46
TIKI,nha-cua-doi-song,55124901,"Thùng Rác Mini Phòng Ngủ, Toilet, Xe Hơi Khả Năng Giữ Mùi 90",100000,100000,0,0
TIKI,nha-cua-doi-song,44803282,"Bàn Làm Việc Có Kệ Sách Mẫu Mới",262500,350000,87500,25
TIKI,nha-cua-doi-song,143002904,"Ổ  điện đa năng shoptida hình tháp nhiều tầng T8/ T12 chịu tải 3600W, an toàn chống cháy chống giật, dây dài 3m và 4m",549000,579000,30000,5
TIKI,nha-cua-doi-song,67650750,"Đệm ngồi lót ghế làm từ hợp chất TPE, thoáng khí, hỗ trợ tuần hoàn máu, chống ê mông, mỏi lưng - Thương hiệu Nhà của Mẹ- giao màu ngẫu nhiên",153000,160000,7000,4
TIKI,nha-cua-doi-song,188375839,"Khăn tắm Khăn lau mặt Cotton 100% Mềm Êm Dày dặn Màu trơn Nhấn viền họa tiết 74x33cm",49000,49000,0,0
TIKI,nha-cua-doi-song,189339895,"Đèn LED Mini Móc Khóa - Đèn Pin COB - Đèn Pin Dã Ngoại - Sạc Type C Tiện Dụng",30400,32000,1600,5
TIKI,nha-cua-doi-song,111410597,"Kính bảo hộ Honeywell A700 Mắt kính chống bụi, chống tia UV, chống trầy xước, đọng sương",77900,82000,4100,5
TIKI,nha-cua-doi-song,117645437,"Ổ cắm điện LiOA đa năng kết hợp - 2D2S, 3D3S, 4D6S dây dài 3m/5m - Ổ cắm điện Lioa Chính Hãng",85000,85000,0,0
TIKI,nha-cua-doi-song,250512089,"Kéo cắt cành cộng lực chuyên dụng Germany -dụng cụ làm vườn đa năng",162000,280000,118000,42
TIKI,nha-cua-doi-song,141201958,"Ly Giữ Nhiệt Cà Phê Có Tay Cầm Nắp Trượt Chống Tràn Rinfere (415ml)",295000,449000,154000,34
TIKI,nha-cua-doi-song,78633940,"Máy Sấy Và Khử Trùng Giày Xiaomi Youpin SOTHING DSHJ-S-1904 có hẹn giờ",259000,269000,10000,4
TIKI,nha-cua-doi-song,41318920,"Bộ chặn cửa chống va đập nam châm hít cửa dán sàn Hobby Home Decor CC1 inox 304 kèm keo dán sàn",82000,139000,57000,41
TIKI,nha-cua-doi-song,16196661,"Bộ Tua Vít Đa Năng Tua Vít 25 Đầu Trong 1 Screwdriver",28044,28044,0,0
TIKI,nha-cua-doi-song,72459016,"Bộ Nhả Kem Đánh Tự Động OENON, Kệ Treo Bàn Chải Nhà Tắmg Dán Tường Kèm Cốc Hút Từ Tính - OEKEM",99000,190000,91000,48
TIKI,nha-sach-tiki,49204092,"Tái Tạo Tổ Chức: Phá Vỡ Rào Cản, Thổi Bùng Sinh Khí (Tái Bản)",122000,190000,68000,36
TIKI,nha-sach-tiki,59618902,"Ehon - Hướng Dẫn Sử Dụng Mẹ (Tái Bản 2020)",40800,59000,18200,31
TIKI,nha-sach-tiki,186578993,"Đu Đưa Trên Ngọn Cây Bàng",91500,118000,26500,22
TIKI,nha-sach-tiki,130863107,"Sách Người Tìm Xác tập 1+2 - Truyện trinh thám, linh dị",298000,378000,80000,21
TIKI,nha-sach-tiki,195662905,"Circe",137000,200000,63000,32
TIKI,nha-sach-tiki,175724125,"Chú Thuật Hồi Chiến Tập 2: Chú Thai Đới Thiên [Tặng Kèm Obi Và Thẻ Bo Góc Nhựa]",29000,30000,1000,3
TIKI,nha-sach-tiki,176906739,"UX Writing - Quyền Năng Tối Thượng Của Nội Dung Tương Tác",61000,99000,38000,38
TIKI,nha-sach-tiki,66398387,"Trời Sinh Vụng Về, Hãy Bù Đắp Bằng Sự Kiên Trì",92400,129000,36600,28
TIKI,nha-sach-tiki,77539095,"Nghệ Thuật Dạy Con Từ Kinh Talmud (20 Câu Chuyện Sâu Sắc Từ Bộ Kinh Cổ Của Người Do Thái)",104000,135000,31000,23
TIKI,nha-sach-tiki,129766803,"Sách Khác Biệt Hay Là Chết (Tái Bản)",89100,128000,38900,30
TIKI,nha-sach-tiki,147988202,"Combo 2 Cuốn Tớ Học Lập Trình: Tớ Học Lập Trình - Làm Quen Với Python + Tớ Học Lập Trình - Làm Quen Với Lập Trình Scratch",167000,210000,43000,20
TIKI,nha-sach-tiki,32490132,"Một Đời Như Kẻ Tìm Đường",113000,175000,62000,35
TIKI,nha-sach-tiki,76737958,"Mind Map English Vocabulary - Từ Vựng Tiếng Anh Qua Sơ Đồ Tư Duy",128700,198000,69300,35
TIKI,nha-sach-tiki,157540009,"Diệt Slime Suốt 300 Năm, Tôi Levelmax Lúc Nào Chẳng Hay (Tập 7)",42000,48000,6000,13
TIKI,nha-sach-tiki,190859600,"Lôi Thần Và Nhân Viên Văn Phòng (Tập 4)",58900,66000,7100,11
TIKI,nha-sach-tiki,176132374,"Truyện Thiếu Nhi Hạt Giống Tâm Hồn - Điều Ước Gửi Các Vì Sao",46000,56000,10000,18
TIKI,nha-sach-tiki,112333133,"Quý Cô Thịnh Vượng - Khi Phụ Nữ Tư Duy Đúng Về Tiền",68900,89000,20100,23
TIKI,nha-sach-tiki,74277389,"Combo 4 Cuốn: Bộ Tuyển Tập Truyện Hay Dành Cho Thiếu Nhi (Tái Bản)",133000,192000,59000,31
TIKI,nha-sach-tiki,125362334,"Dinh Dưỡng Thai Kỳ (Mẹ Bầu Ăn Gì Giúp Con Phát Triển Toàn Diện Và Thông Minh",122000,189000,67000,35
TIKI,nha-sach-tiki,58828012,"Ai Lấy Miếng Pho Mát Của Tôi ? - Phiên Bản Dành Cho Độc Giả Nhí",47100,68000,20900,31
TIKI,nha-sach-tiki,867314,"Tuần Của Bé - Bé Sạch Sẽ",11500,23000,11500,50
TIKI,nha-sach-tiki,188767663,"Quỷ Giá - Bản Thường ( Tặng kèm 1 Bookmark 2 mặt)",124000,159000,35000,22
TIKI,nha-sach-tiki,164336681,"Việt Nam Danh Tác - Bỉ Vỏ",69700,90000,20300,23
TIKI,nha-sach-tiki,151597210,"Practice Test Grade 6",118000,118000,0,0
TIKI,nha-sach-tiki,72027523,"Ehon - Đi Đã Ngoại Ngày Mưa (Tái Bản 2020)",39100,55000,15900,29
TIKI,nha-sach-tiki,194205609,"Ai Đó Chạy Cùng Ta",175000,225000,50000,22
TIKI,nha-sach-tiki,273656715,"Trạm Đọc Official |  Tư Duy Nhanh Và Chậm",201000,269000,68000,25
TIKI,nha-sach-tiki,188535073,"Tối Giản Thông Thái",75700,96000,20300,21
TIKI,nha-sach-tiki,14684952,"Khu Vườn Bí Mật ( Tái Bản 2019 )",71500,96000,24500,26
TIKI,nha-sach-tiki,13673964,"Giây Thứ 12 - Tập 1 (Trinh Thám)",42000,87000,45000,52
TIKI,nha-sach-tiki,55071991,"Combo Trọn Bộ 6 Cuốn Giáo Trình Hán Ngữ",512400,732000,219600,30
TIKI,nha-sach-tiki,8288935,"Của Chuột Và Người",68400,76000,7600,10
TIKI,nha-sach-tiki,190702862,"Siddhartha",79000,120000,41000,34
TIKI,nha-sach-tiki,4040663,"25 Chuyên Đề Ngữ Pháp Tiếng Anh Trọng Tâm – (Tập 1)",71000,110000,39000,35
TIKI,nha-sach-tiki,7804743,"Bí mật - The secret",238000,298000,60000,20
TIKI,nha-sach-tiki,197464901,"Bẩm Thầy Tường Có Thầy Vũ Tới Tìm - Tập 2",97800,115000,17200,15
TIKI,nha-sach-tiki,192913462,"Lớp 7(bộ Kết nối, Cánh diều, Chân trời) - Sách Siêu trọng tâm môn Toán, Anh, KHTN - Nhà sách Ôn luyện",80000,160000,80000,50
TIKI,nha-sach-tiki,58220389,"Mô Hình Biểu Đồ - Phương pháp Hiệu quả để Tìm kiếm Lợi nhuận",368000,368000,0,0
TIKI,nha-sach-tiki,68437861,"Đừng Chết Bởi Canxi",110000,159000,49000,31
TIKI,nha-sach-tiki,186290792,"Bồ Câu Không Đưa Thư (Tái Bản 2022)",27800,38000,10200,27
TIKI,nha-cua-doi-song,184519325,"Bộ quần áo mưa vân tổ ong cao cấp siêu bền",138000,138000,0,0
TIKI,nha-cua-doi-song,14764119,"Ly Giữ Nhiệt Nắp Trượt Chống Tràn Rinfere - Tặng Kèm Ống Hút Không Gỉ, Dụng Cụ Vệ Sinh Ông Hút (590ml)",265000,299000,34000,11
TIKI,nha-cua-doi-song,107961495,"Ly Nhựa 2 Lớp LocknLock 900ml HAP502BEG - Màu",158000,263000,105000,40
TIKI,nha-cua-doi-song,106996271,"Bộ vòi dẫn nước nước rửa chén inox 304 gắn bồn rửa bát dây dài 1.2met",56154,56154,0,0
TIKI,nha-cua-doi-song,68513020,"Combo 3 hộp đựng đồ cao cấp Việt Nam phong cách Nhật (38x25xH25cm) Storage Box",166000,166000,0,0
TIKI,nha-cua-doi-song,50294624,"Lưới Đèn LED Chống Nước Trang Trí Ngoài Trời Cho Giánh Sinh, Tiệc, Lễ Tết - Nhiều kích cỡ",119000,119000,0,0
TIKI,nha-cua-doi-song,133885539,"Tô Giấy Dùng 1 lần KETILO Cao Cấp 250ml, Trắng Trơn, Cứng Cáp, An Toàn và Thân Thiện Môi Trường - HÀNG CHÍNH HÃNG TG100",69900,89000,19100,21
TIKI,nha-cua-doi-song,195980111,"Bình giữ nhiệt LocknLock LHC3275 - 490ML - Hàng chính hãng",294000,490000,196000,40
TIKI,nha-cua-doi-song,5146283,"Ấm đun nước Inox 304 Elmich 3L EL3373 dùng bếp từ",643000,890000,247000,28
TIKI,nha-cua-doi-song,183335921,"Bộ ống hút inox thẳng kèm cọ rửa đảm bảo sức khỏe cho người tiêu dùng",20000,20000,0,0
TIKI,nha-cua-doi-song,272452316,"Bộ Lau Nhà MyJae Đài Loan Sợi Fiber Xoay 360 Độ Thông Minh 125cm",429000,1200000,771000,64
TIKI,nha-cua-doi-song,182432982,"KỆ ĐỂ GIÀY DÉP SAGOKER, mã KED201",141000,159999,18999,12
TIKI,nha-cua-doi-song,195949375,"Đèn bàn học làm việc đọc sách chống cận, pin sạc tích điện led có thể gấp gọn – 03 chế độ ánh sáng bảo vệ mắt - Chính hãng VinBuy",179000,300000,121000,40
TIKI,nha-cua-doi-song,19590366,"Kệ Đa Năng Inochi B4 (45,5 x 26,0 x 44,7 cm)",76000,80000,4000,5
TIKI,nha-cua-doi-song,181909422,"Chảo Sâu Lòng Suit LocknLock CSU1225PIK – 22cm - Màu Pink",331730,677000,345270,51
TIKI,nha-cua-doi-song,157169614,"Thớt Nhựa Kháng Khuẩn 5D Cao Cấp - Chính Hãng ( Giao màu ngẫu nhiên)",29000,58000,29000,50
TIKI,nha-cua-doi-song,20528052,"Bộ 2 Pin Sạc AA 1.2V - 1.450mAh Tích Hợp Cổng Sạc USB Tiện Dụng (Màu ngẫu nhiên)",140000,140000,0,0
TIKI,nha-cua-doi-song,94847014,"Nến thơm trang trí phong cách hoa khô thảo mộc",180000,180000,0,0
TIKI,nha-cua-doi-song,54133235,"Pin Sạc AA 2000mAh NH15 Power Plus RP2 Energizer NH15 RP2 (Mẫu mới)",157000,160000,3000,2
TIKI,nha-cua-doi-song,28937063,"Đồng hồ để bàn báo thức điện tử",81000,120000,39000,33
TIKI,nha-cua-doi-song,66546628,"Giá Treo Rổ Rá, Thau Chậu và Dụng Cụ Bếp Dán Tường Không Khoan Đục Kèm 4 Móc Treo Đồ Tiện Lợi MTC1",58000,99000,41000,41
TIKI,nha-cua-doi-song,96608971,"Móc treo quần áo gấp gọn tiện dụng/Móc du lịch đa năng",7680,9600,1920,20
TIKI,nha-cua-doi-song,125771437,"Khay nướng Bít-tết Phụ kiện nồi chiên không dầu 2GOOD ",380000,380000,0,0
TIKI,nha-cua-doi-song,56383693,"Combo 300 túi lọc rác bồn rửa bát",37999,37999,0,0
TIKI,nha-cua-doi-song,32021492,"Ổ Khóa Số Du Lịch Stanley S742-054",161000,167000,6000,4
TIKI,nha-cua-doi-song,57971649,"Bộ 2 chảo Lock&Lock Easy Frypan 2P Set, Chảo 1 tay cầm 24cm + Chảo lòng sâu 26cm (LEY1243 x 1, LEY1265 x 1) LEY1243S2",308000,593000,285000,48
TIKI,nha-cua-doi-song,77577550,"Bộ Chăn Gối Văn Phòng 3 Trong 1 Kiểu Gấu Nâu Độc Đáo Dùng Để Ngủ Trưa Tại Văn Phòng, Tựa Lưng Và Gấu Bông Dùng Để Trang Trí",249000,279000,30000,11
TIKI,nha-cua-doi-song,12622141,"Cân điện tử mini nhà bếp 5kg",36000,36000,0,0
TIKI,nha-cua-doi-song,15444566,"Kệ đựng xà bông dán tường phòng tắm Hobby Home Decor SBL2 có miếng dán gạch men",70000,89000,19000,21
TIKI,nha-cua-doi-song,115972789,"HỘP ĐỰNG TÚI ĐỰNG QUẦN ÁO KHUNG THÉP 66L- LIVING BOX 66L- Dài 50x Rộng 40x Cao 33.5 cm",85000,85000,0,0
TIKI,nha-cua-doi-song,58469713,"Dây đèn nháy led đom đóm trang trí dùng pin nhiều màu, bóng đèn nháy fairy light cao cấp décor phòng, nhà cửa, tết (Tùy chọn chiều dài dây)",89000,115000,26000,23
TIKI,nha-cua-doi-song,116185291,"Nhiệt ẩm kế cơ học TANAKA TH101E Chính hãng nhật,nhiệt ẩm kế cơ theo công nghệ nhật bản,đồng hồ đo ẩm kế chính xác,nhiệt ẩm kế phòng,nhiệt ẩm kế sử dụng cho trẻ sơ sinh,nhiệt ẩm kế treo tường ",118500,140000,21500,15
TIKI,nha-cua-doi-song,37495650,"Kệ Sách Để Sàn Cao Cấp 11 Tầng Bằng Gỗ MDF Phủ Melamin Chống Nước, Chống Xước - Hàng Chính Hãng",400000,439000,39000,9
TIKI,nha-cua-doi-song,75730188,"Băng keo dán chống thấm nước bồn rửa chén, bếp, nhà vệ sinh [Tặng dây cột tóc hoa mặt trời ngẫu nhiên",40997,40997,0,0
TIKI,nha-cua-doi-song,180997554,"Bộ 12 ly  thủy tinh cao cấp",64991,64991,0,0
TIKI,nha-cua-doi-song,13287995,"Cây gãi lưng chỉnh độ dài có đầu gãi bằng PVC ",18000,18000,0,0
TIKI,nha-cua-doi-song,195469953,"Súng Bắn Keo (Cỡ Lớn/Nhỏ) Kèm 10 Keo Nến Silicon",109000,109000,0,0
TIKI,nha-cua-doi-song,134676914,"Lọ Hũ Thủy Tinh Nắp Cài Kín Hơi Đáy Vuông Nhiều Dung Tích",55000,55000,0,0
TIKI,nha-cua-doi-song,75478111,"Bộ tượng 04 chú tiểu trang trí xe hơi, bàn làm việc, mang lại bình an, hạnh phúc",41400,45000,3600,8
TIKI,nha-cua-doi-song,112946538,"Tấm trải tiện ích Everon Lite (Giao màu ngẫu nhiên)",296000,395000,99000,25
TIKI,nha-cua-doi-song,139815721,"Sào Phơi Giá Rẻ - ko khoen,ko bánh xe,1m",125000,125000,0,0
TIKI,nha-cua-doi-song,15839139,"Đèn pin Laser Laze MV – 303 (Đen) tặng pin sạc và sạc",108000,108000,0,0
TIKI,nha-cua-doi-song,12736380,"Đồng hồ để bàn led báo thức thông minh",178000,178000,0,0
TIKI,nha-cua-doi-song,73640967,"Miếng lau nhà thay thế Bộ lau nhà KITIMOP-C6 PLUS ( 33 x 12cm)",15000,19000,4000,21
TIKI,nha-cua-doi-song,159971094,"Bộ 2 hộp vải đựng đồ 7 ngăn mã HQ2 - Combo 2 hộp vải đựng quần áo chia ngăn gọn gàng tiện lợi chất vải Oxford cao cấp miDoctor",150000,250000,100000,40
TIKI,nha-cua-doi-song,42491736,"Bút thử nước TDS, dụng cụ đo TDS, máy đo độ cứng của nước - Hàng chính hãng",124000,180000,56000,31
TIKI,nha-cua-doi-song,98153708,"Chậu Gội Đầu Tại Giường KUNBE, Chậu Gội Đầu Tại Nhà Thông Minh Cho Mọi Người - Tặng Lược Massage Và Cốc Gội Đầu",209000,209000,0,0
TIKI,nha-cua-doi-song,21582013,"Bộ Bịt Mắt Ngủ 3D Tặng Kèm Bịt Tai Chống Ồn Màu Ngẫu Nhiên",45000,45000,0,0
TIKI,nha-cua-doi-song,181909427,"Nồi 2 Tay Cầm Suit LocknLock CSU1202PIK - Màu Pink",578000,1112000,534000,48
TIKI,nha-cua-doi-song,54682452,"Pin vuông 9V Energizer 522 ALKALINE chính hãng ( Mẫu mới )",57000,60000,3000,5
TIKI,nha-cua-doi-song,117318253,"Nệm xếp đa năng Goodnight 70x180cm, Nệm gấp văn phòng, Nệm xếp 3 thiết kế gọn nhẹ, kèm túi đựng (Giao màu ngẫu nhiên)",466000,570000,104000,18
TIKI,nha-cua-doi-song,80757840,"Combo 3 hộp vải đựng đồ đa năng TD2 – Bộ 3 túi vải Thụy Điển không nắp tiết kiệm sang trọng dung tích 24L mỗi hộp - chính hãng",159000,210000,51000,24
TIKI,nha-cua-doi-song,781987,"Gối Memory Foam 50D Lock & Lock HLW114 (61 x 34 x 10 cm)",475000,791000,316000,40
TIKI,nha-cua-doi-song,83927709,"Bịt Mắt Ngủ Che Mắt Ngủ Có Túi Gel Massage - Giảm Thâm Quầng Mắt - Mẫu Hoạt Hình Mới - Xanh Đen",35000,35000,0,0
TIKI,nha-cua-doi-song,185004372,"Ly Thủy Tinh Phong Cách Bắc Âu Đế Xoay 170ml - Navivu Rock Glass",45000,45000,0,0
TIKI,nha-cua-doi-song,194465292,"Bình giữ nhiệt LocknLock DIY Strap Tumbler LHC3283 350ml",254000,489000,235000,48
TIKI,nha-cua-doi-song,189157824,"Bộ 8 túi hút chân không tặng kèm bơm hút chân không đựng quần áo, chăn màn, ga gối gọn gàng D Danido",189000,199000,10000,5
TIKI,nha-cua-doi-song,12213522,"Ô dù đi mưa gấp gọn hình gấu Brown",44175,44175,0,0
TIKI,nha-cua-doi-song,106338289,"Dép Lỗ Đi Trong Nhà Tắm Chống Trơn Trượt Nhanh Khô, Thoáng Mát, Mẫu Mới Nhất. Dép Cho Cả Gia Đình",95000,155000,60000,39
TIKI,nha-cua-doi-song,149657438,"Tấm Nệm Trải Sàn Gấp Gọn Hàng xuất Nhật",273000,350000,77000,22
TIKI,nha-cua-doi-song,38114299,"Thanh treo rèm cửa inox đa năng, không cần khoan tường hay bắt vít, thay đổi vị trí linh hoạt HT03",60000,60000,0,0
TIKI,nha-cua-doi-song,45170002,"Tấm Chắn Dầu Mỡ Tiện Dụng Cho Bếp Ga - TC29",14000,15478,1478,10
TIKI,nha-cua-doi-song,75411116,"Lót chân ghế, miếng dán chống trầy, chống rung lắc bàn ghế - Hàng chính hãng",23000,25000,2000,8
TIKI,nha-cua-doi-song,7699064,"Chảo Nhôm Sâu Lòng Chống Dính Lock&Lock Baum Marble 1 Tay Cầm, Nắp Thủy Tinh LBU1285 (28cm)",404000,776000,372000,48
TIKI,nha-cua-doi-song,38462026,"Đèn Led Trang Trí Bóng Tròn Dài 3M - 20 Bóng Trang Trí Noel Lễ Tết",43900,43900,0,0
TIKI,nha-cua-doi-song,185647202,"Tranh Cát Chảy Chuyển Động 3D KUNBE Nhiều Mẫu Trang Trí Nhà Cửa Bàn Làm Việc, Giảm Stress",168000,168000,0,0
TIKI,nha-cua-doi-song,75044183,"Đèn Đọc Sách Cao Cấp - Đèn Bàn Làm Việc Sang Trọng - Đèn Ngủ - Đèn Trang Trí - Có Thể Gập Hai Chỗ – 03 Chế Độ Ánh Sáng Vàng Bảo Vệ Mắt Chống Cận Pin Sạc - Hàng Chính Hãng - VinBuy",175000,300000,125000,42
TIKI,nha-cua-doi-song,102508672,"Thùng Đựng Rác Thông Minh E1906, Nắp Đóng Mở Một Chạm Tiện Ích, Chất Liệu Nhựa Cao Cấp Chống Nước, Chịu Nhiệt Tốt, Dung Tích 10 Lít - Hàng Nhập Khẩu",229000,360000,131000,36
TIKI,nha-cua-doi-song,185889866,"[ Mới nhất ] Hashtag Cầm Tay check in đám cưới",28000,28000,0,0
TIKI,nha-cua-doi-song,75354717,"Tủ Quần Áo 2 Buồng 6 Ngăn Tiện Lợi, Tủ Vải 170cm Chất Lượng Cao Chắc Chắn, Vững Chãi - Hàng Chính Hãng miDoctor",240000,295000,55000,19
TIKI,nha-cua-doi-song,105374376,"Bộ Lõi Lọc Khử Mùi Hôi Lỗ Thoát Sàn Cao Cấp MIFAN - Ngăn chặn mùi hôi cống, chống côn trùng lỗ thoát nước nhà tắm, vệ sinh, bồn rửa - Mẫu mới 2021",50000,50000,0,0
TIKI,nha-cua-doi-song,177129235,"Bình giữ nhiệt Thermos nút bấm JNL-752 MTB 750ml màu xanh dương",854000,1090000,236000,22
TIKI,nha-cua-doi-song,74859074,"Chuông Cửa Không Dây Thông Minh CTFAST CT - 01 (1 Nút Bấm, 1 Chuông ), Chống Nước, Khoảng Cách Sử Dụng Hiệu Quả 300 mét - Hàng Chính Hãng",135000,169000,34000,20
TIKI,nha-cua-doi-song,131407862,"ghế văn phòng ghế xoay văn phòng",399000,591000,192000,32
TIKI,nha-cua-doi-song,125658476,"Bình Giữ Nhiệt Kim Cương 1500Ml Inox 304- YOGA QG- Chống Rỉ Set, Nắp Đậy Chặt, Giữ Nhiệt Nóng Lạnh Tốt 6- 8h, Quai Đeo Chắc Chắn, Thiết Kế Sang Trọng, Màu Sắc Thanh Lịch, Tiện Lợi, Pha Lọc Trà, Hàng Chính Hãng",141000,172000,31000,18
TIKI,nha-cua-doi-song,77962744,"Kệ nhà tắm, kệ dán tường đựng đồ nhà tắm, đồ bếp, nhà vệ sinh, siêu chịu lực, (không dán lên tường sơn nước, sơn vôi) - Giao màu ngẫu nhiên",42750,45000,2250,5
TIKI,nha-cua-doi-song,59238383,"Vòi nước đa năng 2 đầu đồng mạ chorme cao cấp mẫu mới 2024 (Hàng chính hãng)",171000,295000,124000,42
TIKI,nha-cua-doi-song,252390050,"Gương dán tường 30x30cm LOẠI MỚI",33000,39000,6000,15
TIKI,nha-cua-doi-song,104681142,"(Chọn Loại) Túi Zip PE Trong Suốt 2 Đường Kéo MyJae, Túi Bọc Đồ Ăn, Rau Củ Bảo Quản Trong Tủ Lạnh",66000,99000,33000,33
TIKI,nha-cua-doi-song,164593190,"Tăm chỉ nha khoa tiệt trùng hộp 50 cây, vệ sinh kẽ răng chân nướu chuyên dụng",4999,4999,0,0
TIKI,nha-sach-tiki,72290296,"Bí Quyết Đầu Tư & Kinh Doanh Chứng Khoán Của Tỷ Phú Warren Buffett Và George Soros (Tái Bản 2020)",110000,158000,48000,30
TIKI,nha-sach-tiki,80920029,"Nguyên lý kế toán TBL9",63000,63000,0,0
TIKI,nha-sach-tiki,71553549,"Đọc Nhanh, Hiểu Sâu, Nhớ Lâu Trọn Đời (Tái Bản 2020)",42000,59000,17000,29
TIKI,nha-sach-tiki,8149335,"Cổ Học Tinh Hoa (Bìa Mềm)",94300,115000,20700,18
TIKI,nha-sach-tiki,170708219,"Đừng Bao Giờ Chia Đôi Lợi Ích Trong Mọi Cuộc Đàm Phán",103820,179000,75180,42
TIKI,nha-sach-tiki,109654814,"Bút bi gel 0.5mm nhiều màu Deli - Có nắp gài - 1 chiếc - Đỏ/ Xanh Dương/ Xanh Lá/ Tím/ Cam - A119",5000,10800,5800,54
TIKI,nha-sach-tiki,71990280,"Nói Chuyện Là Bản Năng, Giữ Miệng Là Tu Dưỡng, Im Lặng Là Trí Tuệ",132300,189000,56700,30
TIKI,nha-sach-tiki,1029908,"Tuần Của Bé - Bé Công Bằng (Dành Cho Trẻ 3 - 6 Tuổi)",17000,23000,6000,26
TIKI,nha-sach-tiki,160585762,"Veil – Sắc Đen Trầm Lặng - Tập 2 - (Tặng Kèm Postcard)",92200,109000,16800,15
TIKI,nha-sach-tiki,174444166,"Cẩm Nang Diện Chẩn – Phương Pháp Đơn Giản Áp Dụng Tại Gia",124000,179000,55000,31
TIKI,nha-sach-tiki,347334,"Có Hai Con Mèo Ngồi Bên Cửa Sổ",70500,100000,29500,30
TIKI,nha-sach-tiki,13673968,"Giây Thứ 12 - Tập 2 (Trinh Thám)",68000,145000,77000,53
TIKI,nha-sach-tiki,195479322,"Tàn Tro",79400,108000,28600,26
TIKI,nha-sach-tiki,16284286,"Tuổi Thơ Dữ Dội - Tập 1 (Tái Bản)",57400,80000,22600,28
TIKI,nha-sach-tiki,34708988,"Bộ 10 Bút Gel Điểm 10 xóa được TP-GELE01",95000,120000,25000,21
TIKI,nha-sach-tiki,40433264,"Combo Bí Ẩn Mãi Mãi Là Bí Ẩn( Trọn bộ 6 cuốn)( tặng kèm sổ Tay Xương Rồng)",261000,290000,29000,10
TIKI,nha-sach-tiki,155351487,"IELTS 16 ACADEMIC",195000,195000,0,0
TIKI,nha-sach-tiki,107492789,"Keo dán x2000 siêu dính, keo dán đa năng dán tất cả vật liệu bằng gỗ, thủy tinh, dán nhựa an toàn với da tay (Dạng nước)",21996,21996,0,0
TIKI,nha-sach-tiki,181928999,"Yuri Espoir (Tập 1) - Bản Thường Tặng Kèm Postcard",57300,79000,21700,27
TIKI,nha-sach-tiki,187889757,"Gọt bút chì mini Deli - Màu ngẫu nhiên - E0594",2500,5400,2900,54
TIKI,nha-sach-tiki,150711999,"Michelle Obama - Chất Michelle (Bìa Cứng) (Tái Bản)",372000,520000,148000,28
TIKI,nha-sach-tiki,8011021,"Tâm Lý Học Thành Công (Tái Bản)",149000,199000,50000,25
TIKI,nha-sach-tiki,83162438,"Combo Kinh Tế Vi Mô và Câu Hỏi - Bài Tập - Trắc Nghiệm Kinh Tế Vi Mô",171000,180000,9000,5
TIKI,nha-sach-tiki,165038798,"OKRs - Tối Ưu Hóa Hiệu Suất Của Bất Kỳ Đội Nhóm Nào",110000,169000,59000,35
TIKI,nha-sach-tiki,175956866,"Giới Hạn Của Bạn Chỉ Là Xuất Phát Điểm Của Tôi (Tái Bản)",62700,89000,26300,30
TIKI,nha-sach-tiki,175833959,"Combo 5-10-20 Bút Bi Bấm Deli EQ24 Ngòi 0.7mm - Mực Xanh/Đen/Đỏ - Bút bi dầu phù hợp học sinh văn phòng",8500,17100,8600,50
TIKI,nha-sach-tiki,77403145,"The Story Of Food - Câu Chuyện Thực Phẩm",483000,486000,3000,1
TIKI,nha-sach-tiki,21031780,"Pháo Đài Số ( Tái Bản )",128500,199000,70500,35
TIKI,nha-sach-tiki,100958464,"Hỏi Đáp Từ Trái Tim (Tái Bản)",102000,149000,47000,32
TIKI,nha-sach-tiki,109982979,"Isaac Newton - Nhà Khoa Học Vĩ Đại",28000,40000,12000,30
TIKI,nha-sach-tiki,111537682,"Bách Khoa Cho Trẻ Em - Bách Khoa Động Vật (Tái Bản)",131000,180000,49000,27
TIKI,nha-sach-tiki,40750124,"Không Gia Đình (Phiên Bản Mới) - Tặng kèm bộ Postcard",119250,159000,39750,25
TIKI,nha-sach-tiki,46240920,"Kỹ Năng Quản Lý Tài Chính Cá Nhân Trong 30 Ngày",82800,119000,36200,30
TIKI,nha-sach-tiki,73684906,"Marketing Phải Bán Được Hàng",110000,159000,49000,31
TIKI,nha-sach-tiki,195969658,"Tiệm Sách Cũ Biblia - Ngoại Truyện 2 - Tobirako Và Thời Gian Bỏ Ngỏ",51000,95000,44000,46
TIKI,nha-sach-tiki,170434495,"Hộp Quà Bí Mật Dành Tặng Bé Yêu",19000,19000,0,0
TIKI,nha-sach-tiki,17530147,"Series Địch Công Kỳ Án Tập 14 - Hầu Tử Và Lão Hổ ( Tái Bản )",44000,88000,44000,50
TIKI,nha-sach-tiki,74616448,"Lập Kế Hoạch Kinh Doanh Cho Người Mới Bắt Đầu",69020,119000,49980,42
TIKI,nha-sach-tiki,58462050,"Sách Người Trong Muôn Nghề: Ngành IT có gì?",155000,169000,14000,8
TIKI,nha-sach-tiki,168181452,"Thiên Sứ Nhà Bên - Tập 2",83600,95000,11400,12
TIKI,nha-cua-doi-song,21459762,"PHÂN TRÙN QUẾ HỮU CƠ DÙNG CHO RAU SẠCH VÀ HOA KIỂNG - 2 KG",15900,15900,0,0
TIKI,nha-cua-doi-song,32014487,"Chăn Nỉ Văn Phòng Cao Cấp (160cm * 120cm)",129000,179000,50000,28
TIKI,nha-cua-doi-song,176309828,"Túi thực phẩm Inochi - shinsen 25 x 35cm",35000,35000,0,0
TIKI,nha-cua-doi-song,7202377,"Bộ 3 Lõi Lọc Nước Máy Tiêu Chuẩn Barrier",504000,660000,156000,24
TIKI,nha-cua-doi-song,87966539,"Sọt rác lưới tròn 26x23x18.5cm - Màu Ngẫu Nhiên",76000,120000,44000,37
TIKI,nha-cua-doi-song,167041804,"Ly rock thủy tinh pha lê đế xoay 360 độ, cốc uống whisky rượu tây 160ml wine glass",35000,35000,0,0
TIKI,nha-cua-doi-song,87982701,"Pin Nút Áo CR2032 BR2032 DL2032 ECR2032 Lithium 3V CR 2032 220mAh (5 Viên) Pin Cho Đồng Hồ Điện Tử/ Đồ Chơi Điều Khiển Từ Xa/ Đèn Xe Đạp",26000,39000,13000,33
TIKI,nha-cua-doi-song,72829989,"Lá diệp phật - Ngọc Quý Gemstones",39000,39000,0,0
TIKI,nha-cua-doi-song,118451214,"Ổ cắm điện LiOA đa năng - Ổ on/off 4 lỗ, 6 lỗ mỗi ổ 1 công tắc dây dài 3m",139000,139000,0,0
TIKI,nha-cua-doi-song,27986931,"Kệ Sách Để Bàn Tiện Ích - Vân gỗ",68000,99000,31000,31
TIKI,nha-cua-doi-song,29339320,"Công tắc điều khiển từ xa Honest HT-6220KGD công suất lớn 220v 40A 1000m dùng cho máy bơm ,moto điện..",159000,159000,0,0
TIKI,nha-cua-doi-song,73314056,"Lọ xay tiêu cầm tay nắp viền inox 304 lọ thủy tinh Hobby Home Decor XT mẫu thon cao và mẫu thấp tùy chọn",54000,99000,45000,45
TIKI,nha-cua-doi-song,21389285,"Vỉ 20 viên pin cmoss CR2032",36190,36190,0,0
TIKI,nha-cua-doi-song,137176118,"100gram Túi Zip trong suốt đáy đứng- túi đựng thực phẩm khô, nước - size",38000,40000,2000,5
TIKI,nha-cua-doi-song,42759652,"Chốt cửa dây xích an toàn inox 304 gắn cửa HOBBY Home Decor KLC1 bảo vệ phòng cho chung cư phòng ngủ không rỉ sét",82000,129000,47000,36
TIKI,nha-cua-doi-song,181223364,"Bộ vòi xịt vệ sinh toilet kèm giá treo và dây lò xo co giãn HOBBY Home Decor VSR2 inox 304 ren chờ 21mm",144000,229000,85000,37
TIKI,nha-cua-doi-song,171022457,"Dầu bôi trơn thiết bị gia dụng đa năng dùng trong gia đình - Dầu bôi trơn động cơ, chống rỉ bánh răng cơ khí",24000,24000,0,0
TIKI,nha-cua-doi-song,73230427,"Chill Party-Đèn Chiếu Ngàn Sao 6 phong cách kiêm đèn ngủ xoay tự động, tích hợp phát nhạc bằng Bluetooth nhiều màu sắc tuyệt đẹp, sạc lại bằng USB",380000,380000,0,0
TIKI,nha-cua-doi-song,55427978,"Combo 100 Túi Lọc Rác cho bồn rửa chén bát ",15780,15780,0,0
TIKI,nha-cua-doi-song,88914388,"Bộ 04 chân đế cao su chống rung máy giặt - HT SYS - Đế chống rung máy giặt - Đế chống ồn máy giặt, máy sấy,tủ lạnh, bàn ghế + Sét 3 móc dính dán tường vàng tài lộc HT SYS",139000,139000,0,0
TIKI,nha-cua-doi-song,20104505,"Hộp 3 ống hút inox và cọ rửa",43000,43000,0,0
TIKI,nha-cua-doi-song,73464817,"Kệ gia vị dán tường dài 30/40/50cm sơn đen tĩnh điện Vando chính hãng - kèm keo chuyên dụng kệ treo tường bằng thép carbon không gỉ, siêu chịu lực 30kg",119000,141000,22000,16
TIKI,nha-cua-doi-song,201687096,"[TikiNow giao hàng] Ghế chỉnh dáng ngồi đúng Roichen - Hàn Quốc. Sản phẩm dành cho Nữ , Sản phẩm nhập khẩu Hàn Quốc (Made in Korea). Hàng chính hãng Roichen",785000,898000,113000,13
TIKI,nha-cua-doi-song,138380998,"Gói 20 Chiếc Khăn Cotton Nén Sử Dụng Một Lần Tiện Dụng Cho Du Lịch Khổ 20x24cm Khăn Uớt Viên Kẹo",17000,35000,18000,51
TIKI,nha-cua-doi-song,657076,"Màng Bọc Thực Phẩm PE Ringo 150 (30cm x 150m)",103000,103000,0,0
TIKI,nha-cua-doi-song,59425995,"Bộ Ga Gối Cotton Tici Kẻ LIDACO Cao Cấp - Kẻ Cam Ghi",159000,229000,70000,31
TIKI,nha-cua-doi-song,68391419,"ĐẦU VÒI RỬA CHÉN LỌC NƯỚC TĂNG ÁP 360 ĐỘ - giao màu ngẫu nhiên",7850,7850,0,0
TIKI,nha-cua-doi-song,186094219,"Khăn Tắm Nén Bằng Cotton Tiện Lợi Dùng Một Lần 70*140 cm - Khăn Nén Du Lịch - Khăn Nén Spa",13000,14111,1111,8
TIKI,nha-cua-doi-song,81936258,"Hộp đựng quần áo gấp gọn có nắp Màu kem Morning House  - SIZE S",50000,50000,0,0
TIKI,nha-cua-doi-song,174262175,"Bát Sen Tắm Của Vòi Tắm Hoa Sen Nóng Lạnh Pimisi Với Tay Sen Bằng Nhựa Cao Cấp Mạ Xi Cr/Ni Màu Inox Sáng Bóng Kiểu Vuông Bo Tròn Góc - Ổn Định Nhiệt Độ Nước Nóng Lạnh Theo Công Nghệ Đầu Phun Tăng Áp Dạng Phun Mưa Tiết Kiệm Nước | Hàng Chính Hãng",124000,200000,76000,38
TIKI,nha-cua-doi-song,191918107,"Bình lắc LocknLock Balance Shake It Bottle HAP949BLK 800ml - Màu",139000,267000,128000,48
TIKI,nha-cua-doi-song,134360720,"Bộ 8 Pin AAA ( R03NT/2S ) Panasonic 1,5V Không Chì - Hàng Chính Hãng",40000,45000,5000,11
TIKI,nha-cua-doi-song,169696716,"Bình Đựng Nước 2L Dễ Thương Kèm Ống Hút , Có Vạch Báo Giờ Uống Nước - Hàng Loại 1 Chính Hãng",124000,218000,94000,43
TIKI,nha-cua-doi-song,164848242,"Chậu gội đầu tại giường cho người già, trẻ nhỏ, người bệnh... màu sắc giao ngẫu nhiên- Hàng chính hãng",124000,130000,6000,5
TIKI,nha-cua-doi-song,90530495,"Đèn Pixar, Đèn Bàn Học Chống Cận Thị, Đèn Đọc Sách, Đèn Làm Việc Bảo Vệ Mắt - Hàng Chính Hãng Moontronics MT01",255000,310000,55000,18
TIKI,nha-cua-doi-song,205819517," Bóng đèn Led thông minh Xiaomi Yeelight Bulb W3 đui xoắn E27 (RGB 16 triệu màu) - tích hợp Razer Chroma",261000,350000,89000,25
TIKI,nha-cua-doi-song,55465365,"Pin Max 8 + 4 Viên Energizer E92 BP8+4 AAA - Hàng Chính Hãng Model 2020",138000,145000,7000,5
TIKI,nha-cua-doi-song,78904788,"Gối Lót Ngồi Y Tế Hình Chữ O Bằng Cao Su Non Phòng Bệnh Trĩ Giảm Đau Xương Cụt",205000,205000,0,0
TIKI,nha-cua-doi-song,46327991,"Hộp Nhựa Đựng Thực Phẩm Trong Suốt GAGI Mã GH01 Nhựa PP Bền Bỉ, Sử Dụng Cho Cả Lò Vi Sóng Không Bám Mùi Dễ Dàng Vệ Sinh - Hàng Chính Hãng",44000,69000,25000,36
TIKI,nha-cua-doi-song,21418511,"Hộp đựng bông tẩy trang và tăm bông 2 ngăn mica cao cấp 14.5 x 10.5 x 13 cm",85000,85000,0,0
TIKI,nha-sach-tiki,193684715,"Ngoan Cường Vượt Định Kiến",56100,79000,22900,29
TIKI,nha-sach-tiki,135552451,"Các Triều Đại Việt Nam",78000,120000,42000,35
TIKI,nha-sach-tiki,332626,"Oxford Learner's Pocket Dictionary : A Pocket-sized Reference to English Vocabulary (Fourth Edition)",76260,85000,8740,10
TIKI,nha-sach-tiki,259537049,"Hộp 10 Bút Lông Bảng Thiên Long WB-03",73000,93000,20000,22
TIKI,nha-sach-tiki,197629358,"Chúng Ta Có Hẹn Với Bình Yên",71000,89000,18000,20
TIKI,nha-sach-tiki,169603497,"Macmillan Dictionary Vietnam ED with App – Soft cover",399000,399000,0,0
TIKI,nha-sach-tiki,101297001,"Tâm Lý Hành Vi Trong Đầu Tư Chứng Khoán",110700,159000,48300,30
TIKI,nha-sach-tiki,148761075,"Combo 6 Cuốn: "Hít Hà Mùi Đất Nước"",207000,240000,33000,14
TIKI,nha-sach-tiki,189598539,"Bài tập bổ trợ Tiếng Anh 10",118000,118000,0,0
TIKI,nha-sach-tiki,191148968,"Bút Hết Nặng Viết Hết Đau",185000,239000,54000,23
TIKI,nha-sach-tiki,76305752,"Combo Bộ 2 Cuốn: Giết Chỉ Huy Đội Kỵ Sĩ (Tập 1: Ý Tưởng Xuất Hiện + Tập 2: Ẩn Dụ Dịch Chuyển)",326000,410000,84000,20
TIKI,nha-sach-tiki,10581200,"Dế Mèn Phiêu Lưu Ký (Tái Bản)",38000,50000,12000,24
TIKI,nha-sach-tiki,191926650,"Trái cây đại chiến Zombie - Thế giới khủng long: Tập 11 - Thợ săn đáy biển",58000,89000,31000,35
TIKI,nha-sach-tiki,193988316,"Siêu Tâm Trí – Học Cách Suy Nghĩ Như Sherlock Holmes",98500,145000,46500,32
TIKI,nha-sach-tiki,150682463,"Linh Ứng - Hành Trình Của Kẻ Siêu Vô Thần Đến Thế Giới Tâm Linh",187000,268000,81000,30
TIKI,nha-sach-tiki,46107068,"Thế Giới Ảo, Thương Hiệu Thật",86420,149000,62580,42
TIKI,nha-sach-tiki,5974545,"Series Địch Công Kỳ Án Tập 11: Bóng Ma Trong Chùa",53000,110000,57000,52
TIKI,nha-sach-tiki,147988196,"Combo 3 Cuốn "Hiểu Hết": How Food Works - Hiểu Hết Về Thức Ăn + How The Body Works - Hiểu Hết Về Cơ Thể + How Psychology Works - Hiểu Hết Về Tâm Lý Học",759000,900000,141000,16
TIKI,nha-sach-tiki,74983567,"Tứ Trấn Huyền Linh",158000,259000,101000,39
TIKI,nha-sach-tiki,173092689,"Phát triển trí tuệ (140 câu đố) - Bộ sách Rèn luyện Trí thông minh - Dành cho trẻ 5-6 tuổi",23538,46152,22614,49
TIKI,nha-sach-tiki,164323204,"Semantic Error - Lỗi Logic - Tập 1 - Tặng Kèm Bookmark + 01 Postcard",233100,259000,25900,10
TIKI,nha-sach-tiki,188128043,"Kingdom - Tập 29",45000,45000,0,0
TIKI,nha-sach-tiki,176909246,"Bí Quyết Bấm Huyệt Chữa Bệnh",124000,178000,54000,30
TIKI,nha-sach-tiki,87941401,"Lối Tắt Khởi Nghiệp - Con Đường Ngắn Từ Tay Trắng Đến Thành Công Bền Vững",125000,169000,44000,26
TIKI,nha-sach-tiki,193100617,"Anh Hùng Diệt Thần & Bảy Thệ Ước (Tập 2)",134000,149000,15000,10
TIKI,nha-sach-tiki,99681443,"Khoa Học - Khái Lược Những Tư Tưởng Lớn ",327000,450000,123000,27
TIKI,nha-sach-tiki,187190670,"Black Jack - Tập 11 (Bìa Cứng)",127000,135000,8000,6
TIKI,nha-sach-tiki,68456844,"Bài Tập Tiếng Anh 8 - Tập 1 - Có Đáp Án (Theo Chương Trình Mới Của Bộ GD&ĐT)",37900,48000,10100,21
TIKI,nha-sach-tiki,51660434,"Những Bí Quyết Vàng Đầu Tư Bất Động Sản",89000,89000,0,0
TIKI,nha-sach-tiki,184781428,"Nuôi Con Bằng Yêu Thương Dạy Con Bằng Lý Trí (Tái bản) - Tặng Kèm Bookmark",85000,114000,29000,25
TIKI,nha-sach-tiki,166033485,"Sách 14 Nguyên Tắc Tăng Trưởng Thần Tốc Như Amazon",125000,188000,63000,34
TIKI,nha-sach-tiki,194130753,"Bong bóng số 0-9 nhiều màu 35cm trang trí tiệc xinh",18000,18000,0,0
TIKI,nha-sach-tiki,146936894,"Combo 4 cuốn Sách tự xóa: Chữ cái - Toán - Chữ số - Hình khối & Màu sắc (tặng kèm bút)",79528,152939,73411,48
TIKI,nha-sach-tiki,42180465,"Đừng Chỉ Đẹp Mà Không Hiểu Chuyện",61800,89000,27200,31
TIKI,nha-sach-tiki,714012,"Truyện Ngụ Ngôn La Fontaine",58800,98000,39200,40
TIKI,nha-sach-tiki,152517438,"Dữ Liệu Bạch Kim (Văn Học Trinh Thám)",127200,159000,31800,20
TIKI,nha-sach-tiki,95090180," Bút dấu dòng dạ quang Deli – 6 chiếc/ hộp - S624",52200,52200,0,0
TIKI,nha-sach-tiki,69162885,"Influencer - Phương Pháp 5 Bước Để Trở Thành Người Có Tầm Ảnh Hưởng Nhất Trong Lĩnh Vực Của Bạn",88100,129000,40900,32
TIKI,nha-sach-tiki,101897983,"Không Tức Giận Bạn Đã Thắng",107000,149000,42000,28
TIKI,nha-sach-tiki,136753126,"Tôi Đã Kiếm 1 Triệu Đô Đầu Tiên Trên Internet Như Thế Nào Và Bạn Cũng Có Thể Làm Như Thế (Tái Bản)",115420,199000,83580,42
TIKI,nha-cua-doi-song,58206715,"Bản lề tự đóng cửa tự động cho cửa hàng, văn phòng, nhà ở",38900,38900,0,0
TIKI,nha-cua-doi-song,31895999,"Đầu Vòi Lọc Sạch Nước Than Hoạt Tính",19400,19400,0,0
TIKI,nha-cua-doi-song,185654331,"Hộp, Lọ, Hũ Thủy Tinh Nắp Gỗ JIMMEAL 200ml 350ml 500ml 750ml 1000ml 1200ml 1600ml",32000,32000,0,0
TIKI,nha-cua-doi-song,67416013,"CỐC GIỮ NHIỆT ELMICH INOX 304 470ML EL3668",254000,399000,145000,36
TIKI,nha-cua-doi-song,800795,"Bình đựng thức ăn giữ nhiệt 1800ml EL3128",699000,1390000,691000,50
TIKI,nha-cua-doi-song,121367420,"Gối ngồi lót mông y tế chống trĩ, đau xương cụt, ê mỏi mông cho dân văn phòng, lái xe, thu ngân, sinh viên...Chính hãng Ema - Hàng nhập khẩu",550000,550000,0,0
TIKI,nha-cua-doi-song,3677753,"Bình Lọc Nước BRITA Flow Basic Blue - 8.2L (Kèm Maxtra Plus) - Hàng Chính Hãng",2499000,2499000,0,0
TIKI,nha-cua-doi-song,142261128,"Đệm Lót Ghế Ngồi NOOZ Home Goods Gối Lót Ghế Ngồi Bệt Memory Foam Giúp Chống Đau Lưng, Đau Xương Cụt, Đau Thần Kinh Tọa Ruột Đệm Cao Su Non Danh Cho Dân Văn Phòng",339000,450000,111000,25
TIKI,nha-cua-doi-song,11341623,"Hộp 40 viên pin 2A Maxell",122000,130000,8000,6
TIKI,nha-cua-doi-song,127693039,"[Thùng 1, 5, 10, 18 Lít] Keo Sơn Chống Thấm Sàn Mái Lộ Thiên TAIKO NITTON (Gốc Acrylic) - Tặng Kèm Vải Kết Cấu Và Chổi Lăn Sơn - Chống Thấm Sàn Mái, Máng Xối, Ban Công Lô Gia, Bể Nước, Bể Cá, Bề Mặt Cát Xi Măng (Hiệu quả hơn khi pha với Xi Măng",249600,320000,70400,22
TIKI,nha-cua-doi-song,106281034,"Bình nước thủy tinh Luminarc Quadro 1.7L -LUQUG2668",154000,205000,51000,25
TIKI,nha-cua-doi-song,167030045,"Áo Nệm, Ga bọc Nệm Toppper 2 Mặt Có Khóa Kéo, Kich Thước 1mx2m,1m2x2m, 1m4x2m, 1m6x2m, 1m8x2m",145000,145000,0,0
TIKI,nha-cua-doi-song,84953200,"Kệ đựng dụng cụ rửa chén dán tường Hobby Home Decor KRC6 inox 304 có miếng dán",173000,279000,106000,38
TIKI,nha-cua-doi-song,173717336,"Túi Hộp Vải Lưới Đựng Đồ Lót, Tất Vớ Nhiều Ngăn - Khay Xếp Chia Ô Đựng Đồ Để Tủ Quần Áo Tiện Ích",24000,24000,0,0
TIKI,nha-cua-doi-song,155546820,"Hộp nhựa đựng thực phẩm tủ lạnh 2 lớp Homepower ghi chú thời gian bảo quản thông minh kèm rổ thoát nước tiện lợi - Cao cấp",89000,89000,0,0
TIKI,nha-cua-doi-song,105026602,"Chuông báo động, còi báo động dành cho người lớn tuổi, người bệnh ",249000,249000,0,0
TIKI,nha-cua-doi-song,52297710,"Bộ 25 Móc dán tường, dính tường trong suốt Siêu chắc, siêu chịu lực loại 10kg",11968,11968,0,0
TIKI,nha-cua-doi-song,149242704,"Combo 20 Móc treo ảnh gắn tường, móc treo ảnh cưới ôm sát tường decor rất đẹp, không cần khoan đục - Hàng chính hãng",33250,35000,1750,5
TIKI,nha-cua-doi-song,181909425,"Nồi 1 Tay Cầm Suit LocknLock CSU1181PIK (18cm) - Màu Pink",491000,945000,454000,48
TIKI,nha-cua-doi-song,198508670,"Đèn LED Mini Móc Khóa - Đèn Pin COB - Đèn Pin Dã Ngoại - Sạc USB Tiện Dụng- Kiêm hộp quẹt",48510,49000,490,1
TIKI,nha-cua-doi-song,74615464,"Phin pha cà phê nhôm Trung Nguyên( Không Hoa Văn)",30000,30000,0,0
TIKI,nha-cua-doi-song,7699062,"Chảo Nhôm Chống Dính Lock&Lock Baum Marble 1 Tay Cầm LBU1283C (28cm)",295000,567000,272000,48
TIKI,nha-cua-doi-song,38666598,"Túi Đựng Ly Giữ Nhiệt Lớn 900ml Nhiều Mẫu",40000,40000,0,0
TIKI,nha-cua-doi-song,160909295,"0,5KG - 1KG TÚI ZIP LỤA MỜ và TRONG Túi Zip lock LỤA MỜ có khoá kéo, túi zip đựng quần áo, khoá chắc chắn",65000,65000,0,0
TIKI,nha-cua-doi-song,187622257,"Bộ 3 Kệ Trang Trí Treo Góc Tường SIB DECOR Hình Cung Tròn",149000,149000,0,0
TIKI,nha-cua-doi-song,13619778,"Đồng Hồ Treo Tường P1 (25cm) - Màu ngẫu nhiên",99000,99000,0,0
TIKI,nha-cua-doi-song,141971329,"Túi Đựng Hộp Cơm Grepaco Giữ Nhiệt Nóng Lạnh Dạng Đứng Có Ngăn Phụ Đựng Đồ Thức Ăn Văn Phòng, Du Lịch – Vải Bố Canvas, Kích Thước Size Vừa, Kiểu Giỏ Xách Thời Trang Nam Nữ - Tặng Túi Đựng Muỗng Nĩa - Hàng Chính Hãng",69000,69000,0,0
TIKI,nha-cua-doi-song,51406882,"Bộ 10 miếng xốp dán tường giả gạch 3D 70x77cm",105600,132000,26400,20
TIKI,nha-cua-doi-song,53185365,"Túi Ly Giữ Nhiệt Rinfere - Sản Phẩm Handmade Phù Hợp Với Ly Giữ Nhiệt Rinfere, Lock and Lock, Yeti - Free Size",104000,104000,0,0
TIKI,nha-cua-doi-song,113899477,"Đèn học để bàn, đèn đọc sách LED tích điện di động Homepower gập 2 chỗ - 3 chế độ ánh sáng vàng bảo vệ mắt, chống cận Pin 2500mAh",179000,179000,0,0
TIKI,nha-cua-doi-song,91546481,"️ Kệ nhà bếp gấp gọn đa năng TI-KE001 - Tháo ra dùng ngay được",401000,433900,32900,8
TIKI,nha-cua-doi-song,149959628,"Cmbo 6 Cuộn Túi Đựng Rác Gia Đình, Bao Đựng Rác Văn Phòng, Trường Học Tiện Lợi Màu Đen Đầy Đủ 3 Size Tiểu Trung Đại - Chính Hãng MINIIN",45000,45000,0,0
TIKI,nha-cua-doi-song,403497,"Đèn Diệt Côn Trùng Well DS-D6",625000,786000,161000,20
TIKI,nha-cua-doi-song,116244976,"Túi Đựng Hộp Cơm Grepaco Giữ Nhiệt Nóng Lạnh Đựng Đồ Thức Ăn Văn Phòng, Du Lịch – Vải Bố Canvas, Kích Thước To (Cỡ Lớn), Kiểu Dáng Giỏ Xách Thời Trang Nam Nữ - Tặng Túi Đựng Muỗng Nĩa",149000,149000,0,0
TIKI,nha-cua-doi-song,274121804,"Ruột Gối Ôm Lông Vũ Thuần Việt - Sợi Lông Vũ Nhân Tạo Microfiber Êm Ái Mềm Mịn - KT 20x100cm",340000,550000,210000,38
TIKI,nha-cua-doi-song,162406191,"Giấy lau mặt dùng 1 lần khăn mặt cotton khô cuộn giấy tẩy trang lau khô/lau ướt",14900,28500,13600,48
TIKI,nha-cua-doi-song,11710987,"Combo 10 cuộn keo lụa vặn ren vòi nước, ren ống cao cấp (Cao su non, băng tan) ",33000,38000,5000,13
TIKI,nha-cua-doi-song,198214329,"Combo 2 bộ chuyển đổi 3 chấu thành 2 chấu phích tròn Barwell - Chính hãng, giao màu ngẫu nhiên",32200,35000,2800,8
TIKI,nha-cua-doi-song,140746932,"Bàn Gấp Treo Tường Đầy Đủ Phụ Kiện và Hướng Dẫn Đi Kèm",165000,165000,0,0
TIKI,nha-cua-doi-song,79971957,"Bộ Chăn Gối Văn Phòng 3 IN 1 Hình Thú Mặc Áo Hà Mã, Bò Vàng Siêu Tiện Lợi- Bò áo xám",219000,219000,0,0
TIKI,nha-sach-tiki,191353862,"Green Witchcraft - Năng lượng từ thảo mộc",104300,149000,44700,30
TIKI,nha-sach-tiki,112588572,"Yêu Trong Tỉnh Thức - Từ Bạn Đời Đến Bạn Đạo Tập 1",185000,185000,0,0
TIKI,nha-sach-tiki,73222804,"Sách Putin Logic Của Quyền Lực (Tái Bản 2020)",117000,168000,51000,30
TIKI,nha-sach-tiki,172800656,"Komi - Nữ Thần Sợ Giao Tiếp Tập 8 [Tặng kèm Card bo góc Nữ thần]",25000,25000,0,0
TIKI,nha-sach-tiki,870619,"Túp Lều Bác Tom",71000,110000,39000,35
TIKI,nha-sach-tiki,190592917,"Combo 2 Quyển: Thiên Tài Bên Trái, Kẻ Điên Bên Phải + Tâm Lý Học Tội Phạm: Phác Họa Chân Dung Kẻ Phạm Tội",223000,324000,101000,31
TIKI,nha-sach-tiki,520337,"Luật Im Lặng (Mario Puzo)",63000,95000,32000,34
TIKI,nha-sach-tiki,91120169,"Homecoming - Hồi Sinh Đứa Trẻ Bên Trong Bạn",117000,169000,52000,31
TIKI,nha-sach-tiki,109982956,"Leonardo Da Vinci - Thiên Tài Toàn Năng",40000,60000,20000,33
TIKI,nha-sach-tiki,191148787,"Green Witchcraft - Năng lượng từ thảo mộc",103700,149000,45300,30
TIKI,nha-sach-tiki,109982972,"Marie Curie - Nhà Nữ Khoa Học Kiệt Xuất",58500,75000,16500,22
TIKI,nha-sach-tiki,11413619,"Combo Mẹ Hỏi Bé Trả Lời (4 Cuốn)",95000,120000,25000,21
TIKI,nha-sach-tiki,194959697,"Thánh Hiệp Sĩ Nơi Tận Cùng Thế Giới – Tập 1",116000,145000,29000,20
TIKI,nha-sach-tiki,195801643,"Cà Phê Cùng Tony (Tái Bản 2022)",72000,105000,33000,31
TIKI,nha-sach-tiki,130997089,"[Manga] Diệt Slime Suốt 300 Năm, Tôi Levelmax Lúc Nào Chẳng Hay (Tập 6)",47100,48000,900,2
TIKI,nha-sach-tiki,91774356,"Fullmetal Alchemist - Cang Giả Kim Thuật Sư - Fullmetal Edition Tập 8",65500,69000,3500,5
TIKI,nha-sach-tiki,73553840,"Truyện Thiếu Nhi Hạt Giống Tâm Hồn - Thế Giới Trong Ngăn Tủ (Tái Bản 2020)",35000,40000,5000,13
TIKI,nha-sach-tiki,191373346,"[QUÀ TẶNG ĐỘC QUYỀN]  Ví da y tế cao cấp đa năng, đựng thuốc, đựng máy đo đường huyết, nhiệt kế, điện thoại, ví tiền, bền đẹp và tiện lợi, hạn chế va đập, tiện lợi cả ở nhà và đi du lịch",199000,199000,0,0
TIKI,nha-sach-tiki,5087505,"Ám Dạ Hành (Trinh Thám Hiện Đại Trung Quốc)",63000,151000,88000,58
TIKI,nha-sach-tiki,1544255,"Băng Keo Trong 5F (2 Cuộn / Lốc)",17000,49000,32000,65
TIKI,nha-sach-tiki,160814425,"Thai Giáo Theo Chuyên Gia - 280 Ngày - Mỗi Ngày Đọc Một Trang (Tái Bản 2021)",82800,115000,32200,28
TIKI,nha-sach-tiki,171821043,"Bộ "Anne Tóc Đỏ" 8 Cuốn",717000,972000,255000,26
TIKI,nha-sach-tiki,52691750,"Tự Do Đầu Tiên & Cuối Cùng",124000,178000,54000,30
TIKI,nha-sach-tiki,72688722,"Giáo Dục - Tương Lai & Đổi Mới",148000,180000,32000,18
TIKI,nha-sach-tiki,6807847,"Cảm Ơn Người Lớn (Bìa Mềm) - Bản Tặng Kèm Thiệp + Phong Bì Thiệp + Bookmark (Số Lượng Có Hạn)",64200,110000,45800,42
TIKI,nha-sach-tiki,175967753,"Komi - Nữ Thần Sợ Giao Tiếp Tập 9",25000,25000,0,0
TIKI,nha-sach-tiki,173420792,"Người Hạt Dẻ",159200,199000,39800,20
TIKI,nha-sach-tiki,3840809,"New Economy Toeic Lc 1000 (Kèm file MP3)",149000,198000,49000,25
TIKI,nha-sach-tiki,72688720,"Năm Phút Nữa Thôi",43800,59000,15200,26
TIKI,nha-sach-tiki,46107066,"Học Cách Học",119000,159000,40000,25
TIKI,nha-sach-tiki,76117849,"Luyện Kỹ Năng Nghe Tiếng Anh (Trình Độ Cơ Bản) -Tactics For Listening Basic",64000,90000,26000,29
TIKI,nha-sach-tiki,172422019,"Vì Con Gái Tôi Có Thể Đánh Bại Cả Ma Vương - Tập 5 - Tặng Kèm Poster + Bookmark",119000,140000,21000,15
TIKI,nha-sach-tiki,36311444,"Đàn Ông Sao Hỏa Đàn Bà Sao Kim (Tặng Bookmark PL)",135360,188000,52640,28
TIKI,nha-sach-tiki,77481097,"Nghề Nhân Sự Việt - Nghìn Lẻ Chuyện Giờ Mới Kể",127400,199000,71600,36
TIKI,nha-sach-tiki,11119019,"Oxford Advanced Learner's Dictionary 8th Edition (With Vietnamese Translation) and CD - ROM (Paperback)",581300,625000,43700,7
TIKI,nha-sach-tiki,100382935,"Sách - Hành Trình Về Phương Đông (Bìa Mềm - Tái bản 2021) - First News",106650,106650,0,0
TIKI,nha-sach-tiki,158972052,"Cẩm Nang Con Trai",47100,68000,20900,31
TIKI,nha-sach-tiki,392568,"Marvellous Techniques For IELTS Writing",201000,268000,67000,25
TIKI,nha-sach-tiki,11413616,"Mẹ Hỏi Bé Trả Lời 4-5 Tuổi (Tái Bản)",27000,30000,3000,10
TIKI,nha-sach-tiki,100376369,"Đứa Con Gái Hoang Đàng - Hai Số Phận - Phần II",129000,209000,80000,38
TIKI,nha-sach-tiki,49716241,"Tử Vi Hàm Số (Bìa Cứng)",121000,180000,59000,33
TIKI,nha-sach-tiki,178240555,"Tần Số Của Chúng Ta",178000,179000,1000,1
TIKI,nha-sach-tiki,1667307,"Quân Vương – Thuật Cai Trị (Tái Bản)",69000,109000,40000,37
TIKI,nha-sach-tiki,195305999,"Giải mã truyện Tây Du",80000,119000,39000,33
TIKI,nha-sach-tiki,171137376,"SUY TƯỞNG – MARCUS AURELIUS ANTONINUS – TỦ SÁCH TINH HOA -",155000,155000,0,0
TIKI,nha-sach-tiki,196373994,"Sổ Tay Ghi Chép Bìa Da A5 300 Trang Kẻ Ngang Deli - Phù Hợp Làm Sổ Kế Hoạch Planner, Nhật Kí, Tập Vở Ghi Chép Bullet Journal - EN012 / EN013",106200,106200,0,0
TIKI,nha-sach-tiki,42975887,"Nuốt Cá Lớn - Eating The Big Fish",299000,299000,0,0
TIKI,nha-sach-tiki,26135056,"Bộ 2 cuốn sách về kinh tế hay nhất : Dạy Con Làm Giàu (Tập 1) - Để Không Có Tiền Vẫn Tạo Ra Tiền + Dạy Con Làm Giàu (Tập 2) - Sử Dụng Đồng Vốn (Tặng kèm Bookmark thiết kế AHA)",191500,191500,0,0
TIKI,nha-sach-tiki,145092202,"Túi giấy kraft Nhật trơn có quai đựng thực phẩm nhiều kích thước, túi giấy xi măng đựng quà",1675,1675,0,0
TIKI,nha-sach-tiki,196157730,"[QUÀ TẶNG ĐỘC QUYỀN] Combo 10 bông tẩm cồn sát trùng Alcohol Pads - Nhỏ gọn, rất tiện khi sử dụng.",25000,25000,0,0
TIKI,nha-sach-tiki,273636756,"Trạm Đọc Official | Hackers Toeic Vocabulary",209250,279000,69750,25
TIKI,nha-sach-tiki,59362973,"Osho Phụ Nữ - The Book Of Women",78000,109000,31000,28
TIKI,nha-sach-tiki,197587848,"Mỗi Ngày Gửi Cậu Một Cái Ôm",103000,129000,26000,20
TIKI,nha-sach-tiki,105614549,"Khay pha màu 10/14 ngăn Deli - 1 chiếc - 9402 / 9403",10000,10000,0,0
TIKI,nha-sach-tiki,58864689,"Giải Mã Siêu Trí Nhớ",139000,139000,0,0
TIKI,nha-sach-tiki,176824198,"How To Draw – Vẽ Nguệch Ngoạc Cả Thế Giới",103000,139000,36000,26
TIKI,nha-sach-tiki,72744539,"IELTS 15 ACADEMIC",142000,142000,0,0
TIKI,nha-sach-tiki,7440075,"Lâu Đài Trên Mây",71500,96000,24500,26
TIKI,nha-sach-tiki,178514167,"Tìm Lại Màu Xanh (Phần Tiếp Theo Của Người Truyền Ký Ức)",84000,108000,24000,22
TIKI,nha-sach-tiki,598975,"Dạy Con Làm Giàu 10 - Trước Khi Bạn Thôi Việc",78300,90000,11700,13
TIKI,nha-sach-tiki,187933180,"OKR - Phương Pháp Thiết Lập Mục Tiêu Và Quản Lý Công Việc Vượt Trội (Tái Bản 2022)",89800,129000,39200,30
TIKI,nha-sach-tiki,190705657,"Nuôi Dạy Con Theo Phương Pháp Montessori: Em Bé Sơ Sinh Từ 0-1 Tuổi",153000,220000,67000,30
TIKI,nha-sach-tiki,31515106,"Đàn Kiến Chăm Chỉ - Ngụ Ngôn Song Ngữ (Tái Bản 2019)",19200,32000,12800,40
TIKI,nha-sach-tiki,42877486,"Văn Học Kinh Điển Thế Giới - Peter Pan (Tái Bản)",57000,88000,31000,35
TIKI,nha-sach-tiki,192048655,"Tớ đã từng sợ hãi",58000,75000,17000,23
TIKI,nha-sach-tiki,129765498,"Văn Học Kinh Điển - Những Người Phụ Nữ Bé Nhỏ (tặng 2 postcard Tranh Màu + 1 bookmark)",190000,380000,190000,50
TIKI,nha-sach-tiki,51215567,"Đồng Tiền Hạnh Phúc",62000,95000,33000,35
TIKI,nha-sach-tiki,152522279,"Phúc Cho Ai Không Thấy Mà Tin - Những Câu Chuyện Nhiệm Mầu Về Hồng Ân Thiên Chúa",61100,88000,26900,31
TIKI,nha-sach-tiki,184075082,"Học Đàn Piano",90000,125000,35000,28
TIKI,nha-sach-tiki,106770825,"Bộ 10 bìa bao tập Thiên Long Điểm 10 TP-NBC01",15000,15000,0,0
TIKI,nha-sach-tiki,163553056,"Thần Chết Làm Thêm 300 Yên/Giờ (Tái Bản)",77200,105000,27800,26
TIKI,nha-sach-tiki,134846272,"Education - Kinh Doanh Giáo Dục Tại Thị Trường Việt Nam",164000,220000,56000,25
TIKI,nha-sach-tiki,197353392,"Holmes Ở Kyoto - Tập 6",52000,85000,33000,39
TIKI,nha-sach-tiki,10971007,"EQ - Trí Thông Minh Xúc Cảm Trong Công Việc",111300,159000,47700,30
TIKI,nha-sach-tiki,181131167,"Boxset Nhà Trọ Của Những Điều Đã Mất (3 Cuốn)",89000,90000,1000,1
TIKI,nha-sach-tiki,134605012,"15 Nguyên Tắc Vàng Về Phát Triển Bản Thân (Tái Bản)",103820,179000,75180,42
TIKI,nha-sach-tiki,173135243,"Vòng Đời (Life Cycles)",233000,350000,117000,33
TIKI,nha-sach-tiki,160371977,"Ăn Tối Cùng Chef Và Nói Chuyện Bếp",98000,170000,72000,42
TIKI,nha-sach-tiki,182548599,"Dragon Quest - Dấu Ấn Roto (Dragon Quest Saga Emblem Of Roto) Perfect Edition Tập 6 - Tặng Kèm Bookmark PVC",68000,75000,7000,9
TIKI,nha-sach-tiki,171549996,"Never Get Bored - Tí Ta Tí Toáy",120000,155000,35000,23
TIKI,nha-cua-doi-song,188769126,"Chuông cửa không dây thông minh CACAZI A10, chống nước khoảng cách sử dụng trong 300M, 60 loại nhạc chuông, 110 DB",185000,185000,0,0
TIKI,nha-cua-doi-song,185004559,"Ly Thủy Tinh Hoa Văn Navivu Vintage Glass 300 - 350ml",47000,47000,0,0
TIKI,nha-cua-doi-song,30008695,"Vĩ 5 viên pin Maxell dòng cao cấp CR2032",20049,20049,0,0
TIKI,nha-cua-doi-song,42718737," Đèn Led Trang Trí Bóng Tròn Dài 6M - 40  Bóng Trang Trí Noel Lễ Tết",80000,80000,0,0
TIKI,nha-cua-doi-song,696521,"Ổ Cắm Điện 4 Lỗ 3 Chấu 2 cổng USB Philips SPN6248WB/74 (2500W)",416000,469000,53000,11
TIKI,nha-cua-doi-song,153263106,"Kéo Cắt Gà  Nhật Bản Làm Bếp Đa Năng Cắt Vải Cắt Giấy SK5 Siêu Sắc - Hàng Loại 1- Chính Hãng",58000,65000,7000,11
TIKI,nha-cua-doi-song,155718559,"Bình xịt dầu ăn, xịt gia vị dạng phun sương chai thủy tinh 100ml - hàng chính hãng THAFA",35000,39000,4000,10
TIKI,nha-cua-doi-song,174489182,"Túi đựng rác phân hủy sinh học Sunhouse KS-GA6578BS",46000,70000,24000,34
TIKI,nha-cua-doi-song,4216861,"Kính bảo hộ 3M SF401AF chống đọng sương",75000,75000,0,0
TIKI,nha-cua-doi-song,36935892,"Combo 10 khăn lau bếp đa năng - KL29 (Giao ngẫu nhiên mẫu)",10000,10998,998,9
TIKI,nha-cua-doi-song,42264813,"Kẹp phơi đồ Inox -Kẹp phơi quần áo đồ chống gió",61800,61800,0,0
TIKI,nha-cua-doi-song,38306937,"Vỉ 5 Viên Pin CR1616 Lithium 3V Panasonic - Hàng Chính Hãng",86400,89000,2600,3
TIKI,nha-cua-doi-song,77315431,"[Chọn màu] Bộ 20 miếng bọc chân ghế tròn, chân bàn bằng silicon dày, bọc chân bàn chống trượt, chống xước cho sàn gỗ GD365-BCGheTron-20",19998,19998,0,0
TIKI,nha-cua-doi-song,26053920,"Vòi Nước Inox 304 Loại Tốt",34293,34293,0,0
TIKI,nha-cua-doi-song,12461025,"Nước cắm hoa công nghệ nano đồng Fresh Flowers AHT 430ml - giúp hoa lâu tàn, không thối nước",44000,55000,11000,20
TIKI,nha-cua-doi-song,90072128,"Kệ Giày Dép 7 Tầng Rộng 80cm Gỗ Tự Nhiên 100%- TN",745000,980000,235000,24
TIKI,nha-cua-doi-song,3677777,"Bình Lọc Nước BRITA Active Pink - 600ml (Kèm Microdisc)",549000,849000,300000,35
TIKI,nha-cua-doi-song,32153958,"Khóa Số ABUS 145/20 (20mm) - Nhiều Màu",129000,139000,10000,7
TIKI,nha-cua-doi-song,70840199,"Vá Canh Bằng Gỗ Nhãn Tự Nhiên - VAGOO - Làm Thủ Công Chống Thấm, Chống Ẩm Mốc, An Toàn Cho Sức Khoẻ",99000,99000,0,0
TIKI,nha-cua-doi-song,17998301,"Túi đựng đồ lót nhiều ngăn có móc treo",32827,34555,1728,5
TIKI,nha-cua-doi-song,53521887,"Giấy lọc cà phê Hario 40 cái (V60-VCF-02-40M)",49000,62000,13000,21
TIKI,nha-cua-doi-song,167937668,"Aó mưa măng tô,Áo mưa có dây kéo ,vải dù cao cấp chống thấm nước cực tốt ,bảo vệ cơ thể ấm áp,cho nam và nữ",151050,159000,7950,5
TIKI,nha-cua-doi-song,57521842,"Bàn Học Bàn Làm Việc Kết Hợp Kệ Sách Thương Hiệu IGEA",569000,620000,51000,8
TIKI,nha-cua-doi-song,152446716,"Cây Lài Trà - cây cảnh vườn + Tặng phân bón cho cây mau lớn",25000,30000,5000,17
TIKI,nha-cua-doi-song,161455577,"Đui đèn cảm biến chuyển động",42000,42000,0,0
TIKI,nha-cua-doi-song,73758944,"Kệ Đa Năng Để Lò Vi Sóng INOX Trắng Cao Cấp Chống Han Gỉ Kệ Để Đồ Nặng Siêu Gọn Cho Nhà Bếp VANDO",599000,856000,257000,30
TIKI,nha-cua-doi-song,82877146,"Đèn Bàn Học LED Chống Cận GHINER GN-1902 (Pin 4500mAh)",250000,320000,70000,22
TIKI,nha-cua-doi-song,207557574,"Bàn học gấp gọn ngồi bệt, bàn chân nhựa cứng 40x60cm mặt gỗ MDF loại đẹp ( giao màu ngẫu nhiên )",60000,77000,17000,22
TIKI,nha-cua-doi-song,93062863,"Ô dù tự động thông minh cao cấp toàn Fully Automatic Safe Umbrella, cơ chế giữ nước như dù ngược, khung nan chắc chắn chống gió bão cấp 6, vải siêu chống nước phủ Nano chống tia UV",259000,259000,0,0
TIKI,nha-cua-doi-song,58678597,"Hộp Cơm Điện Lock&Lock EJR226IVY (2 Lít)",1010000,1942000,932000,48
TIKI,nha-cua-doi-song,143322314,"Ron chặn khe hở 90cm đa năng, Nẹp dán chân cửa chống côn trùng, phù hợp mọi loại cửa tiện dụng-GD534-Ron90",29000,29000,0,0
TIKI,nha-cua-doi-song,126244017,"Ghế Học Sinh Tiểu Học Chống Gù Thông Minh Có Gác Chân BHS288 Ghế Ngồi Bàn Học Cho Bé Tuỳ Chỉnh Độ Cao - Hàng Chính Hãng",1035000,1265000,230000,18
TIKI,nha-cua-doi-song,7078973,"Kìm Cắt Chân Linh Kiện PLT 170 125mm",17000,17000,0,0
TIKI,nha-cua-doi-song,58536862,"Cặp Vỏ Gối Lụa Cao cấp A - 50x70cm hoặc 60x80cm - mềm mịn mát lạnh",165000,200000,35000,18
TIKI,nha-cua-doi-song,139161475," Muỗng, Muôi Múc Canh, Vá múc canh Inox 304 Cao Cấp, Sang Trọng Cho Bữa Cơm",45000,45000,0,0
TIKI,nha-cua-doi-song,69927147,"Túi Đựng Hộp Cơm Giữ Nhiệt Đa Lớp Nhiều Hoa Văn - Xanh Denim",23896,23896,0,0
TIKI,nha-cua-doi-song,52354974,"Combo 9 Ván Sàn Gỗ Tự Nhiên Màu Nâu Vàng, Vỉ Gỗ Lót Sàn Ban Công, Sân Vườn, Hồ Bơi, Phòng Spa, Siêu Bền, Chịu Nước Tốt, Chống Trơn Trượt, Tiêu Chuẩn Xuất Khẩu",249000,279000,30000,11
TIKI,nha-cua-doi-song,146288304,"Giá để/ Chân để/ Giá đỡ/ Chân đỡ đàn Guitar cao cấp - Kzm Kurtzman J2 - Đa năng, dành cho tất cả loại đàn Guitar - Màu đen - Hàng chính hãng",168000,168000,0,0
TIKI,nha-cua-doi-song,180001622,"Bộ 2 Ly Thuỷ Tinh Cao Luminarc Salto Frost Lime 350ml - LUSAQ3177",139000,180000,41000,23
TIKI,nha-cua-doi-song,52609001,"Đèn Pin Mini Cầm Tay Siêu Sáng Loại Đèn Nhỏ 3W Police Dùng Pin AA",31000,55000,24000,44
TIKI,nha-cua-doi-song,72615961,"Dây đèn led đom đóm trang trí decor phòng, du lịch cắm trại, fairy light cao cấp (tùy chọn loại nguồn cấp, chiều dài dây và màu sắc)",14000,23000,9000,39
TIKI,nha-cua-doi-song,140791193,"Bóng đèn LED Bright PHILIPS E27 - Thay thế hoàn hảo cho bóng đèn Compact - Hàng Chính Hãng",56000,90000,34000,38
TIKI,nha-cua-doi-song,72041730,"Bộ Dao 6 Món Lock&Lock (4 Dao, 1 Kéo, 1 Hộp Đựng Dao) CKK802",598000,996000,398000,40
TIKI,nha-cua-doi-song,192975755,"Kệ Gỗ Trang Trí Treo Tường Không Cần Khoan - Tặng Kèm Móc Treo Inox Và Phụ Kiện",95000,110000,15000,14
TIKI,nha-cua-doi-song,7583254,"Vòi xịt vệ sinh inox - Vòi xịt bồn cầu inox SUS 304 cao cấp",59800,59800,0,0
TIKI,nha-cua-doi-song,146495143,"Hộp vải đựng đồ BA03 đa năng, thùng đựng quần áo có nắp rời đậy chắc chắn an toàn dododios",129000,129000,0,0
TIKI,nha-cua-doi-song,47108061,"Bộ 100 túi bóng hút chân không 1 mặt nhám - có nhiều size túi kích thước khác nhau",65000,65000,0,0
TIKI,nha-cua-doi-song,73887002,"Đèn Ngủ Cảm Ứng Cảm Biến Dán Tường Sạc Pin USB Đời Mới",79000,79000,0,0
TIKI,nha-cua-doi-song,16869707,"Kính Bịt Mắt Ngủ 3D (Đen)",29900,39000,9100,23
TIKI,nha-cua-doi-song,197826403,"Bình Đựng Nước 2L Có Vạch Báo Giờ Uống Nước",65000,65000,0,0
TIKI,nha-cua-doi-song,16382292,"Bộ Quần Áo Đi Mưa - 3XL",115000,115000,0,0
TIKI,nha-cua-doi-song,53063443,"Ga giường chống thẩm trơn kích thước 1.6mx2m - Màu giao ngẫu nhiên",49450,49450,0,0
TIKI,nha-cua-doi-song,149376396,"Túi peva SmileBox size lớn bọc nhiều bộ quần áo treo tủ chống thấm, chống bụi, có khóa kéo đôi tiện lợi nhiều size ngắn dài 90cm 110cm- Hàng chính hãng",105000,105000,0,0
TIKI,nha-cua-doi-song,184122885,"Khăn tắm lau mặt nén bằng cotton dùng 1 lần hoặc tái sử dụng được cho du lịch khách sạn",38000,40000,2000,5
TIKI,nha-cua-doi-song,58679667,"Chuỗi dây đèn led gương trang điểm 10 bóng 5 màu điều chỉnh",199900,199900,0,0
TIKI,nha-cua-doi-song,145767958,"Set 3 hộp tròn đựng thực phẩm tủ lạnh, bảo quản thực phẩm có lót đáy ráo nước, van thoát khí PET Xuất Khẩu EU",299000,299000,0,0
TIKI,nha-cua-doi-song,173701257,"Khăn lau đa năng bếp, bát đĩa, cốc chén thấm nước chống dính dầu mỡ hai mặt",8000,8000,0,0
TIKI,nha-cua-doi-song,272298582,"Bóng đèn bắt muỗi ( dùng để thay thế bóng khi bóng chính bị hỏng)",68000,68000,0,0
TIKI,nha-cua-doi-song,32072094,"Dầu neem hữu cơ DOCNEEM phòng trị sâu bệnh hoa hồng, phong lan, cây cảnh, dầu neem oil nguyên chất ép lạnh 100ml",150000,150000,0,0
TIKI,nha-cua-doi-song,167954128,"BỘ LAU NHÀ TRÒN XOAY 360 ĐỘ MẪU MỚI",183000,350000,167000,48
TIKI,nha-cua-doi-song,75836319,"Phân bón hữu cơ Kích Hoa cho Hoa hồng, Hoa lan, cây cảnh, cây kiểng trong nhà và ngoài trời, giàu lân giúp phân nhánh nụ, hoa, giảm chồi điếc, dung tích 1 lít, chính hãng DOCNEEM",119000,119000,0,0
TIKI,nha-cua-doi-song,71518280,"Đèn Led Thanh 8 Bóng Để Bàn Đầu Gắn Ngõ USB Dự Phòng 4W (0.5W/led) Siêu Sáng",7000,14000,7000,50
TIKI,nha-cua-doi-song,718885,"Thùng rác nhựa Fitis Compact PPS1-904 - xanh xám - 10L",232000,290000,58000,20
TIKI,nha-cua-doi-song,26334551,"Mền dù cao cấp  - mỏng nhẹ - thoáng mát - Cho giấc ngủ dễ chịu [chăn ga gối đệm",160000,180000,20000,11
TIKI,nha-cua-doi-song,50241058,"Kệ sách gỗ để bàn - Tủ,kệ sách mini - Giao màu sắc ngẫu nhiên ",49000,57000,8000,14
TIKI,nha-cua-doi-song,25088140,"2 cuộn 1 lốc Bao rác cực đại",25000,25000,0,0
TIKI,nha-cua-doi-song,66903798,"Remote Điều Khiển Từ Xa Cho Quạt SenkoTR1428, TR1628, DR1608 – Hàng Chính Hãng",75000,75000,0,0
TIKI,nha-cua-doi-song,99099494,"Bóng Đèn LED 38W COMET Bulb Fighter CB02F0386 Ánh Sáng Trắng - Hàng Chính Hãng",164000,164000,0,0
TIKI,nha-cua-doi-song,26060194,"GĂNG TAY RỬA BÁT SILICON SIÊU DAI CỰC BỀN",9989,9989,0,0
TIKI,nha-cua-doi-song,143001862,"Ổ cắm điện đa năng shoptida có sạc nhanh PD 20W cổng USB+TYPEC, có 4-6 lỗ cắm tải 2500W, 1 đổi 1 15 tháng",174000,250000,76000,30
TIKI,nha-cua-doi-song,55727445,"Nắp đậy ly cốc bằng silicon nhiều mẫu xinh xắn",10000,10000,0,0
TIKI,nha-cua-doi-song,49100347,"Cây massage đa chức năng: gãi lưng , đấm lưng , massage đầu, tay, chân, vai tặng kèm móc treo siêu dính (màu ngẫu nhiên)",21900,21900,0,0
TIKI,nha-cua-doi-song,144590196," Kéo Nhật Nhà Bếp Cắt Gà Cắt Đồ Đa Năng Jodily - Hàng Chính Hãng ",105000,105000,0,0
TIKI,nha-cua-doi-song,58014281,"Giá treo móc phơi, kẹp quần áo cho gọn loại lớn Inox 304 dán tường gạch men - kèm keo dán sealant fix - HOBBY GPM3",123000,199000,76000,38
TIKI,nha-cua-doi-song,4355547,"Bộ lọc nước thô đầu nguồn 3 cấp lọc 10inch Yamato YMTH10-3TX",334000,385000,51000,13
TIKI,nha-cua-doi-song,10788516,"Khuôn làm kem 6 que  (Màu ngẫu nhiên)",32999,32999,0,0
TIKI,nha-cua-doi-song,162424714,"Khay Giấy Bạc, Khay Bạc Đựng Thực Phẩm Lót Nồi Chiên Không Dầu Chịu Nhiệt Cao - Hàng Loại 1 - Chính Hãng MINIIN",32000,65000,33000,51
TIKI,nha-cua-doi-song,72016703,"Bếp Nướng Than Hoa Phiên Bản Cải Tiến Loại Dài 2023 Chống Cháy Thực Phẩm, An Toàn Sức Khỏe, Không Cần Quạt, Bếp Nướng Không Khói, Bếp Nướng Ngoài Trời, Bếp Nướng Than Hoa Vuông",209000,209000,0,0
TIKI,nha-cua-doi-song,135442243,"Bộ Lục Giác Deli Đầu Bằng Chữ L Cao Cấp - Kiểu Dáng Nhỏ Gọn Giúp Người Dùng Cầm Nắm, Thao Tác Dễ Dàng DL230008 DL230009",24000,46800,22800,49
TIKI,nha-cua-doi-song,93760107,"Dây đèn trang trí ngoài trời chống nước dùng cho quán cà phê, trà chanh, trà sữa đuôi đèn chống nước -thương hiệu Kiotool",103000,103000,0,0
TIKI,nha-sach-tiki,4319337,"Tạo Dựng Thương Hiệu Cá Nhân",76300,109000,32700,30
TIKI,nha-sach-tiki,148802195,"How We’Re F***Ing Up Our Planet - Ta Đang Hủy Diệt Trái Đất Như Thế Nào",255000,330000,75000,23
TIKI,nha-sach-tiki,186578233,"Trúc thư dao 2 (Nước Tấn - Gió nổi cung đình)",173000,219000,46000,21
TIKI,nha-sach-tiki,8128223,"Lột xác để trở thành nhà đầu tư giá trị - The education of a value investor",268000,268000,0,0
TIKI,nha-sach-tiki,154245459,"Nghiền Từ Vựng Tiếng Anh - Học Qua Gốc Từ Bằng Hình Ảnh - Gốc Từ Là Bí Quyết Để Ghi Nhớ Hàng Nghìn Từ Vựng - Quyển 1",89000,135000,46000,34
TIKI,nha-sach-tiki,163297416,"My Hero Academia - Học Viện Siêu Anh Hùng Tập 3: All Might (Tái Bản)",25000,25000,0,0
TIKI,nha-sach-tiki,110649726,"Hành Trình Thức Tỉnh ",229000,229000,0,0
TIKI,nha-sach-tiki,172160196,"Thấu Hiểu Marketing Bệnh Viện",249000,249000,0,0
TIKI,nha-sach-tiki,14684312,"Dấn Thân (Tái Bản)",75000,112000,37000,33
TIKI,nha-sach-tiki,105837988,"Hộp 22 gôm tẩy học sinh Deli - Hình dáng ngộ nghĩnh đáng yêu - 71055 / 71054",59400,59400,0,0
TIKI,nha-sach-tiki,82072617,"Các Lỗi Thường Gặp Trong Tiếng Anh",51500,80000,28500,36
TIKI,nha-sach-tiki,63924629,"Tạp Văn Nguyễn Ngọc Tư (Tái Bản Lần Thứ 20-2020)",62000,90000,28000,31
TIKI,nha-sach-tiki,427631,"Tầm Nhìn Thay Đổi Quốc Gia",186000,268000,82000,31
TIKI,nha-sach-tiki,145977554,"Combo 2 Cuốn: Thần Số Học + Thần Số Học Ứng Dụng",242300,348000,105700,30
TIKI,nha-sach-tiki,273718791,"Sapiens: Lược Sử Loài Người",224000,299000,75000,25
TIKI,nha-sach-tiki,49252204,"Dạy Con Làm Giàu - Tập 12: Lời Tiên Tri Của Người Cha Giàu (Tái Bản)",98200,160000,61800,39
TIKI,nha-sach-tiki,194103341,"Bột Nước Muối Men: Nền tảng của bánh mỳ và pizza thủ công",232000,360000,128000,36
TIKI,nha-sach-tiki,188930498,"Người Bà Tài Giỏi Vùng Saga – Tập 6",40500,52000,11500,22
TIKI,nha-sach-tiki,82996527,"Tinh Thần Chiến Đấu Rực Lửa",66500,95000,28500,30
TIKI,nha-sach-tiki,47323978,"Quick Quick Học Nhanh Toàn Diện Từ Vựng Tiếng Anh Theo Chủ Đề Lớp 1",66000,89000,23000,26
TIKI,nha-sach-tiki,186265472,"Thế Giới Của Truyện Nôm",112000,170000,58000,34
TIKI,nha-sach-tiki,191782142,"Điều Vĩ Đại Đời Thường",63000,92000,29000,32
TIKI,nha-sach-tiki,147964307,"COMBO SÁCH PHÙ HỢP MỌI THỂ LOẠI ĐẦU TƯ – KỸ THUẬT KHÓ CHẲNG LO",428000,428000,0,0
TIKI,nha-sach-tiki,273568395,"Husky Và Sư Tôn Mèo Trắng Của Hắn (Tập 2)",111000,169000,58000,34
TIKI,nha-sach-tiki,730723,"Tuần Của Bé Tháng 7- Bé Tự Tin",11500,23000,11500,50
TIKI,nha-sach-tiki,75454261,"Stay Positive - Sống Tích Cực, Đời Hết Bực - Bí Quyết Sống Vui Mỗi Ngày",99000,120000,21000,18
TIKI,nha-sach-tiki,714023,"Ngụ Ngôn E Dốp - Văn Học Cổ Điển Hi Lạp",58800,98000,39200,40
TIKI,nha-sach-tiki,190238358,"Nhặt Sao - Bản Thường - (Tặng kèm 1 bookmark in 2 mặt)",161000,179000,18000,10
TIKI,nha-sach-tiki,189557421,"Blog Writing - Sống với nghề viết blog",216000,250000,34000,14
TIKI,nha-sach-tiki,111537683,"Và Rồi Chẳng Còn Ai (Agatha Christie)",64200,110000,45800,42
TIKI,nha-sach-tiki,196394987,"Hai Ta Trên Đường Kẻ Cuộc Đời",98400,109000,10600,10
TIKI,nha-sach-tiki,273714602,"Trạm Đọc | Thuật Tẩy Não - Nghệ Thuật Thao Túng Và Kiểm Soát Tâm Lý Đối Phương",141000,189000,48000,25
TIKI,nha-sach-tiki,191926658,"Trái cây đại chiến Zombie - Thế giới khủng long: Tập 10 - Vương quốc ngủ say",58000,89000,31000,35
TIKI,nha-sach-tiki,192833921,"Combo 2 Sách: Tiếng Anh Cho Người Mới Bắt Đầu và Tổng Ôn Ngữ Pháp Tiếng Anh Cô Trang Anh",328000,400000,72000,18
TIKI,nha-sach-tiki,193896500,"How Yoga Works: Bí mật Yoga",171900,239000,67100,28
TIKI,nha-sach-tiki,58165559,"Ngữ Pháp Tiếng Hàn Thông Dụng - Sơ Cấp",160000,250000,90000,36
TIKI,nha-sach-tiki,19948893,"Chạm Tay Hóa Vàng (Tái Bản)",77000,125000,48000,38
TIKI,nha-sach-tiki,107576379,"Sổ tay học sinh Destination B1,B2,C1&2",118500,118500,0,0
TIKI,nha-sach-tiki,644081,"Đường Về",52000,70000,18000,26
TIKI,nha-sach-tiki,7982626,"Thế Giới Phẳng (Tái Bản)",162000,310000,148000,48
TIKI,nha-sach-tiki,22881666,"Mindset For IELTS - Foundation Student's Book With Testbank And Online Modules",367350,395000,27650,7
TIKI,nha-sach-tiki,146272575,"Ăn Ít Để Khỏe - 1 Bữa Là Đủ Sao Phải Cần 3 (Tái Bản 2021)",92900,119000,26100,22
TIKI,nha-sach-tiki,173425949,"Khung ảnh để bàn nhiều kích thước, khung ảnh trong suốt Anzzar loại 2.5cm",47000,55000,8000,15
TIKI,nha-sach-tiki,35410612,"Combo Sách Tư Duy - Kỹ Năng Sống Ai Cũng Cần Phải Có : Cân Bằng Cảm Xúc, Cả Lúc Bão Giông + Nóng Giận Là Bản Năng , Tĩnh Lặng Là Bản Lĩnh ( Tặng Kèm Bookmark Green Life)",163500,163500,0,0
TIKI,nha-sach-tiki,73116944,"Combo 20 cuốn - Bé Tô màu - Luyện chữ (Mầm non - Chuẩn bị vào lớp 1)",99272,190907,91635,48
TIKI,nha-sach-tiki,194206884,"Frugal Innovation - Làm tốt hơn với nguồn lực ít hơn",142000,220000,78000,35
TIKI,nha-sach-tiki,181699596,"Jesse Livermore - Nhà Đầu Tư Chứng Khoán Vĩ Đại",152000,219000,67000,31
TIKI,nha-sach-tiki,121236564,"PHÂN TÍCH MẪU HÌNH BIỂU ĐỒ - Những Bí Quyết Giúp Nhà Giao Dịch Siêu Hạng DAN ZANGER Biến 11 Nghìn Đô Thành 42 Triệu Đô Trong 23 Tháng",348000,348000,0,0
TIKI,nha-sach-tiki,74307132,"Arty Mouse - Đồ Theo Nét (Học Tập Đầu Đời Thông Qua Mỹ Thuật)",41700,45000,3300,7
TIKI,nha-sach-tiki,74235036,"Điều Kỳ Diệu của Thái Độ Sống (Tái Bản)",44100,58000,13900,24
TIKI,nha-sach-tiki,195661677,"Tư Duy Sâu, Ý Tưởng Bén, Sáng Tạo Thần Sầu",139000,139000,0,0
TIKI,nha-sach-tiki,14683083,"Nhượng Quyền Khỏi Nghiệp - Con Đường Ngắn Để Bước Ra Thế Giới (Tái Bản)",112000,112000,0,0
TIKI,nha-sach-tiki,170298040,"Những Ý Tưởng Lớn Của Lý Quang Diệu",79000,120000,41000,34
TIKI,nha-sach-tiki,273119845,"Ông Trùm Cuối Cùng (Mario Puzo)",99000,150000,51000,34
TIKI,nha-sach-tiki,77323488,"Chatter - Trò Chuyện Với Chính Mình",128000,199000,71000,36
TIKI,nha-sach-tiki,72470133,"Bộ Cọ Tròn 6 Cây Chuyên Dụng Cao Cấp Để Tô Vẽ Tranh Sơn Dầu, Màu Nước, Màu Acrylic, Vẽ Nghệ Thuật",59000,59000,0,0
TIKI,nha-sach-tiki,34751670,"Ngụ Ngôn Song Ngữ Anh - Việt: Đôi Sừng Hươu (Tái Bản 2019)",19200,32000,12800,40
TIKI,nha-sach-tiki,91343895,"Những Sự Thật Về Ung Thư - Hiểu Thêm Để Bớt Lo",74100,105000,30900,29
TIKI,nha-sach-tiki,70540568,"Nuôi Dạy Bé Gái Từ 0 Đến 6 Tuổi (Tái Bản 2020)",52000,75000,23000,31
TIKI,nha-sach-tiki,173515430,"Khám Phá Vận Mệnh - 7 Bước Đánh Thức Bản Thân",82900,145000,62100,43
TIKI,nha-sach-tiki,182735416,"Pet Sematary - Nghĩa địa thú cưng - 1980books",209300,299000,89700,30
TIKI,nha-sach-tiki,1029852,"Tuần Của Bé - Bé Thân Thiện (Dành Cho Trẻ 3 - 6 Tuổi)",21850,23000,1150,5
TIKI,nha-sach-tiki,168559528,"Chiêm Tinh Học For Dummies",171000,249000,78000,31
TIKI,nha-sach-tiki,157054867,"Tôi Muốn Giỏi Tiếng Anh Nhưng Tôi Không Muốn Chăm Chỉ",145000,210000,65000,31
TIKI,nha-sach-tiki,19274771,"Chuỗi Án Mạng A.B.C (Tái Bản)",62100,105000,42900,41
TIKI,nha-sach-tiki,13116553,"Thị Trấn Mèo Tập 1 (Tái Bản 2019)",62000,68000,6000,9
TIKI,nha-sach-tiki,173878382,"Bảng Từ Trắng Viết Bút Lông Deli - Bảng Mica Hít Nam Châm Nhiều Kích Cỡ - Có Khay Đựng - Phù Hợp Học Sinh Văn Phòng - EV450 / EV600 / EV900",199000,405000,206000,51
TIKI,nha-sach-tiki,272588674,"Giấy Photo, giấy in Samsung A4/70gsm - 500 tờ/ream",78000,78000,0,0
TIKI,nha-sach-tiki,186290800,"Đón Ngọn Triều Dâng",76600,130000,53400,41
TIKI,nha-sach-tiki,146502516,"[Hàng Cao Cấp Loại Dày 2mm] Băng Dính 2 Mặt Đa Năng Trong Suốt Siêu Dày 2mm – Chọn Chiều Dài – Siêu Bám Dính - Băng Keo Trong Suốt Chính Hãng dododios",29000,29000,0,0
TIKI,nha-sach-tiki,10675287,"EAT CLEAN Thực Đơn 14 Ngày Thanh Lọc Cơ Thể Và Giảm Cân",105000,149000,44000,30
TIKI,nha-sach-tiki,34750340,"Ngụ Ngôn Song Ngữ Anh - Việt: Đừng Tin Lời Gã Cáo (Tái Bản 2019)",16800,28000,11200,40
TIKI,nha-sach-tiki,195541265,"Bài Tập Thực Hành Tiếng Anh 7 (Có Đáp Án) - Dùng Kèm SGK Tiếng Anh 7 GLOBAL SUCCESS",64000,65000,1000,2
TIKI,nha-sach-tiki,22881827,"Complete IELTS B1 Student's Book with answer with CD-ROM",259470,279000,19530,7
TIKI,nha-sach-tiki,109982974,"Alfred Nobel Và Bản Di Chúc Bất Hủ",51500,65000,13500,21
TIKI,nha-sach-tiki,593709,"Góc Khuất Đàn Bà - Bản Thông Thường",66300,89000,22700,26
TIKI,nha-sach-tiki,16422526,"365 Chuyện Kể Trước Giờ Đi Ngủ - Những Câu Chuyện Phát Triển Chỉ Số Tình Cảm EQ (Tái Bản)",55000,78000,23000,29
TIKI,nha-sach-tiki,115078652,"Huấn Luyện Cảm Xúc Để Con Trẻ Phát Triển Toàn Diện",153000,198000,45000,23
TIKI,nha-sach-tiki,173973552,"Sách Từ Vựng Tiếng Anh : Từ Cùng Trường Nghĩa Trong Tiếng Anh Cô Trang Anh",149000,200000,51000,26
TIKI,nha-sach-tiki,41556498,"Tác Phẩm Kinh Điển: Thiên Tài Bên Trái, Kẻ Điên Bên Phải / Sách Văn Học Hay (Tặng Kèm Bookmark Thiết Kế Bookmark Happy Life)",163250,163250,0,0
TIKI,nha-sach-tiki,1686729,"Học Tiếng Anh Giao Tiếp Chỉ Trong 30 Ngày",224000,298000,74000,25
TIKI,nha-sach-tiki,12107379,"Barron's Essential Words For The Ielts (Tái Bản)",145000,208000,63000,30
TIKI,nha-sach-tiki,192714730,"Tuyển Tập Đề Kiểm Tra Định Kì Khoa Học Tự Nhiên Lớp 7 ( Theo Chương Trình GDPT Mới )",69000,92000,23000,25
TIKI,nha-sach-tiki,194104629,"Một Quyển Phong Hoa Đại Đường",96500,139000,42500,31
TIKI,nha-sach-tiki,111155169," [Manga] Diệt Slime Suốt 300 Năm, Tôi Levelmax Lúc Nào Chẳng Hay (Tập 5) ",38100,48000,9900,21
TIKI,nha-sach-tiki,190707619,"Của Chuột Và Người",60300,76000,15700,21
TIKI,nha-sach-tiki,55957270,"Sách Hoa Trôi Trên Sóng Nước (Tái Bản 2020) - Nguyên Phong",64000,98000,34000,35
TIKI,nha-sach-tiki,46253703,"Danh Gia Cổ Vật - Bí Ẩn Thanh Minh Thượng Hà Đồ",119000,150000,31000,21
TIKI,nha-sach-tiki,136540035,"Tư Duy Hộp Đen (Tìm Ra Lời Giải Cho Những Câu Hỏi Trong Cuộc Sống Và Kinh Doanh Bằng Tư Duy Thực Tế)",152500,219000,66500,30
TIKI,nha-sach-tiki,14643411,"Điều Kỳ Diệu (Tái Bản)",84200,148000,63800,43
TIKI,nha-sach-tiki,41299102,"Những Nguyên Lý Quản Trị Bất Biến Mọi Thời Đại (Tái Bản 2019)",96100,138000,41900,30
TIKI,nha-sach-tiki,386182,"Thế Giới Tuổi Thần Tiên - Những Câu Chuyện Trong Rừng Xanh",20000,38000,18000,47
TIKI,nha-sach-tiki,7556499,"GAM7 No.11 Promotion - Khuyến Mại",136000,165000,29000,18
TIKI,nha-sach-tiki,67120551,"Đây Là Monet",109000,150000,41000,27
TIKI,nha-sach-tiki,187279375,"Sách Luyện thi B2 Vstep 4 kỹ năng - Ôn thi chứng chỉ tiếng Anh bậc 4 (bằng B2 tiếng Anh) khung năng lực Ngoại ngữ 6 bậc Việt Nam",350000,350000,0,0
TIKI,nha-sach-tiki,15634588,"Who? Chuyện Kể Về Danh Nhân Thế Giới: Ludwig Van Beethoven (Tái Bản 2019)",41000,55000,14000,25
TIKI,nha-sach-tiki,189076559,"Gatsby vĩ đại",184000,280000,96000,34
TIKI,nha-sach-tiki,95311763,"Phương Pháp Ăn Uống Cải Thiện Lưu Thông Máu",61800,89000,27200,31
TIKI,nha-sach-tiki,178240500,"Đường Gia Tiểu Miêu",133000,179000,46000,26
TIKI,nha-sach-tiki,11470936,"Combo Giáo Trình HSK 3 - Sách Bài Học (Kèm MP3) và Giáo Trình HSK 3 - Sách Bài Tập (Kèm MP3) ( Tặng Kèm Sổ Tay)",380800,476000,95200,20
TIKI,nha-sach-tiki,1732997,"Hồ Sơ Mật Lầu 5 Góc Và Hồi Ức Về Chiến Tranh Việt Nam (Sách Tham Khảo)",290000,290000,0,0
TIKI,nha-sach-tiki,29190890,"Tôi Đi Tìm Tôi",103000,160000,57000,36
TIKI,nha-sach-tiki,172175794,"Lý Thuyết Dow - Khoa Học Đầu Cơ Chứng Khoán: Bí Quyết Phân Tích Hành Vi Thị Trường Của Cha Đẻ Chỉ Số Dow Jones - Tác Phẩm Nền Tảng Của Phân Tích Kĩ Thuật Hiện Đại",37100,55000,17900,33
TIKI,nha-sach-tiki,187859732,"Spy Room – Lớp Học Điệp Viên 4",83900,109000,25100,23
TIKI,nha-sach-tiki,273634677,"Trạm Đọc Official | Hackers Ielts 4 cuốn  ( Listening + Reading + Speaking + Writing )",743000,996000,253000,25
TIKI,nha-sach-tiki,81499980,"Danh Gia Cổ Vật - Minh Nhãn Mai Hoa",178000,230000,52000,23
TIKI,nha-sach-tiki,195288800,"Combo 2 Cuốn Khám Phá Sứ Mệnh Với Câu Hỏi Tại Sao – Bắt Đầu Với Câu Hỏi Tại Sao",149000,208000,59000,28
TIKI,nha-sach-tiki,157244522,"Văn Minh Đông Phương Và Tây Phương (Ts Thu Giang Nguyễn Duy Cần)(Tái Bản)",41200,60000,18800,31
TIKI,nha-sach-tiki,68350215,"Combo Chinh Phục Luyện Thi Vào 10 Toán Văn Anh Theo Chủ Đề",313000,477000,164000,34
TIKI,nha-sach-tiki,41299108,"Trở Về Từ Cõi Sáng (Tái Bản)",68100,98000,29900,31
TIKI,nha-sach-tiki,112331977,"Quiz! Khoa Học Kì Thú: Khám Phá Trái Đất",49100,68000,18900,28
TIKI,nha-sach-tiki,190701640,"Diệt Slime Suốt 300 Năm, Tôi Levelmax Lúc Nào Chẳng Hay (Tập 4) - (Tái Bản)",48000,52000,4000,8
TIKI,nha-sach-tiki,73553827,"Dữ Liệu Lớn Cho Doanh Nghiệp Nhỏ For Dummies",118000,159000,41000,26
TIKI,nha-sach-tiki,187859733,"Thám Tử Đã Chết Tập 4 - Bản Phổ Thông - Quà Tặng Kèm Bookmark, Bộ Card Trong Bù Của Tập 3 (Trong Lần In Đầu)",83900,109000,25100,23
TIKI,nha-sach-tiki,77281352,"Lời giải bài tập Python cơ bản",75000,75000,0,0
TIKI,nha-sach-tiki,595726,"Giáo Trình Chuẩn HSK 4 Bài Học (Tập 2)",179000,238000,59000,25
TIKI,nha-sach-tiki,49904794,"Fullset Ehon Nhật Bản cho bé thông minh sáng tạo: Ehon Điều Kỳ Diệu Của Hình Khối + Điều Kỳ Diệu Của Âm Thanh + Điều Kỳ Diệu Của Màu Sắc (Bộ 10 cuốn cho bé 0-6 tuổi / Bộ Sách Phát Triển Trí Tuệ & Kích Thích Thị Giác Cho Bé)",269000,390000,121000,31
TIKI,nha-sach-tiki,191045567,"Làm Người Là Như Thế Nào? How To Be Human – The Manual",133000,179000,46000,26
TIKI,nha-sach-tiki,9687403,"The Book Of Leadership - Dẫn Dắt Bản Thân, Đội Nhóm Và Tổ Chức Vươn Xa",150000,218000,68000,31
TIKI,nha-sach-tiki,595738,"Giáo Trình Chuẩn HSK 4 Bài Tập (Tập 1)",111000,148000,37000,25
TIKI,nha-cua-doi-song,28619438,"Thang nhôm rút gọn SUMIKA SK320 - Chiều cao tối đa 3.2m, chiều dài rút gọn 0.8m, hợp kim nhôm cao cấp, khóa chốt chắc chắn, đế cao su chống trượt, nhỏ gọn, di chuyển tiện lợi",1139000,1500000,361000,24
TIKI,nha-cua-doi-song,157175018,"Kệ Thanh Ngang Treo Tường Kết Cấu Giấu Chân SIB Decor, Gỗ Lõi Xanh Chống Ẩm, Kèm Phụ Kiện Và Thước Thuỷ Lấy Cân Bằng",89000,89000,0,0
TIKI,nha-cua-doi-song,173768367,"Hộp đựng đồ chia ngăn 7 - 9 và 12 ngăn sắp xếp quần áo Danido - Khay đựng đồ chia ngăn tiện ích, chất liệu cao cấp",75050,79000,3950,5
TIKI,nha-cua-doi-song,148810239,"Hộp Cơm Cắm Điện Đời Mới Chính Hãng MINIIN, Hâm Nóng, Giữ Nhiệt, Nấu Chín Cơm Và Thức Ăn, 2 Tầng Nhỏ Gọn, 4 Bát Innox Không Gỉ, Tặng Kèm Bộ Đũa Và Thìa, Đa Chức Năng, Dễ Dàng Vệ Sinh",220150,259000,38850,15
TIKI,nha-cua-doi-song,165219472,"Sét 10 khay giấy bạc,khay bạc đựng thực phẩm lót nồi chiên không dầu chịu nhiệt độ cao",10000,13000,3000,23
TIKI,nha-cua-doi-song,98678067,"10 Thùng hộp carton - Mã MHL8 - Kích thước 50x40x30 (cm)",162000,162000,0,0
TIKI,nha-cua-doi-song,198562465,"Bàn Làm Việc, Bàn Học Có Ngăn Để Đồ Tiện Dụng Phong Cách Bắc Âu Thương Hiệu IGA - GP185",613000,666000,53000,8
TIKI,nha-cua-doi-song,138534630,"Tủ nhựa KATA 5 tầng giá rẻ, chất lượng, chính hãng, nhiều màu sắc",1049000,1250000,201000,16
TIKI,nha-cua-doi-song,75483321,"Dụng Cụ Cọ Rủa Bình,Ly Có Đầu Mút-Giao Màu Ngẫu Nhiên",12000,12000,0,0
TIKI,nha-cua-doi-song,68716601,"Dao Gọt Hoa Quả Sunhouse KS-KN100PS",33000,49000,16000,33
TIKI,nha-cua-doi-song,184915910,"Chậu Gội Đầu Tại Nhà, Tại Giường Cho Người Già, Người Bệnh, Trẻ Em",89000,125000,36000,29
TIKI,nha-cua-doi-song,1084776,"Chảo Chống Dính Vân Đá Đáy Từ HappyCook MFP-26IH GRAY (26cm)",235000,373000,138000,37
TIKI,nha-cua-doi-song,263488389,"Kệ sách để bàn HT003  - Vàng vân gỗ - Ván dày 12mm",47000,58000,11000,19
TIKI,nha-cua-doi-song,27068546,"Bộ 2 Túi Đựng Chăn Màn - Túi Quần Áo Khung Sắt Gấp Gọn 2 Chiếc Cao Cấp (Giao màu ngẫu nhiên)",169000,250000,81000,32
TIKI,nha-cua-doi-song,177081696,"Cây Sứ Thái Kép Hoa Tím - cây cảnh để trong nhà + tặng phân bón cho cây",65000,110000,45000,41
TIKI,nha-cua-doi-song,25036470,"Bình Lọc Nước Barrier Nika (2.5l) - Xanh Lá",206000,450000,244000,54
TIKI,nha-cua-doi-song,49123718,"Bàn Học, Bàn Làm Việc Thông Ming Thương Hiệu IGEA",758000,825000,67000,8
TIKI,nha-cua-doi-song,243047801,"Gối tựa lưng văn phòng cao su non A kích thước 34 x 34 cm x 6/10cm",180000,180000,0,0
TIKI,nha-cua-doi-song,16284231,"Bộ 50 móc dán tường siêu dính ",22999,22999,0,0
TIKI,nha-cua-doi-song,146373034,"Hộp Đựng Đồ Dùng Gấp Gọn Cao Cấp BA01 Kích Thước 38x25x25cm Tiện Lợi, Hộp Vải Chia Ngăn Đựng Quần áo, Hộp vải chia 7 ngăn, chia 9 ngăn, chia 11 ngăn, chia 12 ngăn - Chính Hãng dododios",65000,65000,0,0
TIKI,nha-cua-doi-song,108712114,"Kèn Melodion Swan 32 Phím Model SW-37 Tặng kèm túi đựng TIKCO và khăn lau hàng chính hãng",195000,195000,0,0
TIKI,nha-cua-doi-song,54758744,"combo 5 keo bẫy  chuột siêu dính cao cấp , dùng được nhiều lần ",34900,34900,0,0
TIKI,nha-cua-doi-song,133245917,"Hộp Đựng Bàn Chải Và Nhả Kem Đánh Răng Tự Động Tặng Kèm  Cốc Hút Từ -Kệ Để Đồ Nhà Tắm Dán Tường Tiện Lợi- Hàng Chính Hãng MINIIN",145350,153000,7650,5
TIKI,nha-cua-doi-song,76058957,"Kệ gia vị chữ E cao cấp VANDO bằng thép carbon chống gỉ, chống xước, kệ đựng chai lọ gia vị đa năng, kệ để đồ nhà bếp gọn gàng, sang trọng",399000,656000,257000,39
TIKI,nha-cua-doi-song,190989561,"Bình đựng thức ăn giữ nhiệt Inox 316 Elmich EL-8019 dung tích 600ml",301000,419000,118000,28
TIKI,nha-cua-doi-song,67937873,"Tấm bảo vệ nệm Everon White",370000,370000,0,0
TIKI,nha-cua-doi-song,117791447,"Bình nước cho bé đi học, Bình uống nước cho bé có ống hút 700ml bằng nhựa PP chịu nhiệt tốt tặng kèm túi và dây đeo tiện lợi BBShine – BN011",94000,150000,56000,37
TIKI,nha-cua-doi-song,120470924,"Bình Thuỷ Tinh Luminarc Dona Embossment Ray 1L - LUDOQ0436 ",104000,104000,0,0
TIKI,nha-cua-doi-song,85908084,"Nhang Sạch Phòng Máy Lạnh - Ít khói - Hương trầm dịu nhẹ - Chân tăm mộc - Nhang Xanh - 300g - 20cm",120000,120000,0,0
TIKI,nha-cua-doi-song,34527170,"Giấy bạc dán tường nhà bếp chống thấm dầu, thấm nước tiện dụng 3mx60cm",20999,20999,0,0
TIKI,nha-cua-doi-song,155114109,"Ngăn Kéo Nhựa Nhỏ Mini, Khay Đựng Bút Gắn, Hộp ngăn kéo Treo Dưới Bàn Làm Việc Giúp Cất Giữ Gọn Gàng Bàn Làm Việc (Giao Màu Ngẫu Nhiên)",119000,119000,0,0
TIKI,nha-cua-doi-song,46178511,"Túi Lọc Sữa Đậu Nành, Túi Lọc Sữa Hạt Cao Cấp, Túi Lọc Trà, Túi Lọc Gia Vị - Hàng Chính Hãng",28000,60000,32000,53
TIKI,nha-cua-doi-song,180750013,"VẢI GA BỌC GHẾ SOFA GIƯỜNG - SOFA BED",66000,66000,0,0
TIKI,nha-cua-doi-song,54644755,"Áo bọc bàn để ủi quần áo, nhiều họa tiết - Áo trùm bàn ủi đồ, chọ size theo ý, giao mẫu ngẫu nhiên+ Tặng kèm hình dán",59000,59000,0,0
TIKI,nha-cua-doi-song,71342375,"Áo Mưa Bít Trẻ Em Vải Dù Siêu Dày Hàng Việt Nam, Chống Thấm Nước, Phơi Mau Khô Ráo, Che Kín Người An Toàn Cho Bé, Có Lựa Chon Size, Giới Tính Cho Bé ( Giao Màu - Mẫu Ngẫu Nhiên Vì Nhiều Hoạt Tiết)",90000,90000,0,0
TIKI,nha-cua-doi-song,8085585,"Giấy lọc cà phê Hario 40 cái (V60-VCF-02-40W)",47000,58000,11000,19
TIKI,nha-cua-doi-song,118898224,"Phin nhôm cao cấp hoa văn màu đen có hộp giấy",75000,75000,0,0
TIKI,nha-cua-doi-song,42354346,"Gối Chữ U Kèm Bịt Mắt, Bịt Tai – Gối Ngủ Du Lịch, Tựa Đầu Chống Mỏi Chất Liệu Memory Foam Chính Hãng miDoctor – mi1711",149000,149000,0,0
TIKI,nha-cua-doi-song,144203362,"Bộ túi hộp cơm thủy tinh Lock&amp;Lock 3EA LLG429DS2GRY (LLG429Dx1, LLG428x1, HWB820GRYx1) - Màu",355000,682000,327000,48
TIKI,nha-cua-doi-song,25731116,"Thùng vuông 55 lít - có bánh xe Duy Tân No.748 (61 x 43 x 32 cm)",195000,195000,0,0
TIKI,nha-cua-doi-song,152446518,"Cây cúc tần ấn độ - cây cảnh vườn + tặng phân bón cho cây",25000,30000,5000,17
TIKI,nha-cua-doi-song,4361879,"Bộ lọc nước thô đầu nguồn 3 cấp lọc 10inch Yamato YMTH10-3T",334000,450000,116000,26
TIKI,nha-cua-doi-song,155253236,"HỘP PIN MAXELL 40 VIÊN  AAA TEM BẠC - HÀNG CHÍNH HÃNG",51450,51450,0,0
TIKI,nha-cua-doi-song,174897090,"Combo 4 Miếng dán tường treo kệ bếp, kệ nhà tắm",24000,24000,0,0
TIKI,nha-cua-doi-song,212986033,"Đồng hồ bấm giờ đếm ngược điện tử mini, đồng hồ điện tử đa năng - Funu Home",65000,65000,0,0
TIKI,nha-cua-doi-song,48354676,"Bộ 2 Hộp Thủy Tinh Chịu Nhiệt KLOCK KV400 (2 x 400ml) Tặng Túi Giữ Nhiệt",119000,199000,80000,40
TIKI,nha-cua-doi-song,67980198,"Phân bón hữu cơ sinh học KingCrop, dùng trồng rau, cây ăn trái sạch, an toàn",70000,70000,0,0
TIKI,nha-cua-doi-song,150561019,"Ủng Bọc Giày Đi Mưa Cổ Cao Có Đế Chống Trượt",38900,38900,0,0
TIKI,nha-cua-doi-song,217766070,"Thùng Rác Văn Phòng Dạng Lưới Kim Loại Size 27cm",88000,88000,0,0
TIKI,nha-cua-doi-song,136014171,"Bình Nước Nhựa We Bare Bears 1l Dễ Thương Có Kèm Túi Rút Túi Giữ Nhiệt Và Ống Hút Siêu Tiện Lợi",418000,418000,0,0
TIKI,nha-cua-doi-song,35169106,"Bộ 3 đầu cọ bàn chải gắn máy Khoan cầm tay - Dụng cụ vệ sinh nhà cửa lốp xe thông minh",60000,149440,89440,60
TIKI,nha-cua-doi-song,274541068,"Combo 10 cặp nút tai chống ồn cao cấp Honeywell Max 1 - Nút bịt tai chống ồn khi đi ngủ, ôn thi, đi máy bay, công trình, xưởng in",3000,3000,0,0
TIKI,nha-cua-doi-song,196552579,"Ô Dù gấp gọn , dù che mưa , chống tia UV 8 nan ( nhiều mẫu )",51000,51000,0,0
TIKI,nha-cua-doi-song,46185330,"COMBO 10 MÓC INOX HÌNH CHỮ S NHỎ",60000,60000,0,0
TIKI,nha-cua-doi-song,98955056,"Móc Treo Quần Áo Inox SUS304 7 Chấu Dán Tường Không Cần Khoan Đục - Tặng Kèm keo và Đinh Vít",150000,195000,45000,23
TIKI,nha-cua-doi-song,42566535,"Dụng Cụ Mài Dao 3 Rảnh - Dụng Cụ Mài Nhiều Loại Dao, Nhiều Chế Độ",15000,15000,0,0
TIKI,nha-cua-doi-song,26602007,"Kẹp Bẫy Bắt Chuột Thông Minh",7000,9899,2899,29
TIKI,nha-cua-doi-song,59236591,"Cốc Thủy Tinh Chia Vạch Tiên Lợi-màu giao ngẫu nhiên- CCV",24000,24000,0,0
TIKI,nha-cua-doi-song,35068214,"Pin 12V- Pin A23 Panasonic LRV08 - Hàng Chính Hãng",35000,35000,0,0
TIKI,nha-cua-doi-song,100431737,"Bộ hộp bảo quản thực phẩm đa năng Nora Ez – FS11-E1++++",198000,198000,0,0
TIKI,nha-cua-doi-song,82979825,"Bàn Chải Đa Năng Cầm Tay Dùng Cho Phòng Tắm Hình Cá Voi Có Đế Đựng Tiện Lợi",45000,45000,0,0
TIKI,nha-cua-doi-song,58498874,"Bộ Đũa Thìa Dĩa Inox, Hộp Đựng Lúa Mạch, Nhiều Màu Lựa Chọn, Tặng Kèm Ống Hút Tre",48999,48999,0,0
TIKI,nha-cua-doi-song,71692258,"Mũ làm khô tóc siêu thấm nước dùng sau khi gội đầu/tắm đa năng",42000,42000,0,0
TIKI,nha-cua-doi-song,59412424,"Bộ Dụng Cụ Bếp (Đũa, Sạn, Vá) Bằng Gỗ Nhãn Tự Nhiên - VAGOO - Làm Thủ Công Chống Thấm, Chống Ẩm Mốc, An Toàn Sức Khoẻ",169000,169000,0,0
TIKI,nha-cua-doi-song,55718749,"Tấm lót silicon đa năng trơn dùng làm bánh lót bàn ăn",69000,69000,0,0
TIKI,nha-cua-doi-song,145420630,"kệ treo quần áo chống gỉ / Giá treo áo khoác kim loại đơn giản và thời trang Bền Chắc Đa Năng Nội Thất Cho Phòng Ngủ- Bảo hành 10 năm",399000,399000,0,0
TIKI,nha-cua-doi-song,253106781,"Nút Nắp Đậy Chai Bằng Silicon Hình Con Chim Giao Màu Ngẫu Nhiên",61600,61600,0,0
TIKI,nha-cua-doi-song,26299212,"Miếng Che Mắt Ngủ Có Túi Gel Làm Mát - Màu Ngẫu Nhiên",32000,32000,0,0
TIKI,nha-cua-doi-song,197649725,"Bình Nước Giữ Nhiệt 500ml Bằng Thép Không Gỉ 304 Hai Lớp Có Màn Hình Kỹ Thuật Số Hiển Thị Nhiệt Độ Cảm Biến 1 Chạm",125000,125000,0,0
TIKI,nha-cua-doi-song,128202074,"Găng Tay Siêu Dai Hình Con Hươu Lót Nỉ",21000,21000,0,0
TIKI,nha-cua-doi-song,25620364,"Set 300 ống hút nhựa PP an toàn",64500,64500,0,0
TIKI,nha-cua-doi-song,116749239,"Ruột Gối Doona Basic độ bền cao, mềm mịn, an toàn cho sức khoẻ",195000,210000,15000,7
TIKI,nha-cua-doi-song,13509515,"Đèn LED siêu sáng USB 28 bóng AZONE",34000,89000,55000,62
TIKI,nha-cua-doi-song,31264857,"Combo 5 Chiếc Khăn Tắm Xuất Nhật bản to 70x140cm",62999,62999,0,0
TIKI,nha-cua-doi-song,192443483,"Hộp cơm văn phòng KIPOR KP-HC01 - Thuỷ tinh cao cấp dùng được trong lò vi sóng - Chống tràn, tiện lợi - Hàng chính hãng",42000,72000,30000,42
TIKI,nha-cua-doi-song,27826567,"Dụng cụ ép tỏi, nghiền tỏi có tay cầm tiện dụng",22000,22000,0,0
TIKI,nha-cua-doi-song,11249688,"Dụng Cụ Bịt Mắt Ngủ- Màu Trắng Hình Ngẫu Nhiên",10800,10800,0,0
TIKI,nha-cua-doi-song,47271244,"Shaker Inox 2 mảnh - Cocktail Boston",175000,175000,0,0
TIKI,nha-cua-doi-song,984752,"Nồi Inox 3 Đáy Fivestar N20-3DG (20cm) - Hàng Chính Hãng",279000,279000,0,0
TIKI,nha-cua-doi-song,101937904,"Kệ nhà tắm, Kệ để đồ toilet thông minh Kệ để đồ phòng tắm phòng vệ sinh dán tường không cần khoan đục",38999,38999,0,0
TIKI,nha-sach-tiki,59010153,"100 Kỹ Năng Sinh Tồn",70000,99000,29000,29
TIKI,nha-sach-tiki,13443886,"Giáo Trình Chuẩn HSK 3 Bài Học (Kèm file MP3) - Tái Bản",216000,288000,72000,25
TIKI,nha-sach-tiki,1823525,"Series Địch Công Kỳ Án: Đạo Quán Có Ma",36000,79000,43000,54
TIKI,nha-sach-tiki,185435307,"Thần Mộc Cào Bất Tận – Tập 2 - Bản Thường (Tặng 1 Bookmark in 2 Mặt)",129000,166000,37000,22
TIKI,nha-sach-tiki,644083,"Thời Gian Để Sống Và Thời Gian Để Chết",66000,100000,34000,34
TIKI,nha-sach-tiki,192475874,"Tôi Muốn Vì Bạn Mà Trở Thành Người Tốt",66600,86000,19400,23
TIKI,nha-sach-tiki,186290796,"Còn chút gì để nhớ (Tái Bản 2022)",28000,43000,15000,35
TIKI,nha-sach-tiki,161930883,"Thói Quen Thứ 8 - Từ Hiệu Quả Đến Vĩ Đại (Bìa Mềm)",114000,168000,54000,32
TIKI,nha-sach-tiki,111165275,"Cao Thủ Đổi Đen Thay Trắng - Tập 3 (Dành Cho 18+)",112000,149000,37000,25
TIKI,nha-sach-tiki,73268489,"Những Ông Trùm Tài Chính",204400,299000,94600,32
TIKI,nha-sach-tiki,52332414,"Nghi thức trì Chú Đại Bi, Chú Dược Sư & Niệm Phật A Di Đà ",19000,19000,0,0
TIKI,nha-sach-tiki,166525103,"NFT – Cuộc Cách Mạng Công Nghệ Tiếp Nối Blockchain Và Kỷ Nguyên Tiền Điện Tử",110700,159000,48300,30
TIKI,nha-sach-tiki,138934615,"Tô Màu Phát Triển Trí Não Bộ Cho Bé 1-5 Tuổi - Tập 4",16000,16000,0,0
TIKI,nha-sach-tiki,161929579,"Fullmetal Alchemist - Cang Giả Kim Thuật Sư - Fullmetal Edition Tập 13 [Tặng Kèm Bookmark PVC]",61600,69000,7400,11
TIKI,nha-sach-tiki,120509490,"Thương Nhớ Mười Hai (Việt Nam Danh Tác) (Tái Bản)",72100,99000,26900,27
TIKI,nha-sach-tiki,54616131,"Tử Huyệt Cảm Xúc",118000,118000,0,0
TIKI,nha-sach-tiki,2651041,"Bàn Về Văn Minh",103000,139000,36000,26
TIKI,nha-sach-tiki,185243203,"Tiếng Anh 10 Bright Workbook (Sách bài tập)",65000,65000,0,0
TIKI,nha-sach-tiki,194104230,"Gió Lẻ Và 9 Câu Chuyện Khác",58000,90000,32000,36
TIKI,nha-sach-tiki,194959711,"Đao Ngữ (Katanagatari) 3",63000,120000,57000,48
TIKI,nha-sach-tiki,185903114,"Bài tập Thực hành tiếng Anh 6 (Có đáp án) - Dùng kèm SGK TA 6 GLOBAL SUCCESS",44100,60000,15900,27
TIKI,nha-sach-tiki,981942,"Combo Kích Thích Phát Triển Thị Giác Cho Bé ( Trọn Bộ 6 Cuốn )",134000,180000,46000,26
TIKI,nha-sach-tiki,160754106,"Nghiên Cứu Phân Tâm Học",98500,135000,36500,27
TIKI,nha-sach-tiki,3529957,"i-Learn Smart World 8 Workbook",77900,82000,4100,5
TIKI,nha-sach-tiki,122848364,"EQ - Từ Âm Vô Cực Đến Dương Vô Cùng",110700,159000,48300,30
TIKI,nha-sach-tiki,29830245,"Thuật Thôi Miên Trong Giao Tiếp",70100,108000,37900,35
TIKI,nha-sach-tiki,50269973,"Biểu Tượng Thất Truyền (Tái Bản 2020)",144400,239000,94600,40
TIKI,nha-sach-tiki,520330,"Đất Máu Sicily (Mario Puzo)",79000,120000,41000,34
TIKI,nha-sach-tiki,185243205,"Tiếng Anh 10 Bright Student's Book (Sách học sinh)",69000,69000,0,0
TIKI,nha-sach-tiki,107034694,"Gọt Chì Mini Deli - Xanh Lá/Xanh Dương/Hồng/Vàng - 1 chiếc - E0531 - Màu ngẫu nhiên",5400,5400,0,0
TIKI,nha-sach-tiki,59043891,"Hố (Louis Sachar)(Tái Bản 2020)",52100,72000,19900,28
TIKI,nha-sach-tiki,185653966,"Tâm Lý Học Đám Đông",111650,149000,37350,25
TIKI,nha-sach-tiki,184781427,"Những Câu Hỏi Lớn Từ Người Phàm Trần Tí Hon Về Cái Chết",57200,79000,21800,28
TIKI,nha-sach-tiki,145144836,"Sách Bóc Dán Dành Cho Bé Gái - Những Nàng Tiên Chăm Chỉ",41100,55000,13900,25
TIKI,nha-sach-tiki,57318113,"Từ Điển Chính Tả Tiếng Việt ( Tác Phẩm Được Viện Ngôn Ngữ Học Thẩm Định)",58000,80000,22000,28
TIKI,nha-sach-tiki,57870430,"Trò Chuyện Với Thượng Đế (Tặng Kèm 01 Bookmark Một Mặt)",112000,159000,47000,30
TIKI,nha-sach-tiki,149409114,"Bổ Được Cà Chua, Mở Được Tiệm Cơm; Bật Được Nắp Chai, Mở Được Quán Nhậu (Tái Bản)",67750,105000,37250,35
TIKI,nha-sach-tiki,195801639,"Hế Lô Nyao - Tập 09",23300,25000,1700,7
TIKI,nha-sach-tiki,185786203,"Hộp đựng răng sữa cho bé bằng gỗ - Hộp đựng răng sữa kỷ niệm cho bé",54000,60000,6000,10
TIKI,nha-sach-tiki,157019700,"Thiệp chúc mừng sinh nhật 12x12 SDstationery SN2 STARRY họa tiết ngôi sao typography chữ viết tay đơn giản",56430,59400,2970,5
TIKI,nha-sach-tiki,196906879,"Máy Tính Khoa Học FX-880 BTG [ Siêu Máy Tính 2022",699000,699000,0,0
TIKI,nha-sach-tiki,74855017,"Quản Lý Tài Chính Cá Nhân Cho Phụ Nữ",110000,159000,49000,31
TIKI,nha-sach-tiki,192115854,"Ninja Rantaro - Tập 58 [Tặng Kèm Postcard]",38100,40000,1900,5
TIKI,nha-sach-tiki,176132392,"Truyện Thiếu Nhi Hạt Giống Tâm Hồn - Những Bông Hoa Hình Trái Tim",43200,56000,12800,23
TIKI,nha-sach-tiki,195623888,"Truyện tranh tuổi thần tiên - Cây táo thần",15000,15000,0,0
TIKI,nha-sach-tiki,584873,"Sách Kiến Tạo Thế Hệ Việt Nam Ưu Việt - John Vu",62100,88000,25900,29
TIKI,nha-sach-tiki,29290844,"Kho Tàng Truyện Thần Thoại Cổ Đại Trung Quốc (Không CD)",22000,22000,0,0
TIKI,nha-sach-tiki,73717906,"Khởi Nghiệp Công Nghệ - Máu Bẩn",150600,239000,88400,37
TIKI,nha-sach-tiki,13443851,"Cùng Khủng Long Học Tiếng Anh Theo Chủ Đề Lớp 1 (Tái Bản)",48100,68000,19900,29
TIKI,nha-sach-tiki,47273271,"Inbound Selling - Thay Đổi Phương Thức Bán Hàng Theo Mô Hình Inbound",116000,158000,42000,27
TIKI,nha-sach-tiki,447670,"Phép Tắc Của Loài Sói (Tái Bản 2015)",106999,106999,0,0
TIKI,nha-sach-tiki,51244265,"Lược Sử Kinh Tế Học",98500,135000,36500,27
TIKI,nha-sach-tiki,67060010,"Thực Đơn Ăn Dặm Kiểu Nhật",116000,168000,52000,31
TIKI,nha-sach-tiki,111285054,"Quẳng Gánh Lo Đi & Vui Sống (Tái Bản)",58000,86000,28000,33
TIKI,nha-sach-tiki,138396005,"Thiên Quan Tứ Phúc - Tập 2 (Tái Bản)",110700,159000,48300,30
TIKI,nha-sach-tiki,165098800,"My Hero Academia - Học Viện Siêu Anh Hùng - Tập 4: Cậu Bé Sinh Ra Với Tất Cả (Tái Bản 2022)",25000,25000,0,0
TIKI,nha-sach-tiki,189642774,"Thay Đổi Vận Mệnh Từ Bàn Tay",84000,128000,44000,34
TIKI,nha-sach-tiki,36399672,"Trò Đùa Của Sự Ngẫu Nhiên",115800,209000,93200,45
TIKI,nha-sach-tiki,111271564,"Vòng Xoáy Đi Lên - Đảo Chiều Trầm Cảm Từ Những Thay Đổi Nhỏ",98800,149000,50200,34
TIKI,nha-sach-tiki,66464344,"Sài Gòn Đất Và Người (Tái Bản 2020)",109000,165000,56000,34
TIKI,nha-sach-tiki,394438,"Giấy Excel A4 DL80 ",70000,70000,0,0
TIKI,nha-sach-tiki,2906447,"Series Địch Công Kỳ Án Tập 7 - Ngọc Xuyến Án",39000,91000,52000,57
TIKI,nha-sach-tiki,730782,"Tuần Của Bé Tháng 7 - Bé Trung Thực",11500,23000,11500,50
TIKI,nha-sach-tiki,5067155,"Nhật Ký Anne Frank (Tái Bản)",73000,98000,25000,26
TIKI,nha-sach-tiki,82041440,"Models: Quyến Rũ Phái Đẹp Bằng Cả Chân Tình",103000,160000,57000,36
TIKI,nha-sach-tiki,186578228,"Đời sống vỉa hè Sài Gòn",131000,169000,38000,22
TIKI,nha-sach-tiki,192377680,"Cách Dạy, Cách Học, Cách Sống Trong Thế Kỷ XXI: Khảo Sát Triết Lý Giáo Dục Của Dewey Và Makiguchi Để Đưa Ra Phương Thức Giáo Dục Mới Cho Nhân Loại",144000,145000,1000,1
TIKI,nha-sach-tiki,22634351,"Combo All The Rules Bình Tĩnh Khi Ế, Mạnh Mẽ Khi Yêu + Sống Bản Lĩnh Theo Cách Một Quý Cô (2 Cuốn)",132000,182000,50000,27
TIKI,nha-sach-tiki,80142837,"Hackers IELTS Basic- Listening",144800,229000,84200,37
TIKI,nha-sach-tiki,191655860,"Làm Đẹp Thuần Chay",102000,139000,37000,27
TIKI,nha-sach-tiki,191148802,"Tâm lý học giao tiếp",130000,189000,59000,31
TIKI,nha-sach-tiki,180400055,"Thất Lạc Cõi Người (Tái Bản 2022)",106250,106250,0,0
TIKI,nha-sach-tiki,74217686,"Gi Gỉ Gì Gi, Cái Gì Cũng Biết - 130 Bí Mật Vui Nhất Cho Tuổi Tiểu Học",86000,115000,29000,25
TIKI,nha-sach-tiki,196377993,"Sáng Mắt",99250,155000,55750,36
TIKI,nha-sach-tiki,107773093,"Hộp màu 150 chi tiết cho bé, bộ màu vẽ đa năng cho bé thỏa thích tô - MAU150",55900,55900,0,0
TIKI,nha-sach-tiki,76688366,"Leader Mindset - Thay Đổi Tư Duy Lãnh Đạo - LOAN VĂN SƠN",325000,500000,175000,35
TIKI,nha-sach-tiki,10144818,"20 bong bóng cao su nhiều màu",16000,16000,0,0
TIKI,nha-sach-tiki,196305161,"Cơ Thể Con Là Của Con (Tái bản 2022)",74100,75000,900,1
TIKI,nha-sach-tiki,188930500,"Người Bà Tài Giỏi Vùng Saga – Tập 5",40500,52000,11500,22
TIKI,nha-sach-tiki,174444190,"Người Bên Gối",90900,119000,28100,24
TIKI,nha-sach-tiki,77917794,"Từ Nước Mắt Đến Nụ Cười - Tận Cùng Khổ Đau Đến Ngời Sáng Tâm Hồn",104000,148000,44000,30
TIKI,nha-sach-tiki,541248,"Võ Nguyên Giáp - Những Năm Tháng Cuộc Đời (Tái Bản)",49400,82000,32600,40
TIKI,nha-sach-tiki,195306005,"Nhà thờ Đức Bà Paris (Bìa Cứng)",426000,650000,224000,34
TIKI,nha-sach-tiki,77988131,"Văn Học Kinh Điển - Thể Xác Và Tâm Hồn (Ấn Bản Phổ Thông - Bìa Cứng) [Tặng Kèm: Postcard + Bookmark]",179000,388000,209000,54
TIKI,nha-sach-tiki,32855400,"Tâm Lý Học Đám Đông (Tái Bản) ( tặng kèm bookmark Sáng Tạo )",111650,149000,37350,25
TIKI,nha-sach-tiki,179547036,"Bộ Sách Khởi Nghiệp Du Kích - Kinh Doanh Ít Vốn: Làm Thế Nào Để Khởi Động và Vận Hành Doanh Nghiệp Bằng Nguồn Vốn Hạn Hẹp",325000,567000,242000,43
TIKI,nha-sach-tiki,581983,"Việt Nam Sử Lược (Bản Đặc Biệt - Ấn Bản Kỉ Niệm 60 Năm NXB Kim Đồng)",177000,250000,73000,29
TIKI,nha-sach-tiki,15634596,"Búp Sen Xanh (Tái Bản)",72000,72000,0,0
TIKI,nha-sach-tiki,192161603,"Chú Thuật Hồi Chiến - Tập 5 - Bản Thường - Tặng Kèm Obi Và Thẻ Bo Góc Nhựa",29100,30000,900,3
TIKI,nha-sach-tiki,92096347,"Trở Về Từ Xứ Tuyết (Tái Bản)",63900,92000,28100,31
TIKI,nha-sach-tiki,195291853,"Kỳ Nghỉ Dưỡng Của Chàng Quý Tộc Ôn Hòa (Tập 3)",149000,196000,47000,24
TIKI,nha-sach-tiki,67120562,"Đây Là Leonardo Da Vinci",109000,150000,41000,27
TIKI,nha-sach-tiki,170490622,"Người Điều Khiển Mê Cung",106700,128000,21300,17
TIKI,nha-sach-tiki,10694902,"Tôi Tài Giỏi - Bạn Cũng Thế (Tái bản) + tặng kèm 1 bookmark",133500,133500,0,0
TIKI,nha-sach-tiki,169376042,"Từ Điển Tiếng Việt Hoàng Phê (Tái Bản)",495000,495000,0,0
TIKI,nha-sach-tiki,47504724,"Những Tấm Lòng Cao Cả (Tái Bản 2020)",59000,90000,31000,34
TIKI,nha-sach-tiki,195928317,"Hộp Bút Túi Đựng Bút Đồ Dùng Học Tập Đồ Dùng Cá Nhân Học Sinh Họa Tiết Vui Nhộn Deli -  Bóp Viết Phù Hợp Cho Học Sinh, Đựng Mĩ Phẩm - Màu Sắc Tươi Sáng",39000,81000,42000,52
TIKI,nha-sach-tiki,147265098,"Volume Profile - Góc nhìn từ người trong cuộc",209000,209000,0,0
TIKI,nha-sach-tiki,115702579,"Quảng Cáo Không Nói Láo - Sự Thật Về Quảng Cáo Dưới Góc Nhìn Khoa Học, Toàn Diện Và Thực Tiễn",169000,195000,26000,13
TIKI,nha-sach-tiki,71658956,"Full Combo (Bộ 10 cuốn) Ehon Kỹ năng - Âm thanh - Nhận biết",167440,322000,154560,48
TIKI,nha-sach-tiki,67060014,"Phát Triển Trí Tuệ Cảm Xúc - Con Được Là Chính Mình!",37100,50000,12900,26
TIKI,nha-sach-tiki,10271803,"Combo Ngữ Pháp Và Giải Thích Ngữ Pháp Tiếng Anh Cơ Bản Và Nâng Cao",280000,400000,120000,30
TIKI,nha-sach-tiki,195801321,"The One Thing - Điều Ý Nghĩa Nhất (Tái Bản 2022)",78000,119000,41000,34
TIKI,nha-sach-tiki,173406524,"Kẻ Lãng Quên - Pháp Y Tần Minh",163500,163500,0,0
TIKI,nha-sach-tiki,59321997,"Luận Về Đại Chiến Lược",150220,259000,108780,42
TIKI,nha-sach-tiki,13828940,"Văn Học Kinh Điển Thế Giới - Phù Thủy Xứ OZ",57000,88000,31000,35
TIKI,nha-sach-tiki,104074530,"Tôi, Tương Lai Và Thế Giới (Tái Bản)",103000,160000,57000,36
TIKI,nha-sach-tiki,76443018,"Lược Sử Triết Học",106000,142000,36000,25
TIKI,nha-sach-tiki,69908762,"Luyện viết chữ Hán Sơ cấp 1 (Theo Giáo trình Hán ngữ BOYA)",129000,250000,121000,48
TIKI,nha-sach-tiki,572247,"Chiến Thắng Kì Thi 9 Vào 10 Chuyên Vật Lý (Tập 1)",109000,189000,80000,42
TIKI,nha-sach-tiki,185055210,"Có Lẽ Bạn Nên Gặp Bác Sỹ Tâm Lý",185000,249000,64000,26
TIKI,nha-sach-tiki,94347312,"Cái Cười Của Thánh Nhân (Ts Thu Giang)(Tái Bản)",73000,105000,32000,30
TIKI,nha-sach-tiki,59362963,"Osho Đàn Ông - The Book Of Men",85200,119000,33800,28
TIKI,nha-sach-tiki,59291594,"100 Phương Pháp Thực Tiễn Để Cải Thiện Trải Nghiệm Khách Hàng",99000,150000,51000,34
TIKI,nha-sach-tiki,197531553,"Blue Period - Tập 4 - Tặng Kèm Bookmark Giấy",45600,48000,2400,5
TIKI,nha-sach-tiki,52004412,"D. Trump - Nghệ Thuật Đàm Phán (Tái bản 2020)",74000,109000,35000,32
TIKI,nha-sach-tiki,56819709,"Thiền Chữa Lành Thân Và Tâm (Tái Bản 2020)",67900,95000,27100,29
TIKI,nha-sach-tiki,176487508,"Trường Pháp Ở Việt Nam 1945 -1975",164400,249000,84600,34
TIKI,nha-sach-tiki,50322534,"Song Ngữ Việt - Anh - Diary Of A Wimpy Kid - Nhật Ký Chú Bé Nhút Nhát",76800,96000,19200,20
TIKI,nha-sach-tiki,49549966,"Ba Người Lính Ngự Lâm (Đông A) (Tái Bản)",164000,250000,86000,34
TIKI,nha-cua-doi-song,26387653,"KỆ ĐỂ GIÀY DÉP 3 TẦNG 80 CM",209000,300000,91000,30
TIKI,nha-cua-doi-song,183254388,"Ô (Dù) Tự Động 2 Chiều Cao Cấp Teement, Che Mưa, Che Nắng, Chống UV - Hàng Chính Hãng",170000,170000,0,0
TIKI,nha-cua-doi-song,6643347,"Phích Cắm Chuyển Đổi 3 Chấu Sang 2 Chấu",12000,12000,0,0
TIKI,nha-cua-doi-song,172950048,"Kệ Nhà Bếp Đa Năng, Kệ Để Lò Vi Sóng Chính Hãng IGA - GM05",213000,232000,19000,8
TIKI,nha-cua-doi-song,193081467,"Ghế Xoay Văn Phòng Lưới Làm Việc Công Thái Học Deli - Tay Gập Thông Minh, Có Chỉnh Lưng, Lưới Thoáng Khí, Chân Xoay Tiện Ích, Đệm Ghế Êm Aí, Nhiều Màu - Phù Hợp Học Sinh, Văn Phòng, Game Thủ, Gaming - Hàng chính hãng",886000,1978200,1092200,55
TIKI,nha-cua-doi-song,112068381,"Kệ Đa Năng, Kệ Để Đồ Black Kodo Phong Cách Hiện Đại - GM06",202000,220000,18000,8
TIKI,nha-cua-doi-song,121330266,"sét 10 bóng Đèn Led 3w Ánh Sáng Trắng",4000,4000,0,0
TIKI,nha-cua-doi-song,67932480,"Topper Everon White",899000,899000,0,0
TIKI,nha-cua-doi-song,163580111,"Bọ xiphong ống thoát chậu rửa chén siêu to",450000,450000,0,0
TIKI,nha-cua-doi-song,270862442,"Ổ Cắm Điện Đa Năng Chống Giật Có 3 Cổng USB, Sạc Trực Tiếp, Tiết Kiệm Điện – Bộ Ổ Cắm Điện Xanh Lá Cao Cấp Chính Hãng - (Model ngẫu nhiên)",69000,100000,31000,31
TIKI,nha-cua-doi-song,186693022,"Cây lau nhà tự vắt Kitimop-Red bàn lau lớn 38cm, con lăn trợ lực, thanh thép không gỉ, khớp xoay 360 độ, 2 bông lau",139000,225000,86000,38
TIKI,nha-cua-doi-song,78010514,"Timer hẹn giờ bật tắt điện tự động KG316T-II/25A/220V",67500,67500,0,0
TIKI,nha-cua-doi-song,144203367,"Bộ túi hộp cơm thủy tinh Lock&Lock 3EA LLG428S2IVY (LLG429Dx1, LLG428x1, HWB821GRYx1) - Màu",378000,726000,348000,48
TIKI,nha-cua-doi-song,74605907,"Khăn Tắm/Khăn Mặt Cotton Mềm Mại Thấm Hút Nước 34x75cm Nhanh Khô",33000,33000,0,0
TIKI,nha-cua-doi-song,73113608,"Bình PET Đựng Nước Tròn Có Vòi 10 Lít Duy Tân thân bình trong suốt giao quai màu ngẫu nhiên (Ø 20 x 40.2 cm) No.625 ",65000,65000,0,0
TIKI,nha-cua-doi-song,76545899,"Bộ Máy Khoan Mài khuôn Khắc mini Đa Năng 100 chi tiết 6 tốc độ Kiotool",545000,545000,0,0
TIKI,nha-cua-doi-song,208761326,"Chai xịt chuột thái land rat off",84000,84000,0,0
TIKI,nha-cua-doi-song,980512,"Cân Nhơn Hòa NHS-5 (5kg) - Hàng Chính Hãng",320000,320000,0,0
TIKI,nha-cua-doi-song,230013933,"Kệ Sách Để Bàn Phong Cách Nordic Thương Hiệu IGA - GP176",281000,305000,24000,8
TIKI,nha-cua-doi-song,182148476,"Combo Móc Dán Tường In Hình Họa Tiết Dễ Thương Loại Lớn PaKaSa - Hàng Chính Hãng ( Giao họa tiết ngẫu nhiên )",39000,58000,19000,33
TIKI,nha-cua-doi-song,122311338,"Nhang Nụ Trầm Hương tự nhiên khói chảy ngược - Hộp 40 nụ - Mùi thơm dịu nhẹ, không cay mắt, không kích mũi - Thiên Mộc Hương",261000,350000,89000,25
TIKI,nha-cua-doi-song,165705675,"Cọ vệ sinh Bình Giữ Nhiệt chuyên dụng, Cứng cáp, Đế gỗ",150000,150000,0,0
TIKI,nha-cua-doi-song,174128094,"SALE SỐC NỆM VĂN PHÒNG- ĐỆM NGỦ VĂN PHÒNG CHỐNG THẮM NƯỚC 75 X 180 X 3CM ( GIAO MÀU NGẪU NHIÊN )",259000,350000,91000,26
TIKI,nha-cua-doi-song,56247996,"Kệ sách mini bằng gỗ, để trên bàn làm việc hoặc bàn học. Hàng tự lắp ghép đa năng, thông minh. Gồm 3 màu đẹp hiện đại",50249,50249,0,0
TIKI,nha-cua-doi-song,125555122,"Bàn Học, Bàn Làm Việc Gấp Gọn Hiện Đại Thương Hiệu IGA - GP154",155000,169000,14000,8
TIKI,nha-cua-doi-song,191057553,"Ổ Cắm Điện Thông Minh USB Cao Cấp Jodily StarHome",185000,185000,0,0
TIKI,nha-cua-doi-song,59401658,"Cuộn Đèn LED Trang Trí Quấn Cây RGB Chống Nước, Dài 5M Kèm Remote 44 Phím",115000,115000,0,0
TIKI,nha-cua-doi-song,72652196,"Bộ túi hộp cơm thủy tinh Lock&Lock 3EA (LLG429Dx1,LLG428x1,BAG-HPL815SGRYx1) LLG428S2GRY - Màu",337000,649000,312000,48
TIKI,nha-cua-doi-song,77947848,"Kệ Chén Đĩa Thép Cao Cấp Sơn Đen Tĩnh Điện Kèm Khay Ráo Nước VANDO, Giá Kệ Úp Bát Đa Năng",429000,656000,227000,35
TIKI,nha-cua-doi-song,76658958,"Khăn Tắm Khách Sạn 5 sao – Cotton 100% - Sợi se đôi cao cấp – Thấm hút cực tốt - Kích thước lớn 70 x 140 cm có thể quấn quanh người",53888,53888,0,0
TIKI,nha-cua-doi-song,95043563,"Khăn tắm sợi tre Bamboo Life hàng chính hãng Khăn lau người mềm mại kháng khuẩn siêu thấm hút an toàn cho da ngay cả với trẻ sơ sinh BL046",65000,65000,0,0
TIKI,nha-cua-doi-song,160310283,"Găng Tay Tắm Funu Giúp Tẩy Tế Bào Chết, Làm Sạch Da - Giao Màu Ngẫu Nhiên",33000,33000,0,0
TIKI,nha-cua-doi-song,152521474,"Combo 200 Túi Lọc Rác Bồn Rửa Bát - Túi Lưới Lọc Rác Giúp Ngăn Chặn Tắc Đường Ống- Hàng Loại 1 - Chính Hãng MINIIN",56050,59000,2950,5
TIKI,nha-cua-doi-song,116681853,"Bình Giữ Nhiệt Lock&Lock Featherlight One-touch Tumbler 500ml LHC3257 - Hàng Chính Hãng - Tặng Kèm Ống Hút Inox",309000,537000,228000,42
TIKI,nha-cua-doi-song,116191376,"Nhang trầm hương tự nhiên Thiên Mộc Hương 30cm, Ít Khói, Thơm Nhẹ, Dễ Chịu, Không kích mũi",89000,150000,61000,41
TIKI,nha-cua-doi-song,169208802,"Vỏ gối chất liệu Cotton 40x60, 50x70 mềm mại siêu rẻ cho khách sạn, phòng ngủ, phòng trọ",30000,30000,0,0
TIKI,nha-cua-doi-song,194125082,"Khăn mặt sợi tre MORI xuất Nhật cao cấp 30x50cm",20900,38000,17100,45
TIKI,nha-cua-doi-song,125084260,"Vỏ gối ôm cotton tici Lidaco kích thước 35x100cm",35000,39000,4000,10
TIKI,nha-cua-doi-song,194005519,"Ghế Kê Chân Văn Phòng, Chịu lực 200 kg Plyconcept Seiza Chair - Gỗ Uốn Cong",160000,280000,120000,43
TIKI,nha-cua-doi-song,98804083,"Bóng Đèn Thông Minh TP-Link Tapo L530E Đa Sắc - Hàng Chính Hãng",199000,398000,199000,50
TIKI,nha-sach-tiki,145279201,"Sách Đường Xưa Mây Trắng - Theo Gót Chân Bụt (Tái bản năm 2020) (Bìa mềm/ Câu Chuyện Thú Vị Về Bụt/ Tặng Kèm Bookmark)",270650,270650,0,0
TIKI,nha-sach-tiki,19349136,"Sức Mạnh Tiềm Thức (Tái Bản)",102000,128000,26000,20
TIKI,nha-sach-tiki,186880675,"Thế Chiến Thứ Hai",435400,699000,263600,38
TIKI,nha-sach-tiki,191949999,"ĐẠO ĐỨC HỌC - SPINOZA",154000,268000,114000,43
TIKI,nha-sach-tiki,114937975,"Bóng Trăng Trắng Ngà - Bản Thường (Tặng Kèm: Bìa Áo + 1 Book Mark)",102000,129000,27000,21
TIKI,nha-sach-tiki,183539215,"Trần Triều Nhàn Thoại",80000,119000,39000,33
TIKI,nha-sach-tiki,192339430,"Tâm Lý Học Về Sự Tự Tôn",95100,129000,33900,26
TIKI,nha-sach-tiki,72511282,"Bộ Sách Tự Xóa Thông Minh - Bé Học Toán Mỗi Ngày (5 -7 tuổi) (Tặng Kèm Bút Xóa)",69500,89000,19500,22
TIKI,nha-sach-tiki,150997930,"Thế Giới Otome Game Thật Khắc Nghiệt Với Nhân Vật Quần Chúng - Tập 4",138000,179000,41000,23
TIKI,nha-sach-tiki,83757985,"Cao Thủ “Đổi Đen Thay Trắng” - Tập 2 (Dành Cho 18+)",111000,149000,38000,26
TIKI,nha-sach-tiki,68580163,"Sổ Tay Học Nhanh Toàn Diện Kiến Thức Và Dạng Bài Hóa Học Lớp  10 - 11 - 12",78000,119000,41000,34
TIKI,nha-sach-tiki,186286174,"Trại Hoa Vàng (Tái Bản 2022)",33000,50000,17000,34
TIKI,nha-sach-tiki,185909452,"Điệp Viên Hoàn Hảo X6 (Bìa Mềm)",124000,178000,54000,30
TIKI,nha-sach-tiki,71092794,"Thanh Gươm Diệt Quỷ - Tập 18: Kí Ức Trỗi Dậy",25000,25000,0,0
TIKI,nha-sach-tiki,186578985,"Hãy Yêu Đời Dẫu Đời Có Trái Ngang -Tặng kèm 01 Bookmark",68100,89000,20900,23
TIKI,nha-sach-tiki,63516905,"Boxset 4 Cuốn: Cá Voi Đêm Bão Và Những Câu Chuyện Khác…",142000,200000,58000,29
TIKI,nha-sach-tiki,184283143,"Combo 10 bìa nút túi hồ sơ tài liệu A4 loại dày màu tự chọn Deli - Phù hợp học sinh văn phòng - EF10412 / EF10432 / EF10442 / EF10452 / EF10462 / EF10472",12000,27000,15000,56
TIKI,nha-sach-tiki,193433940,"Tập luyện cổ họng – 5 phút 1 ngày giúp kéo dài 10 năm tuổi thọ",56400,79000,22600,29
TIKI,nha-sach-tiki,16391543,"Cha Voi - Dạy Con Nên Người Ở Thời Đại Số",97000,150000,53000,35
TIKI,nha-sach-tiki,8306438,"Combo Lược Sử Thời Gian và Vũ Trụ Trong Vỏ Hạt Dẻ",206350,206350,0,0
TIKI,nha-sach-tiki,16284262,"Tuổi Thơ Dữ Dội - Tập 2 (Tái Bản 2019)",58000,80000,22000,28
TIKI,nha-sach-tiki,2782635,"Nghệ Thuật Quản Lý Tài Chính Cá Nhân",111300,159000,47700,30
TIKI,nha-sach-tiki,69764547,"Hẹn Nhau Phía Sau Tan Vỡ",61400,86000,24600,29
TIKI,nha-sach-tiki,75630589,"Sách PACE Books - Tốc độ của niềm tin (The Speed Of Trust: The One Thing That Changes Everything) (Tái Bản) - Stephen M. R. Covey, Rebecca R. Merrill",140000,175000,35000,20
TIKI,nha-sach-tiki,173357306,"Sách 7 Thói Quen Tạo Gia Đình Hạnh Phúc",117000,168000,51000,30
TIKI,nha-sach-tiki,716891,"Mom's Letters: Alphabet",17000,18000,1000,6
TIKI,nha-sach-tiki,188533804,"Chuyện Dài Thành Chuyện Ngắn",103000,115000,12000,10
TIKI,nha-sach-tiki,75615221,"Combo 3 Cuốn Sách Ehon: Ai Giấu Cái Gì Đó (Dành Cho Trẻ Từ 0 - 4 Tuổi)",74100,117000,42900,37
TIKI,nha-sach-tiki,181699638,"Đất Tiền Đất Bạc",99000,150000,51000,34
TIKI,nha-sach-tiki,148937423,"Sách: Vì Sao Đơn Giản Lại Hiệu Quả",84500,130000,45500,35
TIKI,nha-sach-tiki,93249305,"Tư Duy Nhanh Và Chậm (Bản mới nhất 2020)",201000,269000,68000,25
TIKI,nha-sach-tiki,186267247,"Shaman King 11",34300,35000,700,2
TIKI,nha-sach-tiki,195801673,"Khoa Học Khám Phá - Vũ Trụ Trong Vỏ Hạt Dẻ (Tái Bản 2022)",73000,108000,35000,32
TIKI,nha-sach-tiki,966503,"Tuần Của Bé - Bé Lắng Nghe",11500,23000,11500,50
TIKI,nha-sach-tiki,186495460,"Những Bài Diễn Văn Làm Thay Đổi Thế Giới Từ 1945 Đến Nay",253000,340000,87000,26
TIKI,nha-sach-tiki,18002162,"Sách Thiếu Nhi - Truyện Tranh Mây Trắng và hành trình giải cứu Trái đất ",33250,35000,1750,5
TIKI,nha-sach-tiki,108261354,"Tự Học Ngữ pháp Tiếng Anh Bằng Mindmap Tập 1",108000,145000,37000,26
TIKI,nha-sach-tiki,164273180,"Dệt Nên Sự Sống: Khám Phá Bí Mật Cứu Tinh Của Thế Giới Tự Nhiên",84000,119000,35000,29
TIKI,nha-sach-tiki,196201375,"Sách - Bình Yên Trong Bão Tố",213750,225000,11250,5
TIKI,nha-sach-tiki,57708766,"Kẻ trừng phạt (Tái Bản 2020)",62500,125000,62500,50
TIKI,nha-cua-doi-song,108936951,"Bảng Gỗ Quy Tắc Gia Đình, Tranh Treo Tường Gia đình, Những Quy Tắc Để Con Có Cuộc Sống Hạnh Phúc",160000,160000,0,0
TIKI,nha-cua-doi-song,1611899,"Vợt Muỗi Điện Quang ĐQ EMR02 WR - Trắng Phối Đỏ",115855,136300,20445,15
TIKI,nha-cua-doi-song,57712474,"Keo dán đa năng trên mọi bề mặt 50ml+ Tặng kèm miếng dán nam châm",41000,41000,0,0
TIKI,nha-cua-doi-song,48488492,"Đèn Ngủ Hình Mèo Con Siêu Dễ Thương - Chất liệu Silicon Dẻo Cao Cấp An Toàn ",90000,157725,67725,43
TIKI,nha-cua-doi-song,117059826,"Giấy lọc cà phê Hario 100 cái (V60-VCF-02-100W)",99000,99000,0,0
TIKI,nha-cua-doi-song,79691104,"Bộ Hộp Cơm Giữ Nhiệt Văn Phòng Cao Cấp Cắm Điện inox 3 tầng - Chính Hãng",209000,300000,91000,30
TIKI,nha-cua-doi-song,48522643,"Nhiệt ẩm kế cao cấp TT-513 Nhật Bản, đo nhiệt độ phòng, độ ẩm không khí- sản phẩm cần thiết trong mỗi gia đình",197000,296000,99000,33
TIKI,nha-cua-doi-song,161030427,"Cây lau trần nhà, chổi quét trần nhà đa năng hình tam giác - Kitimop A3",149000,199000,50000,25
TIKI,nha-cua-doi-song,141143706,"Ly Giữ Nhiệt Cà Phê Nắp Trượt Chống Tràn Rinfere (295ml)",249000,349000,100000,29
TIKI,nha-cua-doi-song,111472777,"Miếng Dán Tường Đa Năng SenNai - Móc Dán Cây Lau Nhà Loại Tốt - Chịu Tải Lên Đến 5kg",17820,18000,180,1
TIKI,nha-cua-doi-song,178936441," Đũa Gỗ Mộc Hương Cao Cấp - Gỗ Tự Nhiên - Đánh Bóng Thủ Công - Không Ẩm Mốc - Vỉ 10 đôi ",135000,135000,0,0
TIKI,nha-cua-doi-song,94891198,"Hộp Cơm Giữ Nhiệt INOX304 Hiện Đại Kèm Hộp Đựng Canh Soup và Bộ Đũa Thìa INOX – Chất Liệu Cao Cấp An Toàn Cho Sức Khỏe – Hàng Chính Hãng Vinbuy",281000,500000,219000,44
TIKI,nha-cua-doi-song,183029245,"Mền lông cừu Caro cao cấp A kích thước 1m8 x 2m",195000,195000,0,0
TIKI,nha-cua-doi-song,198193045,"Khăn lau kính lau xe ma thuật không để lại vết mờ - Hàng cao cấp - Hàng hót 2022",16900,16900,0,0
TIKI,nha-cua-doi-song,162577287,"Cuộn Dây 5m/10m Đèn LED Trang Trí RGB 5050 Strip Light miDoctor, Quấn Cây Chống Nước, Trang Trí Phòng, Dán Tường, Bàn Máy Tính, Tạo Không Gian Quay Video Tiktok, Chụp Ảnh, Kèm Remote 44 Phím",115000,115000,0,0
TIKI,nha-cua-doi-song,104027916,"Bộ gối tựa lưng và đệm lót ghế chống đau xương cụt Ema loại có gel cao cấp cho dân văn phòng, lái xe, sinh viên",330000,660000,330000,50
TIKI,nha-cua-doi-song,73467694,"Kệ để lò vi sóng đa năng Inox 304 cao cấp Vando chính hãng kệ để đồ lò nướng chắc chắn, sơn tĩnh điện chống bong tróc, kệ nhà bếp siêu chịu lực 300kg",1099000,1099000,0,0
TIKI,nha-cua-doi-song,25055074,"Tủ vải quần áo 3 buồng 8 ngăn, khách được chọn màu,  khung sắt sơn tĩnh điện, vải không dệt",210000,210000,0,0
TIKI,nha-cua-doi-song,186348775,"Đệm ngồi ghế văn phòng chống đau xương cụt, ê mông, thâm mông, xệ mông cho dân văn phòng, lái xe, học sinh - Thương hiệu EMA - Loại cao cấp có gel tản nhiệt",285000,570000,285000,50
TIKI,nha-cua-doi-song,127152344,"Chổi Cọ Nhà Vệ Sinh Bồn Cầu Toilet Không Dây Đa Năng SENNAI Pin 4000mAh - Hàng Chính Hãng",129000,195000,66000,34
TIKI,nha-cua-doi-song,59500188,"Gối cổ chữ U cao su non Nice Food",115000,115000,0,0
TIKI,nha-cua-doi-song,121268576,"Ổ cắm điện 5 lỗ 2m Điện Quang SM750SL - Hàng Chính Hãng",168000,168000,0,0
TIKI,nha-cua-doi-song,143861521,"Dây Led Neon Flex 12V Kèm Nguồn Dài 1M/2M/3M/5M Trang Trí Cổ Điển",100000,100000,0,0
TIKI,nha-cua-doi-song,130769103,"Bộ 12 Hũ Thủy Tinh Sọc Làm Sữa Chua 100ml, Hũ Lọ Yaourt, Lọ Pudding, Hủ Làm Sữa Chua, Caramen- Có Nắp Đậy- Hàng Chính Hãng MINIIN",56000,65000,9000,14
TIKI,nha-cua-doi-song,191918105,"Bộ Bàn Chải Vệ Sinh Các Khe LocknLock ETM415 - 2 cái/bộ",20000,39000,19000,49
TIKI,nha-cua-doi-song,53098903,"Giá treo khăn - Vắt Khăn tắm, Giá treo khăn tắm inox 304 Đa năng 2 tầng, có móc treo quần áo Cao Cấp",380000,510000,130000,25
TIKI,nha-cua-doi-song,76451291,"Đèn Led Đom Đóm Dây Kẽm Dễ Uốn Kèm Pin CR2032",9999,9999,0,0
TIKI,nha-cua-doi-song,193541405,"Áo Mưa Bít Trẻ Em Cho Bé Cute Dễ Thương Siêu Dày Chống Thấm Nước Có Phản Quang Phơi Mau Khô Ráo Che Kín Người Kèm Túi Đựng Deli - Chất Liệu An Toàn Có Lựa Chọn Nhiều Size Màu Sắc",196000,340200,144200,42
TIKI,nha-cua-doi-song,134360863,"Vỉ 6 Viên Pin AA , Pin AAA Energizer Max 1,5V Alkaline - Hàng chính hãng",79000,90000,11000,12
TIKI,nha-cua-doi-song,192635575,"Combo Chén/ Bát gáo dừa + Muỗng gỗ dừa DK Harvest - Loại size lớn 12 - 14cm (Loại Xuất khẩu)",38000,38000,0,0
TIKI,nha-cua-doi-song,143363686,"Băng keo chống thấm x2000 Nhật Bản chống thấm dột, dán tường, dán mái tôn, dán ống nước",24000,40000,16000,40
TIKI,nha-cua-doi-song,200762341,"Cốc Giữ Nhiệt Ly Giữ Nhiệt Inox 304 Có Ống Hút Ly Uống Coffee 600ml",88312,88312,0,0
TIKI,nha-cua-doi-song,83927711,"Bịt Mắt Ngủ Che Mắt Ngủ Có Túi Gel Massage - Giảm Thâm Quầng Mắt - Mẫu Hoạt Hình Mới - Xanh Nhạt",35000,35000,0,0
TIKI,nha-cua-doi-song,184282768,"Combo 6 túi giặt 3 lớp bảo vệ quần áo, đồ lót dùng cho máy giặt chính hãng Dododios",149000,149000,0,0
TIKI,nha-cua-doi-song,69843631,"CÂY TREO QUẦN ÁO HÀN QUỐC GỖ LẮP RÁP- STANDING HANGER- BLUE HOME- MÀU GỖ TỰ NHIÊN",279000,279000,0,0
TIKI,nha-cua-doi-song,147694768,"găng tay làm bếp nấu ăn siêu dai Victoria Bay chất liệu TPE không mùi chống nhăn hộp 100 cái size M",11000,16998,5998,35
TIKI,nha-cua-doi-song,108918404,"GA GIƯỜNG THUN LẠNH MÀU TRƠN - Xám chì - Ga lẻ 1x2m nệm 5->15cm",100000,100000,0,0
TIKI,nha-cua-doi-song,135156091,"Tua vít bake thép 3*100mm",10000,10000,0,0
TIKI,nha-cua-doi-song,199263383,"Bàn Ăn Phong Cách Bắc Âu Đơn Giản Thương Hiệu IGA - GP181",485000,528000,43000,8
TIKI,nha-cua-doi-song,56228508,"Phân bón hữu cơ dịch chuối DOCNEEM, phân bón cho phong lan, hoa hồng, cây cảnh kích rễ, kích kei, chồi, mầm, chai 1 lít",119000,119000,0,0
TIKI,nha-cua-doi-song,162407831,"Kệ Để Máy Tính Kết Hợp Kệ Sách Đa Năng Hiện Đại Thương Hiệu IGA - GP184",176000,186000,10000,5
TIKI,nha-cua-doi-song,89198232,"Kệ Gia Vị Để Bàn Nora Cho Phòng Bếp Gọn Gàng - GM04",133000,146000,13000,9
TIKI,nha-cua-doi-song,51473042,"Kệ đa năng Tokyo 4 tầng hàng cao cấp",154000,154000,0,0
TIKI,nha-cua-doi-song,131145091,"Giá Sách Mini Tủ Đầu Giường Phong Cách Nordic Thương Hiệu IGA - GP156",221000,240000,19000,8
TIKI,nha-cua-doi-song,165594187,"Kệ Sách Để Bàn Có Hộc Đựng Tiện Lợi Thương Hiệu IGA - GP187",134000,134000,0,0
TIKI,nha-cua-doi-song,117138509,"Ổ cắm điện LiOA đa năng - 3 lỗ, 4 lỗ, 6 lỗ, 8 lỗ dây dài 3m/5m - Chính Hãng - MITA",92000,92000,0,0
TIKI,nha-cua-doi-song,44350764,"Combo 2 Thanh treo đồ dán tường,tủ quần áo, nhà bếp, có 6 móc chịu lực (giao màu ngẫu nhiên) GD263-MTSC-Thanh2",34899,34899,0,0
TIKI,nha-cua-doi-song,131498054,"Bóng đèn LED trụ Hi-lumen G3 PHILIPS E27 - Độ sáng cao, tiết kiệm điện, chất lượng ánh sáng vượt trội - Hàng Chính Hãng",134000,264000,130000,49
TIKI,nha-cua-doi-song,135507759,"Dây vòi hoa sen tắm nóng lạnh Pimisi bằng inox 304 với đầu dây đồng thau không gỉ phù hợp với mọi sen tắm trong nhà vệ sinh dài 150cm chống xoắn - mạ xi sáng bóng - ống mềm cấp nước và dùng được cho cả vòi xịt nhà vệ sinh phòng tắm | Hàng chính hãng",87000,120000,33000,28
TIKI,nha-cua-doi-song,158804921,"Gối ngủ cao su non vỏ sợi tre kháng khuẩn cao cấp cho người lớn EMA - Phong cách Nhật Bản - Chống đau mỏi cổ vai gáy, ngủ ngáy - KT 50x30x10cm",149000,298000,149000,50
TIKI,nha-cua-doi-song,52021508,"Bảng điện nổi V2 Điện Quang ĐQ FEP 32W 02S (màu trắng, 3 lỗ 2 chấu, 2 công tắc)",60000,81200,21200,26
TIKI,nha-cua-doi-song,96703757,"bàn làm việc - Nâu - 80x40x75cm",179999,179999,0,0
TIKI,nha-cua-doi-song,7221847,"Bộ Nồi Inox Sunhouse Mama cao cấp 5 đáy SH784 (16cm, 20cm, 24cm) - Dùng cho mọi loại bếp - Hàng chính hãng",858000,1340000,482000,36
TIKI,nha-cua-doi-song,35273810,"Keo vá tường,Keo trám vết nứt tường thông minh - Tặng kèm bộ dụng cụ",16051,16051,0,0
TIKI,nha-cua-doi-song,186440945,"Giá Sách Treo Tường Trang Trí FIVO Mã FB40 Không Cần Khoan Tặng Kèm Đinh 4 Chân Chịu Lực Lên Đến 10KG Với Móc Inox Dễ Dàng Gắn Lên Tường",42000,82000,40000,49
TIKI,nha-cua-doi-song,59318679,"Bộ Ga Gối Cotton Tici Kẻ LIDACO Cao Cấp - Caro Nâu Nhạt",159000,229000,70000,31
TIKI,nha-cua-doi-song,50775246,"Gối hơi du lịch, gối kê cổ du lịch, văn phòng tự bơm, gối hơi kê cổ đa năng, nhiều màu, giao ngẫu nhiên+ Tặng kèm hình dán",95000,95000,0,0
TIKI,nha-cua-doi-song,50339509,"Kệ sách gỗ để đồ đa năng 2 tầng kích thước 80*26*50 cm",159000,179000,20000,11
TIKI,nha-cua-doi-song,55630076,"Miếng lót ly bằng đất xốp Diatomite siêu hút nước, thông điệp ý nghĩa",55000,55000,0,0
TIKI,nha-cua-doi-song,182602992,"Khăn Tắm Gội Đầu Lau Mặt ROYAL TOWEL Dùng Cho Gia Đình Spa Khách Sạn 100% Cotton Thấm Hút Không Ra Màu",29000,29000,0,0
TIKI,nha-cua-doi-song,165758264,"Bộ dao 2 chiếc Eco Family Sunhouse KS-KN2E1",102000,163000,61000,37
TIKI,nha-cua-doi-song,139600248,"Miếng Tấm Pát Pad Thép Vuông Sửa Bản Lề Tủ Cửa Gỗ Lỗ Vít Door Hinge Repair Kit",10000,10000,0,0
TIKI,nha-cua-doi-song,58802544,"Hộp Cơm Giữ Nhiệt INOX304 Hiện Đại Tặng Kèm Túi Giữ Nhiệt",162630,208500,45870,22
TIKI,nha-cua-doi-song,208358660,"Ổ cắm điện LiOA đa năng - 3 lỗ, 4 lỗ, 6 lỗ, 8 lỗ dây dài 3m/5m - Chính Hãng - MITA",95000,95000,0,0
TIKI,nha-cua-doi-song,144582478," Dán Tường Để Đồ Đa Năng, Dán Tường Để Điện Thoại, Để Điều Khiển... - Giao màu ngẫu nhiên ",15000,15000,0,0
TIKI,nha-cua-doi-song,175147417,"Set 10 hộp nhựa chữ nhật mỏng đựng thực phẩm Đại Đồng Tiến 100% nhựa PP an toàn cho sức khỏe dùng được cho lò vi sóng",49020,51600,2580,5
TIKI,nha-cua-doi-song,191918103,"Dụng cụ rửa chai và ly LocknLock ETM143DGRY - Màu xám đen",41000,79000,38000,48
TIKI,nha-cua-doi-song,135442402,"Mỏ Hàn Điện Deli Chính Hãng 30W / 60W Chất Lượng Cao - Sử Dụng Đa Năng, Tiện Ích - DL8830 / DL8860",83000,142200,59200,42
TIKI,nha-cua-doi-song,113773790,"Bình Thủy Tinh 2 Lớp Pha Trà Doron MS79 - Cách Nhiệt Tốt - Có Lõi Lọc Inox 304 - Dung Tích 400ml - Hàng Loại 1",129000,129000,0,0
TIKI,nha-cua-doi-song,6710595,"Bộ 10 móc treo dán tường chịu lực 10kg",4000,30000,26000,87
TIKI,nha-cua-doi-song,12197016,"Bộ 280 Ống gen co nhiệt cách điện nhiều màu đủ size",28896,28896,0,0
TIKI,nha-cua-doi-song,23476097,"Ô Dù Che mưa Che Nắng Chống Tia UV (màu ngẫu nhiên)",28000,150000,122000,81
TIKI,nha-cua-doi-song,106385679,"Túi Giữ Nhiệt Đựng Hộp Cơm Văn Phòng Siêu Dày – Chọn Size – Giữ Nhiệt – 3 Lớp - Chống Thấm Cao Cấp Chính Hãng miDoctor",67000,67000,0,0
TIKI,nha-cua-doi-song,177744785,"Bộ lau nhà tách nước bẩn Kitimop K22 Plus có thùng lau nhà tự vắt 2 ngăn riêng biệt, chổi lau nhà xoay 360 độ lau sạch khô nhanh, 2 bông lau",459000,685000,226000,33
TIKI,nha-cua-doi-song,161455657,"Bóng đèn led 30W TAT",19000,19000,0,0
TIKI,nha-cua-doi-song,55481938,"Đồng hồ gỗ LED để bàn cao cấp - Gỗ đen led trắng - Hiển thị nhiệt độ",195000,195000,0,0
TIKI,nha-cua-doi-song,27948515,"Bộ 2 móc treo chổi, cây lau nhà dụng cụ tẩy rửa nhà tắm dán tường chống khuẩn tiết kiệm không gian chịu lực tối đa 5Kg",10899,10899,0,0
TIKI,nha-cua-doi-song,116571600,"Ga Chống Thấm Cotton LIDACO Cao Cấp - Hươu vàng - 1m4x2mxdưới12cm",149000,160000,11000,7
TIKI,nha-cua-doi-song,149387829,"Hộp Đựng Giấy Vệ Sinh Đa Năng 2 Tầng Treo Tường Cao Cấp - Có Ngăn Kéo Và Khe Cắm Điện Thoại, Ipad - Hàng Chính Hãng Nhập Khẩu",125000,159000,34000,21
TIKI,nha-cua-doi-song,116571619,"Ga Chống Thấm Cotton LIDACO Cao Cấp - Kẻ sao - 1m2x2mxdưới12cm",149000,200000,51000,26
TIKI,dien-thoai-may-tinh-bang,271046571,"Điện thoại Xiaomi Redmi Note 12 (8GB/128GB) - Hàng chính hãng",3790000,4530000,740000,16
TIKI,dien-thoai-may-tinh-bang,273947792,"Điện thoại AI Samsung Galaxy S24 Ultra 12GB/256GB, Camera 200MP Zoom 100x, S Pen- Đen- Hàng Chính Hãng",31990000,34490000,2500000,7
TIKI,dien-thoai-may-tinh-bang,273947785,"Điện thoại AI Samsung Galaxy S24+ 12GB/256GB, Camera 50MP, Màn hình 6.7"- Đen- Hàng Chính Hãng",25490000,27490000,2000000,7
TIKI,dien-thoai-may-tinh-bang,125182567,"Máy đọc sách All New Kindle Paperwhite 5 (11th Gen) - Hàng nhập khẩu",3690000,3690000,0,0
TIKI,dien-thoai-may-tinh-bang,173387789,"Máy đọc sách All New Kindle Oasis 3 - Hàng nhập khẩu",5790000,5790000,0,0
TIKI,dien-thoai-may-tinh-bang,74776150,"Máy đọc sách Kobo Libra H20 8GB Trắng/Đen có đèn nền vàng, chống nước - Hàng nhập khẩu",4499000,4499000,0,0
TIKI,dien-thoai-may-tinh-bang,170448099,"Điện Thoại Người Già Masstel Fami 60 4G - Loa To, FM Không Dây, Đọc Số Bằng Giọng Nói, SOS, Đèn Pin Kép,... Hàng Chính Hãng",679000,882000,203000,23
TIKI,dien-thoai-may-tinh-bang,167465704,"Điện thoại Masstel IZI 20 4G , Pin 1700 mAh - Hàng chính hãng",399000,499000,100000,20
TIKI,dien-thoai-may-tinh-bang,197666071,"Điện thoại Masstel Fami 65 4G - Tặng dock sạc - Gọi HD Call - Hàng chính hãng",656000,900000,244000,27
TIKI,dien-thoai-may-tinh-bang,209872337,"Máy đọc sách Kindle 2022 (11th) - All new kindle 2022 11th màn hình 6inch 300PPI gấp 2 lần độ sắc nét, 16GB bộ nhớ trong với cổng kết nối USB-C - Hàng nhập khẩu",2920000,2920000,0,0
TIKI,dien-thoai-may-tinh-bang,4048581,"Điện Thoại Bàn Panasonic KX-TSC11",689000,689000,0,0
TIKI,dien-thoai-may-tinh-bang,217645692,"Combo Máy đọc sách All New Kindle Paperwhite 5 (11th Gen) - 16Gb và Bao da - Hàng nhập khẩu",3980000,3980000,0,0
TIKI,dien-thoai-may-tinh-bang,117929342,"Điện thoại Panasonic KX-TSC11MX -Hàng chính hãng",599000,599000,0,0
TIKI,dien-thoai-may-tinh-bang,217706932,"Combo Máy đọc sách All New Kindle Paperwhite 5 (11th Gen) và Bao da - Hàng nhập khẩu",3980000,3980000,0,0
TIKI,dien-thoai-may-tinh-bang,176909016,"Máy tính bảng HANET Smart Edu Tablet Model T432 - Hàng Chính Hãng",3300000,3300000,0,0
TIKI,dien-thoai-may-tinh-bang,155833852,"Điện Thoại Masstel Hapi 30 3GB/32GB - Hàng Chính Hãng",1879000,2390000,511000,21
TIKI,dien-thoai-may-tinh-bang,194498804,"Máy Tính Bảng OPPO Pad Air (4GB/64GB) | Màn Hình 2K 1 tỷ Màu | Chip Snapdragon 680 | Hàng Chính Hãng",4990000,6990000,2000000,29
TIKI,dien-thoai-may-tinh-bang,43924153,"Máy đọc sách Kindle Oasis 3 (2019) - Amazon - Hàng nhập khẩu",5790000,5790000,0,0
TIKI,dien-thoai-may-tinh-bang,198111545,"Điện Thoại Vivo V25e 2022 (8GB/128GB) - Hàng Chính Hãng",8490000,8490000,0,0
TIKI,dien-thoai-may-tinh-bang,72290345,"Máy đọc sách Kobo Clara HD 8GB đen, 6 inch, có đèn cam - Hàng nhập khẩu",3099000,3099000,0,0
TIKI,dien-thoai-may-tinh-bang,16521748,"Điện thoại để bàn Panasonic KX-TS880 hàng chính hãng",1150000,1150000,0,0
TIKI,dien-thoai-may-tinh-bang,125753416,"Điện thoại Nokia 110 4G - Hàng chính hãng",740000,740000,0,0
TIKI,dien-thoai-may-tinh-bang,118486668,"Máy đọc sách Kobo Elipsa - Hàng nhập khẩu",12000000,12000000,0,0
TIKI,dien-thoai-may-tinh-bang,162866839,"Máy tính bảng VNPT Technology VNT Tab8 Plus 8 Inch Android 11 RAM 4GB - Hàng chính hãng",3146000,3146000,0,0
TIKI,dien-thoai-may-tinh-bang,272113804,"[MỚI] Điện thoại vivo Y17s - Hàng chính hãng - Camera 50MP - Pin 5000 mAh - Sạc nhanh- RAM mở rộng đến 8GB",3990000,3990000,0,0
TIKI,dien-thoai-may-tinh-bang,11251711,"Điện thoại bàn không dây Panasonic KX-TGD312 - Hàng Chính Hãng",2090000,2090000,0,0
TIKI,dien-thoai-may-tinh-bang,185755283,"Máy đọc sách Onyx Boox Nova Air - Hàng chính hãng",9860000,9860000,0,0
TIKI,dien-thoai-may-tinh-bang,23142193,"Điện thoại bàn không dây Panasonic KX-TGC313 - Hàng Chính Hãng",2100000,2100000,0,0
TIKI,dien-thoai-may-tinh-bang,270510406,"Điện thoại Vivo Y36 (8GB/128GB) - Hàng Chính Hãng - Camera 50MP - Sạc Nhanh 44W",5190000,5190000,0,0
TIKI,dien-thoai-may-tinh-bang,72310352,"Máy tính bảng Vankyo MatrixPad Z10 - Hàng Chính Hãng",2990000,2990000,0,0
TIKI,dien-thoai-may-tinh-bang,217640502,"Máy đọc sách Kindle Scribe - Hàng chính hãng",12590000,12590000,0,0
TIKI,dien-thoai-may-tinh-bang,192694043,"Điện thoại để bàn Panasonic KX-TS880 hàng chính hãng",1060000,1060000,0,0
TIKI,dien-thoai-may-tinh-bang,143359355,"Điện Thoại Tecno Spark 6 Go 4GB/64GB - Hàng Chính Hãng",2079000,2990000,911000,30
TIKI,dien-thoai-may-tinh-bang,214756058,"Máy đọc sách New Kindle 11th 2022 (16GB) - Hàng chính hãng",2920000,2920000,0,0
TIKI,dien-thoai-may-tinh-bang,140184098,"Điện Thoại Vsmart Bee Lite 2GB/16GB - Hàng Chính Hãng",999000,1990000,991000,50
TIKI,dien-thoai-may-tinh-bang,192859201,"Điện thoại Oukitel WP19(chống sốc ,chống nước ,Pin 21000mAh ,Ram 8G ,Rom 256G ,Tầm nhìn ban đêm 64MP ,  Máy ảnh 90Hz ,Điện thoại Helio G95 )-hàng chính hãng",9790000,9790000,0,0
TIKI,dien-thoai-may-tinh-bang,163875403,"ĐIỆN THOẠI MASSTEL IZI 55 4G-HÀNG CHÍNH HÃNG",650000,650000,0,0
TIKI,dien-thoai-may-tinh-bang,197966909,"Điện Thoại Samsung A04s 4GB/64GB - Hàng Chính Hãng",2669000,3990000,1321000,33
TIKI,dien-thoai-may-tinh-bang,160450655,"Điện Thoại Masstel Tab 10A 3GB/32GB - Hàng Chính Hãng",2939000,3790000,851000,22
TIKI,dien-thoai-may-tinh-bang,128895957,"Paperwhite 5 (11th-generation) - 2021 - Hàng Nhập Khẩu",3690000,3800000,110000,3
TIKI,dien-thoai-may-tinh-bang,136876846,"Máy Tính Bảng Samsung Galaxy Tab A7 3GB/64GB - Hàng Chính Hãng",4989000,7990000,3001000,38
TIKI,dien-thoai-may-tinh-bang,147969070,"Điện thoại thông minh itel A26 - giá rẻ | 2 Sim 2 Sóng 4G LTE | Màn hình IPS 5.7" HD+ | RAM 2GB + ROM 32 GB (Hỗ trợ thẻ nhớ 32 GB) | Mở khoá bằng Gương Mặt | Chính Hãng bảo hành 12 tháng| 1 đổi 1 trong 30 ngày",2390000,2390000,0,0
TIKI,dien-thoai-may-tinh-bang,62242668,"Điện Thoại Bàn Homephone lắp sim - Lắp Tất Cả Các Sim Đi Động - Di Chuyển Mang Đi Khắp Nơi - Hàng Chính Hãng",699000,699000,0,0
TIKI,dien-thoai-may-tinh-bang,151463645,"Điện thoại Bphone A60 (Ram 6Gb,Rom 128 Gb,màn hình đục lổ FHD 6.7inch , pin 5.000mAh ) - Hàng chính hãng",6490000,6490000,0,0
TIKI,dien-thoai-may-tinh-bang,242434782,"Máy đọc sách New Kindle 11th 2022 (16GB) - Hàng nhập khẩu",2920000,2920000,0,0
TIKI,dien-thoai-may-tinh-bang,125753291,"Điện thoại Nokia 105 4G - Hàng chính hãng",629000,629000,0,0
TIKI,dien-thoai-may-tinh-bang,197907038,"Điện thoại di động Vtel E10 4G – Hàng Chính Hãng",375000,399000,24000,6
TIKI,dien-thoai-may-tinh-bang,47292697,"Điện thoại bàn cổ điển DT40",2000000,2000000,0,0
TIKI,dien-thoai-may-tinh-bang,197651936,"Điện thoại Masstel Izi 25 4G Pin siêu khỏe, Gọi HD call- Hàng chính hãng",489000,599000,110000,18
TIKI,dien-thoai-may-tinh-bang,148701811,"Máy đọc sách Kobo Nia - Hàng nhập khẩu",2680000,2680000,0,0
TIKI,dien-thoai-may-tinh-bang,140144656,"Điện thoại Realme C25Y (4GB/128GB) - Hàng chính hãng",3599000,4990000,1391000,28
TIKI,dien-thoai-may-tinh-bang,193366048,"Điện thoại OnePlus 10T 5G - Hàng Chính Hãng",15990000,15990000,0,0
TIKI,dien-thoai-may-tinh-bang,158895857,"Điện thoại Vivo Y33s (8GB/128GB) - Hàng chính hãng",6069000,6069000,0,0
TIKI,dien-thoai-may-tinh-bang,72310420,"Máy tính bảng VANKYO MatrixPad S30 - Hàng Chính Hãng",3090000,3090000,0,0
TIKI,dien-thoai-may-tinh-bang,84757299,"Điện thoại Itel it9200 4G - Hàng chính hãng",590000,590000,0,0
TIKI,dien-thoai-may-tinh-bang,271046571,"Điện thoại Xiaomi Redmi Note 12 (8GB/128GB) - Hàng chính hãng",3790000,4530000,740000,16
TIKI,dien-thoai-may-tinh-bang,273947792,"Điện thoại AI Samsung Galaxy S24 Ultra 12GB/256GB, Camera 200MP Zoom 100x, S Pen- Đen- Hàng Chính Hãng",31990000,34490000,2500000,7
TIKI,dien-thoai-may-tinh-bang,273947785,"Điện thoại AI Samsung Galaxy S24+ 12GB/256GB, Camera 50MP, Màn hình 6.7"- Đen- Hàng Chính Hãng",25490000,27490000,2000000,7
TIKI,dien-thoai-may-tinh-bang,43924153,"Máy đọc sách Kindle Oasis 3 (2019) - Amazon - Hàng nhập khẩu",5790000,5790000,0,0
TIKI,dien-thoai-may-tinh-bang,173387789,"Máy đọc sách All New Kindle Oasis 3 - Hàng nhập khẩu",5790000,5790000,0,0
TIKI,dien-thoai-may-tinh-bang,184036446,"Apple iPhone 11",11390000,15999000,4609000,29
TIKI,dien-thoai-may-tinh-bang,184059211,"Apple iPhone 13",13990000,24990000,11000000,44
TIKI,dien-thoai-may-tinh-bang,183330021,"Apple iPad 10.2-inch (9th Gen) Wi-Fi 2021",6990000,10990000,4000000,36
TIKI,dien-thoai-may-tinh-bang,57809866,"Điện thoại Xiaomi Redmi 9A (2GB/32GB)",1690000,2490000,800000,32
TIKI,dien-thoai-may-tinh-bang,125182567,"Máy đọc sách All New Kindle Paperwhite 5 (11th Gen) - Hàng nhập khẩu",3950000,3950000,0,0
TIKI,dien-thoai-may-tinh-bang,125182567,"Máy đọc sách All New Kindle Paperwhite 5 (11th Gen) - Hàng nhập khẩu",4600000,4600000,0,0
TIKI,dien-thoai-may-tinh-bang,201067649,"Combo máy đọc sách Kindle Paperwhite 5 (11th gen) tặng kèm bao da ( Cover ) - Hàng nhập khẩu",3849000,4100000,251000,6
TIKI,dien-thoai-may-tinh-bang,252586291,"Máy đọc sách All New Kindle Paperwhite 5 (11th Gen) - Hàng chính hãng",3790600,3990000,199400,5
TIKI,dien-thoai-may-tinh-bang,214756058,"Máy đọc sách New Kindle 11th 2022 (16GB) - Hàng chính hãng",2920000,2920000,0,0
TIKI,dien-thoai-may-tinh-bang,242434782,"Máy đọc sách New Kindle 11th 2022 (16GB) - Hàng nhập khẩu",2920000,2920000,0,0
TIKI,dien-thoai-may-tinh-bang,120295859,"Điện Thoại Nokia C30 (2GB/32GB) - Hàng Chính Hãng",1490000,1990000,500000,25
TIKI,dien-thoai-may-tinh-bang,123345348,"Apple iPhone 12",11490000,16990000,5500000,32
TIKI,dien-thoai-may-tinh-bang,184248127,"Apple iPad mini (6th Gen) Wi-Fi 2021",11490000,14990000,3500000,23
TIKI,dien-thoai-may-tinh-bang,163914808,"Điện thoại bàn Panasonic  KX-TS500MX-hàng chính hãng",300000,300000,0,0
TIKI,dien-thoai-may-tinh-bang,252586291,"Máy đọc sách All New Kindle Paperwhite 5 (11th Gen) - Hàng chính hãng",3790600,3990000,199400,5
TIKI,dien-thoai-may-tinh-bang,209872337,"Máy đọc sách Kindle 2022 (11th) - All new kindle 2022 11th màn hình 6inch 300PPI gấp 2 lần độ sắc nét, 16GB bộ nhớ trong với cổng kết nối USB-C - Hàng nhập khẩu",2920000,2920000,0,0
TIKI,dien-thoai-may-tinh-bang,217640502,"Máy đọc sách Kindle Scribe - Hàng chính hãng",12590000,12590000,0,0
TIKI,dien-thoai-may-tinh-bang,217706932,"Combo Máy đọc sách All New Kindle Paperwhite 5 (11th Gen) và Bao da - Hàng nhập khẩu",3980000,3980000,0,0
TIKI,dien-thoai-may-tinh-bang,217645692,"Combo Máy đọc sách All New Kindle Paperwhite 5 (11th Gen) - 16Gb và Bao da - Hàng nhập khẩu",3980000,3980000,0,0
TIKI,dien-thoai-may-tinh-bang,272909668,"[Mới] Điện thoại vivo V29e 5G (8GB/256GB) - Hàng Chính Hãng - Camera Selfie 50 MP - Vòng Sáng Aura 2.0 - Màn hình AMOLED 6.67",8990000,8990000,0,0
TIKI,dien-thoai-may-tinh-bang,201067649,"Combo máy đọc sách Kindle Paperwhite 5 (11th gen) tặng kèm bao da ( Cover ) - Hàng nhập khẩu",3760000,3990000,230000,6
TIKI,dien-thoai-may-tinh-bang,139632023,"Máy đọc sách Kobo Libra 2 - hàng nhập khẩu",5199000,5800000,601000,10
TIKI,dien-thoai-may-tinh-bang,31261844,"Điện Thoại Bàn Cố Định Không Dây Lắp Sim",650000,650000,0,0
TIKI,dien-thoai-may-tinh-bang,173387789,"Máy đọc sách All New Kindle Oasis 3 - Hàng nhập khẩu",5790000,5790000,0,0
TIKI,dien-thoai-may-tinh-bang,197652030,"Điện thoại Masstel Lux 20 4G - Sang trọng - Gọi HD Call - Hàng chính hãng",567000,800000,233000,29
TIKI,dien-thoai-may-tinh-bang,181977398,"Điện thoại bàn Panasonic KX-TS880 hàng chính hãng",1050000,1050000,0,0
TIKI,dien-thoai-may-tinh-bang,197654695,"Điện thoại Masstel izi 26 4G - Gọi HD Call - Hàng chính hãng",489000,650000,161000,25
TIKI,dien-thoai-may-tinh-bang,189466001,"Điện thoại Xiaomi Redmi 10A (2GB/32GB) - Hàng chính hãng",1949000,2890000,941000,33
TIKI,dien-thoai-may-tinh-bang,173557858,"Máy tính bảng Kindle File HD 8 (10th generation - 2020) Hàng nhập khẩu",2250000,2250000,0,0
TIKI,dien-thoai-may-tinh-bang,197960169,"Điện thoại Masstel Lux 10 4G - Sang trọng - Gọi HD Call - Hàng chính hãng",538000,700000,162000,23
TIKI,dien-thoai-may-tinh-bang,125590981,"Điện thoại Nokia C30 2GB/32GB - Hàng chính hãng",1550000,1550000,0,0
TIKI,dien-thoai-may-tinh-bang,170165701,"Điện thoại bàn Ktel 645 hàng chính hãng",398000,398000,0,0
TIKI,dien-thoai-may-tinh-bang,42333095,"Điện thoại cố định không dây cho người già, màn hình hiển thị đầu số - Hàng chính hãng",490000,490000,0,0
TIKI,dien-thoai-may-tinh-bang,195317118," Máy tính bảng Oppo Pad Air (4GB/64GB) - Hàng Chính Hãng",4990000,6999000,2009000,29
TIKI,dien-thoai-may-tinh-bang,11415485,"ĐIỆN THOẠI CỐ ĐỊNH PANASONIC KX-TS580MX",940000,940000,0,0
TIKI,dien-thoai-may-tinh-bang,150724369,"Máy tính bảng Fire HD10 2021 - 11th - (All New Fire HD10 - 2021) - Ram 3/4GB, bộ nhớ 32GB, màn hình 1080 FullHD",3115000,3500000,385000,11
TIKI,dien-thoai-may-tinh-bang,43924153,"Máy đọc sách Kindle Oasis 3 (2019) - Amazon - Hàng nhập khẩu",5790000,5790000,0,0
TIKI,dien-thoai-may-tinh-bang,168526284,"Điện thoại Nokia 105 4G - Hàng chính hãng",675000,769000,94000,12
TIKI,dien-thoai-may-tinh-bang,126050455,"Điện thoại Nokia C20 (2GB/16GB) - Hàng Chính Hãng",1290000,2290000,1000000,44
TIKI,dien-thoai-may-tinh-bang,73842403,"Điện thoại bàn có dây nhỏ gọn màu trắng",250000,250000,0,0
TIKI,dien-thoai-may-tinh-bang,204237269,"Điện Thoại Bàn Panasonic KX-TSC11 - Hàng Chính Hãng - Trắng",600000,600000,0,0
TIKI,dien-thoai-may-tinh-bang,184578632,"Điện thoại Itel it9010 4G - Hàng chính hãng",399000,399000,0,0
TIKI,dien-thoai-may-tinh-bang,172329599,"Điện thoại Xiaomi Redmi 9A (2GB/32GB) - Hàng chính hãng",1754000,2199000,445000,20
TIKI,dien-thoai-may-tinh-bang,140940220,"Máy đọc sách Kobo Sage - hàng nhập khẩu",8679000,8679000,0,0
TIKI,dien-thoai-may-tinh-bang,29931445,"Ulefone Armor X 5 ( chống nước,chống va đập,pin 5.000mAh ) hàng chính hãng",3990000,3990000,0,0
TIKI,dien-thoai-may-tinh-bang,270794184,"Máy đọc sách Kobo Clara - Hàng Chính Hãng",2899000,2925000,26000,1
TIKI,dien-thoai-may-tinh-bang,121744434,"Điện Thoại Xiaomi Redmi 10 4GB/128GB - Hàng Chính Hãng",2949000,4290000,1341000,31
TIKI,dien-thoai-may-tinh-bang,181452535,"Điện thoại Itel it9200 4G - WIFI - Xem YTB , FB - Hàng chính hãng",547000,790000,243000,31
TIKI,dien-thoai-may-tinh-bang,181266509,"Điện thoại Ulefone Armor 14 pro (chống nước,chống va đập,pin khủng,pin 10.000mAh,Ram 8Gb,Rom 128Gb)- hàng chính hãng",5990000,5990000,0,0
TIKI,dien-thoai-may-tinh-bang,167466044,"Điện thoại Masstel FAMI 60 4G Pin 2000 mah - Hàng chính hãng",636000,750000,114000,15
TIKI,nha-cua-doi-song,116571657,"Ga Chống Thấm Cotton LIDACO Cao Cấp - Kitty hồng - 2m2x2mxdưới12cm",199000,217000,18000,8
TIKI,nha-cua-doi-song,116571660,"Ga Chống Thấm Cotton LIDACO Cao Cấp - Kẻ sao - 1m6x2mxdưới12cm",149000,179000,30000,17
TIKI,nha-cua-doi-song,116571721,"Ga Chống Thấm Cotton LIDACO Cao Cấp - Cá đĩa - 1m4x2mxdưới12cm",149000,189000,40000,21
TIKI,nha-cua-doi-song,116571707,"Ga Chống Thấm Cotton LIDACO Cao Cấp - Baby shark - 2m2x2mxdưới12cm",199000,213000,14000,7
TIKI,nha-cua-doi-song,116571729,"Ga Chống Thấm Cotton LIDACO Cao Cấp - Cá đĩa - 1m8x2mxdưới12cm",155000,300000,145000,48
TIKI,nha-cua-doi-song,116571693,"Ga Chống Thấm Cotton LIDACO Cao Cấp - Baby shark - 1m4x2mxdưới12cm",149000,184000,35000,19
TIKI,nha-cua-doi-song,116571742,"Ga Chống Thấm Cotton LIDACO Cao Cấp - Cá đĩa - 2m2x2mxdưới12cm",199000,226000,27000,12
TIKI,nha-cua-doi-song,116571731,"Ga Chống Thấm Cotton LIDACO Cao Cấp - Thỏ bé - 1m4x2mxdưới12cm",149000,160000,11000,7
TIKI,nha-cua-doi-song,116571649,"Ga Chống Thấm Cotton LIDACO Cao Cấp - Kitty hồng - 1m2x2mxdưới12cm",149000,217000,68000,31
TIKI,nha-cua-doi-song,116571625,"Ga Chống Thấm Cotton LIDACO Cao Cấp - Dâu nhật - 1m4x2mxdưới12cm",149000,154000,5000,3
TIKI,nha-cua-doi-song,116571685,"Ga Chống Thấm Cotton LIDACO Cao Cấp - Cá đĩa - 1m2x2mxdưới12cm",149000,189000,40000,21
TIKI,nha-cua-doi-song,116571735,"Ga Chống Thấm Cotton LIDACO Cao Cấp - Thỏ bé - 1m6x2mxdưới12cm",149000,179000,30000,17
TIKI,nha-cua-doi-song,116571671,"Ga Chống Thấm Cotton LIDACO Cao Cấp - Kẻ sao - 2m2x2mxdưới12cm",199000,226000,27000,12
TIKI,nha-cua-doi-song,116571597,"Ga Chống Thấm Cotton LIDACO Cao Cấp - Hươu vàng - 1m2x2mxdưới12cm",149000,160000,11000,7
TIKI,nha-cua-doi-song,129144356,"Ga Chống Thấm Cotton LIDACO Cao Cấp - Lông vũ - 1m2x2mxdưới12cm",149000,189000,40000,21
TIKI,nha-cua-doi-song,116571710,"Ga Chống Thấm Cotton LIDACO Cao Cấp - Baby shark - 1m6x2mxdưới12cm",149000,159000,10000,6
TIKI,nha-cua-doi-song,116571727,"Ga Chống Thấm Cotton LIDACO Cao Cấp - Cá đĩa - 1m6x2mxdưới12cm",149000,179000,30000,17
TIKI,nha-cua-doi-song,116571699,"Ga Chống Thấm Cotton LIDACO Cao Cấp - Baby shark - 1m8x2mxdưới12cm",155000,200000,45000,23
TIKI,nha-cua-doi-song,116571623,"Ga Chống Thấm Cotton LIDACO Cao Cấp - Kitty hồng - 1m4x2mxdưới12cm",149000,189000,40000,21
TIKI,nha-cua-doi-song,116571667,"Ga Chống Thấm Cotton LIDACO Cao Cấp - Baby shark - 1m2x2mxdưới12cm",149000,154000,5000,3
TIKI,nha-cua-doi-song,116571741,"Ga Chống Thấm Cotton LIDACO Cao Cấp - Thỏ bé - 1m2x2mxdưới12cm",149000,250000,101000,40
TIKI,nha-cua-doi-song,217736127,"Ga Chống Thấm Cotton LIDACO Cao Cấp - San hô",149000,250000,101000,40
TIKI,nha-cua-doi-song,116571663,"Ga Chống Thấm Cotton LIDACO Cao Cấp - Kẻ sao - 1m8x2mxdưới12cm",155000,200000,45000,23
TIKI,nha-cua-doi-song,116571716,"Ga Chống Thấm Cotton LIDACO Cao Cấp - Thỏ bé - 1m8x2mxdưới12cm",155000,242000,87000,36
TIKI,nha-cua-doi-song,116571655,"Ga Chống Thấm Cotton LIDACO Cao Cấp - Kẻ sao - 1m4x2mxdưới12cm",149000,189000,40000,21
TIKI,nha-cua-doi-song,116571607,"Ga Chống Thấm Cotton LIDACO Cao Cấp - Phong lan - 1m4x2mxdưới12cm",149000,189000,40000,21
TIKI,nha-cua-doi-song,116571627,"Ga Chống Thấm Cotton LIDACO Cao Cấp - Dâu nhật - 1m6x2mxdưới12cm",149000,179000,30000,17
TIKI,nha-cua-doi-song,164158123,"Vỉ 2 Viên Pin Duracell CR2032 / CR2025 / CR2016 Lithium 3V - Hàng chính hãng",60000,60000,0,0
TIKI,nha-cua-doi-song,101841654,"Đàn Kalimba Cega 17 phím gỗ nguyên tấm Mahogany",290000,290000,0,0
TIKI,nha-cua-doi-song,19423384,"Bộ võng xếp BAN MAI: sơn tĩnh điện và lưới thép số 9 (Giao màu ngẫu nhiên)",619000,920000,301000,33
TIKI,nha-cua-doi-song,116571603,"Ga Chống Thấm Cotton LIDACO Cao Cấp - Dâu nhật - 1m8x2mxdưới12cm",155000,291000,136000,47
TIKI,nha-cua-doi-song,186645870,"Máy Bắn Keo Nến Deli - Phù hợp DIY Làm Đồ Handmade Thủ Công - An Toàn, Nhỏ Gọn, Dễ Sử Dụng - DL390120",79000,171000,92000,54
TIKI,nha-cua-doi-song,57146868,"máy đồng hồ treo tường kim trôi ja-pan",59000,59000,0,0
TIKI,nha-cua-doi-song,96209890,"Dụng cụ thông ống thoát nước chuyên nghiệp có tay cầm - Độ dài dây lò xo: 5m",153400,153400,0,0
TIKI,nha-cua-doi-song,118680989,"Set nến thơm hộp quà thắt nơ – xinh xắn phù hợp làm quà tặng bạn gái",100000,100000,0,0
TIKI,nha-cua-doi-song,116571687,"Ga Chống Thấm Cotton LIDACO Cao Cấp - Thỏ bé - 2m2x2mxdưới12cm",199000,250000,51000,20
TIKI,nha-cua-doi-song,116571602,"Ga Chống Thấm Cotton LIDACO Cao Cấp - Hươu vàng - 1m6x2mxdưới12cm",149000,169000,20000,12
TIKI,nha-cua-doi-song,36300228,"Bộ Móc treo chữ S, có 3 size chọn lựa",21400,21400,0,0
TIKI,nha-cua-doi-song,69741184,"Thanh treo inox cao cấp không cần khoan tường, siêu chắc chắn, khả năng chịu tải cao HT07",149000,149000,0,0
TIKI,nha-cua-doi-song,189492088,"Nhang Sen Thuần Khiết Liên Tâm 29cm 200 cây - Ít khói, dịu nhẹ, 100% Đài sen thiên nhiên",99750,99750,0,0
TIKI,nha-cua-doi-song,135720334,"Bình pha trà cafe French Press Lock&Lock, 800ml - LLG018",169000,255000,86000,34
TIKI,nha-cua-doi-song,136855573,"Xe Kéo Hàng, Xe Đẩy Hàng Gấp Gọn Nhập Khẩu Chất Lượng Cao XKT04 Mới",559000,559000,0,0
TIKI,nha-cua-doi-song,69226574,"Combo 10 viên pin CR2032 Maxell Nhật Bản",31790,31790,0,0
TIKI,nha-cua-doi-song,25140473,"KỆ LÒ VI SÓNG 3 TẦNG Dài 60cm x Cao 80cm",229000,350000,121000,35
TIKI,nha-cua-doi-song,89144285,"Cốc Dán Tường Nhà Tắm Hình Gấu Nâu Dễ Thương - Cốc Đựng Bàn Chải Đánh Răng - Cốc Hình Gấu",6897,6897,0,0
TIKI,nha-cua-doi-song,79323009,"Tủ Sách Đa Năng Conven Phong Cách Nordic Thương Hiệu IGA",632000,689000,57000,8
TIKI,nha-cua-doi-song,204207230,"Nhang nụ trầm hương đốt xông nhà tẩy uế HÀ XÁ đồ thờ cúng phong thủy, xua đuổi vận xui, thu hút nguồn năng lượng tích cực, thanh lọc không khí, an toàn cho sức khỏe",99000,198000,99000,50
TIKI,nha-cua-doi-song,57911829,"GỐI MỀN 3 trong 1 Trái Cây hình thú cute, thun 4 chiều siêu mịn, bộ chăn gối văn phòng, gấu bông kèm mền GM74-Chuotfruit",158748,158748,0,0
TIKI,nha-cua-doi-song,202840456,"Kệ Lò Vi Sóng Effect Đa Năng - GM02",128000,139000,11000,8
TIKI,nha-cua-doi-song,168234677,"[Hàng chính hãng] Ghế chỉnh dáng ngồi đúng - Curble Wider_Premium Model Hàn Quốc (Made in Korea). Phù hợp mọi đối tượng (Free Size)",699840,729000,29160,4
TIKI,nha-cua-doi-song,578902,"Chảo Đáy Từ Chống Dính Sunhouse SHM26 26cm",207000,300000,93000,31
TIKI,nha-cua-doi-song,57755151,"Đèn đường năng lượng mặt trời 300W",760000,760000,0,0
TIKI,nha-cua-doi-song,72527573,"Hộp Đựng Giấy Vệ Sinh Cao Cấp OENON Dán Tường, Hộp Đựng Giấy Đa Năng Có Thêm Ngăn Để Đồ Tiện Lợi - OENON",149000,280000,131000,47
TIKI,nha-cua-doi-song,57046106,"Bình Đựng Nước Lock&Lock Easy Grip Dung Tích 1.5L HAP814",48000,77000,29000,38
TIKI,nha-cua-doi-song,1918931,"Keo Dán Đa Năng Selleys Epoxy Fix (10ml / Tuýp)",37050,39000,1950,5
TIKI,nha-cua-doi-song,87831027,"ĐÈN NĂNG LƯỢNG MẶT TRỜI 100W - 180W - 80W - 60W - 45W  SOLAR LIGHT - ĐIỀU KHIỂN TỪ XA - PIN SẠC TRỌN DỜI - D1147",290000,290000,0,0
TIKI,nha-cua-doi-song,193777239,"Cưa cành cây cưa gỗ gấp gọn bằng thép không gỉ sản xuất tại NHẬT BẢN",25000,50000,25000,50
TIKI,nha-cua-doi-song,55580718,"Bộ 3 Nồi Inox 304 Đáy Từ 5 Đáy Nagakawa NAG1352 (16cm, 20cm, 24cm) - Hàng Chính Hãng",1000000,1890000,890000,47
TIKI,nha-cua-doi-song,75330721,"Then Chốt Cài Cửa, Chốt Khóa Bằng Thép Không Gỉ KUNBE An Toàn Tiện Lợi Nhiều Kích Thước",22900,22900,0,0
TIKI,nha-cua-doi-song,52004331,"Kệ lò nướng - Kệ lò vi sóng - kệ nhà bếp đa năng bằng gỗ thông tự nhiên 4 tầng kích thước 60 x 40 x 110 cm",319000,450000,131000,29
TIKI,nha-cua-doi-song,21268314,"Ổ cắm điện chuyển đổi đa chức năng dùng khi xuất ngoại, đi du lịch,...",35000,35000,0,0
TIKI,nha-cua-doi-song,146260986,"Nồi inox kho cá thịt chống dính bếp từ Fivestar ( 18cm / 20cm / 22cm ) nắp kính , 3 đáy , inox 430 , tặng 1 vá canh",197000,197000,0,0
TIKI,nha-cua-doi-song,48622915,"Bộ Đầu Vòi Xịt Vệ Sinh (Toilet), Vệ Sinh Bồn Cầu + Giá Đỡ - Thiết kế Thông Minh Nhỏ Gọn Tiện Ích",55000,69000,14000,20
TIKI,nha-cua-doi-song,125739804,"BỘ CÂY LAU NHÀ THÔNG MINH SAGOKER, mã BLNEC",146000,159999,13999,9
TIKI,nha-cua-doi-song,117560257,"CHẢO CHỐNG DÍNH SÂU LÒNG SIÊU TIỆN LỢI",33999,33999,0,0
TIKI,nha-cua-doi-song,103755910,"Ghế tatami, ghế lười bệt tựa lưng nệm - Có 5 cấp độ ngã lưng - Chính hãng TIDO",390000,390000,0,0
TIKI,nha-cua-doi-song,156222332,"SEN TẮM CÂY NÓNG LẠNH NHẬP KHẨU NGA FULLBOX F2428 - HÀNG CHÍNH HÃNG - SIÊU BỀN BỈ",2491000,4700000,2209000,47
TIKI,nha-cua-doi-song,21482254,"Bàn gấp chân sắt 1m2 BVP23Đ",396900,490000,93100,19
TIKI,nha-cua-doi-song,7159593,"Khóa số chống trộm an toàn Royal",32000,32000,0,0
TIKI,nha-cua-doi-song,158462914,"Cây Lau Kính, Gạt Chùi Kính Đa Năng 2 Đầu Trong 1 MyJae Cán Dài Uốn Xoay Thông Minh Chống Trơn Trượt",239000,390000,151000,39
TIKI,nha-cua-doi-song,142441475,"Hộp Sấy Và Khử Khuẩn Đũa Thìa Muỗng Thông Minh,  Có Nắp Đậy Cao Cấp Chống Côn Trùng, Kiến, Dán Tường Chắc Chắn- Hàng Loại 1 Chính Hãng MINIIN",229000,229000,0,0
TIKI,nha-cua-doi-song,24482769,"Dây xịt vệ sinh inox 304 dài 120cm",54000,60000,6000,10
TIKI,nha-cua-doi-song,196051243,"Búa Lùn Nguyên Khối Deli Chính Hãng - Đóng Đinh, Nhổ Đinh Dễ Dàng, Tiện Dụng - Nhỏ Gọn, Tay Cầm Bọc Cao Su - DL441008",62000,106000,44000,42
TIKI,nha-cua-doi-song,172143534,"Kệ Gỗ Để Đồ Đa Năng Có Bánh Xe Di Chuyển Dễ Dàng - GP190",216000,235000,19000,8
TIKI,nha-cua-doi-song,48287902,"KỆ GIÀY DÉP 2 TẦNG GỖ THÔNG- Dài 50cm x Cao 50cm",109000,169000,60000,36
TIKI,nha-cua-doi-song,272035598,"HỘP 10 ĐÔI ĐŨA INOX 304 - CAO CẤP - SANG TRỌNG - NGUYÊN KHỐI INOX 304",235000,235000,0,0
TIKI,nha-cua-doi-song,54156958,"Pin Sạc Energizer AAA 700mAh Power Plus",157000,160000,3000,2
TIKI,nha-cua-doi-song,117125057,"Ổ Cắm Điện LiOA Phổ Thông - Ổ Cắm Điện 3 lỗ - 4 lỗ - 5 lỗ - 6 lỗ - dài 3m - MITA",65000,65000,0,0
TIKI,nha-cua-doi-song,125604026,"Dây Treo Trang Trí Noel Dài 3m",25000,25000,0,0
TIKI,nha-cua-doi-song,165844799,"Giá Kệ Sách Để Sàn 5 Tầng Gỗ Cao Cấp Màu Trắng FIVO Mã FB70 Gỗ MDF Phủ Melamine Chống Thấm Bề Mặt Phù Hợp Với Nhiều Không Gian",749000,1168000,419000,36
TIKI,dien-thoai-may-tinh-bang,15428119,"Điện thoại Ip phone Cisco CP-7945G chính hãng",4500000,4500000,0,0
TIKI,dien-thoai-may-tinh-bang,52481412,"Điện thoại bàn cổ điển, điện thoại bàn tân cổ điển, DT122",2200000,2200000,0,0
TIKI,dien-thoai-may-tinh-bang,23865953,"Điện Thoại Để Bàn Panasonic KX-TS500MX - Hàng Chính Hãng",299000,299000,0,0
TIKI,dien-thoai-may-tinh-bang,172537996,"(Hàng chính hãng) Điện thoại bàn hữu tuyến H2P, hiệu Alcatel - Lucent",2220000,2220000,0,0
TIKI,dien-thoai-may-tinh-bang,29446449,"Điện thoại không dây IP 622CW ",1850000,1850000,0,0
TIKI,dien-thoai-may-tinh-bang,252884859,"Tay con điện thoại bàn Panasonic TGDA30-hàng chính hãng",990000,990000,0,0
TIKI,dien-thoai-may-tinh-bang,271152577,"Điện Thoại Samsung Galaxy Z Flip5 5G - Hàng Chính Hãng - Đã kích hoạt bảo hành điện tử",29490000,29490000,0,0
TIKI,dien-thoai-may-tinh-bang,274568845,"Điện thoại Xiaomi 14 5G (12GB/256GB) - Hàng chính hãng",22990000,22990000,0,0
TIKI,dien-thoai-may-tinh-bang,273897590,"Điện thoại Tecno SPARK 20c (8+8)GB/128GB - MTK G36 | 5000 mAh | Sạc nhanh 18W | Hàng Chính Hãng",2490000,2690000,200000,7
TIKI,dien-thoai-may-tinh-bang,273685412,"Điện thoại Samsung Galaxy A25 5G (6GB/128GB) - Hàng chính hãng",6590000,6590000,0,0
TIKI,dien-thoai-may-tinh-bang,274440344,"Điện thoại Xiaomi Redmi Note 13 pro (8GB - 128GB) hàng chính hãng - Bảo hành 18 tháng",6490000,6790000,300000,4
TIKI,dien-thoai-may-tinh-bang,273955111,"Điện Thoại Oppo Reno 10 5G (8GB/128GB) - Hàng Chính Hãng",7650000,8990000,1340000,15
TIKI,dien-thoai-may-tinh-bang,247730209,"Điện thoại Samsung Galaxy A34 5G (8GB/128GB) - Hàng chính hãng",7164000,7164000,0,0
TIKI,dien-thoai-may-tinh-bang,253443894,"Điện Thoại Samsung Galaxy M14 5G (4GB/128GB) - Hàng Chính Hãng",4212000,4212000,0,0
TIKI,dien-thoai-may-tinh-bang,271822675,"Máy Tính Bảng Samsung Galaxy Tab A8 - Hàng Chính Hãng",5856000,5856000,0,0
TIKI,dien-thoai-may-tinh-bang,249168949,"Điện thoại Samsung Galaxy A34 5G 8GB/128GB Bạc - Hàng chính hãng",7164000,7164000,0,0
TIKI,dien-thoai-may-tinh-bang,204872160,"Điện thoại Oppo A17k (3GB/64GB) - Hàng chính hãng",3290000,3290000,0,0
TIKI,dien-thoai-may-tinh-bang,249178196,"Điện thoại Samsung Galaxy A34 5G 8GB/128GB Xanh - Hàng chính hãng",7600000,8490000,890000,10
TIKI,dien-thoai-may-tinh-bang,192348147,"Điện thoại Oppo A57 (4GB/64GB) - Hàng chính hãng",4284000,4284000,0,0
TIKI,dien-thoai-may-tinh-bang,160434731,"Máy Tính Bảng Samsung Galaxy Tab A8 4GB/64GB - Hàng Chính Hãng",5856000,5856000,0,0
TIKI,dien-thoai-may-tinh-bang,244355503,"Điện thoại Samsung Galaxy A04s (4GB/64BG) - Hàng chính hãng",3990000,3990000,0,0
TIKI,dien-thoai-may-tinh-bang,262589811,"Điện thoại Samsung Galaxy A24 (6GB/128GB) - Hàng chính hãng - ĐÃ KÍCH HOẠT BẢO HÀNH ĐIỆN TỬ",6084000,6084000,0,0
TIKI,dien-thoai-may-tinh-bang,249730344,"Điện thoại Masstel IZI 12 4G LTE - 2 Sim 2 Sóng - Pin 1000 mAh - Loa to - Hàng Chính Hãng - Bảo Hành 12 Tháng",456000,456000,0,0
TIKI,dien-thoai-may-tinh-bang,273360836,"Điện thoại Ulefone armor 22(chống nước,chống va đập, Màn hình giọt nước 6,58 inch, RAM:8GB,Rom 128GB/256GB,Thẻ nhớ microSD Lên đến 512GB, Camera kép 64MP + 64MP)- hàng chính hãng",5990000,5990000,0,0
TIKI,dien-thoai-may-tinh-bang,273244815,"Điện thoại Samsung Galaxy A23 5G 4GB/128GB Đen - Hàng chính hãng",5200000,5990000,790000,13
TIKI,dien-thoai-may-tinh-bang,273388474,"Điện thoại chắc chắn Ulefone Power Armor 18T Ultra (chụp ảnh nhiệt Camera FLIR5G 512GB ROM +24GB RAM)- hàng chính hãng",15990000,15990000,0,0
TIKI,dien-thoai-may-tinh-bang,273411988,"Điện thoại Xiaomi Redmi 13C (6+128GB) | 6.74" 90Hz| Media Tek Helio G85| 5000mAh - Hàng chính hãng",3028000,3490000,462000,13
TIKI,dien-thoai-may-tinh-bang,215097578,"Điện Thoại Di Động Forme D666 4G - Hàng Chính Hãng",650000,650000,0,0
TIKI,dien-thoai-may-tinh-bang,245770363,"Điện thoại Samsung Galaxy A04e (3GB/32GB) - Hàng chính hãng",2325000,2325000,0,0
TIKI,dien-thoai-may-tinh-bang,261965186,"Điện Thoại Xiaomi Redmi Note 12S (8GB/256GB) - Hàng Chính Hãng",6132000,6132000,0,0
TIKI,dien-thoai-may-tinh-bang,53380152,"Điện Thoại IP Phone Fanvil X1S - Hàng Chính Hãng",950000,950000,0,0
TIKI,dien-thoai-may-tinh-bang,273640492,"Điện Thoại Samsung Galaxy A05 (6GB/128GB) - Hàng Chính Hãng",3237000,3237000,0,0
TIKI,dien-thoai-may-tinh-bang,249955152,"Điện thoại Xiaomi Redmi Note 12 Pro 5G (8GB/256GB) - Hàng chính hãng",9490000,9490000,0,0
TIKI,dien-thoai-may-tinh-bang,252073075,"Điện thoại Masstel IZI11 4G - Hàng Chính Hãng",468000,468000,0,0
TIKI,dien-thoai-may-tinh-bang,197902452,"Điện thoại Masstel Lux 20 4G dành cho người lớn tuổi - Hàng chính hãng, Nguyên Seal",790000,790000,0,0
TIKI,dien-thoai-may-tinh-bang,273373420,"Điện thoại Xiaomi Redmi 13C (4GB/128GB) - Hàng chính hãng - Bảo hành 18 tháng",2832000,3090000,258000,8
TIKI,dien-thoai-may-tinh-bang,274498287,"Điện Thoại Samsung Galaxy A55 5G (8GB/128GB)- Hàng Chính Hãng",9390000,9990000,600000,6
TIKI,dien-thoai-may-tinh-bang,255866251,"Điện Thoại Samsung A14 4GB/128GB - Hàng Chính Hãng",3429000,4490000,1061000,24
TIKI,dien-thoai-may-tinh-bang,251772653,"Điện thoại Masstel izi 56 4G (pin trâu-loa chữ to rõ) - Hàng Chính Hãng",687000,687000,0,0
TIKI,dien-thoai-may-tinh-bang,271290719,"Điện Thoại Cho Người Già Masstel Fami 65 - SOS, Loa To, FM Không Dây, Đọc Số Bằng Giọng Nói, Xem Lịch Âm - HÀNG CHÍNH HÃNG",699000,999000,300000,30
TIKI,nha-sach-tiki,19963125,"Thiên Tài Bên Trái, Kẻ Điên Bên Phải",155730,179000,23270,13
TIKI,nha-sach-tiki,165089915,"7 Câu Hỏi "Thần Kỳ" Của Mọi Sếp Giỏi (Tái bản)",97000,150000,53000,35
TIKI,nha-sach-tiki,73553837,"Ngọc Sáng Trong Hoa Sen (Tái Bản 2020)",99300,128000,28700,22
TIKI,nha-sach-tiki,170706992,"Thám Tử Lừng Danh Conan: Hồ Sơ Tuyệt Mật - Shuichi Akai & Toru Amuro",112000,120000,8000,7
TIKI,nha-sach-tiki,20104310,"Hệ thống bán hàng đỉnh cao - The Snowball System",328000,328000,0,0
TIKI,nha-sach-tiki,190708160,"Nhất Quỷ Nhì Ma, Thứ Ba Takagi Tập 14 [Tặng Kèm Postcard]",30000,30000,0,0
TIKI,nha-sach-tiki,174449880,"Một Nghiên Cứu Về Giác Tính Con Người 
 (An Enquiry Concerning Human Understanding)",113000,145000,32000,22
TIKI,nha-sach-tiki,34340291,"Não Bộ Kể Gì Về Bạn",98400,149000,50600,34
TIKI,nha-sach-tiki,48629535,"Ngày Xưa Có Một Chuyện Tình (Tái Bản)",87000,125000,38000,30
TIKI,nha-sach-tiki,27957156,"Ehon Thông Minh Cho Trẻ Mẫu Giáo : Xếp Hàng Làm Gì Thế?",38500,52000,13500,26
TIKI,nha-sach-tiki,53486723,"Vô Cùng Tàn Nhẫn Vô Cùng Yêu Thương 3 - Phương Pháp Dạy Con Của Một Người Cha Do Thái",69020,129000,59980,46
TIKI,nha-sach-tiki,16158716,"Cách Nuôi Dạy Những Đứa Trẻ Dễ Cáu Giận, Khó Bảo",64000,89000,25000,28
TIKI,nha-sach-tiki,48212494,"How To Crack The IELTS Speaking Test - Part 1 (Tái Bản)",185400,299000,113600,38
TIKI,nha-sach-tiki,169621651,"Nam Đình Cốc Vi - Tập 6",94300,109000,14700,13
TIKI,nha-sach-tiki,171549938,"Quy Tắc Làm Việc Của Google (Tái Bản)",139000,219000,80000,37
TIKI,nha-sach-tiki,129381392,"Cuốn Sách Tranh Đầu Tiên Về Quốc Kỳ (Ehon Nhật Bản)",73800,99000,25200,25
TIKI,nha-sach-tiki,3283713,"Phong Thủy Cho Người Mua Nhà Chung Cư",399000,399000,0,0
TIKI,nha-sach-tiki,44858499,"Dạy Con Theo Phương Pháp Montessori - Dậy Nào Bé Ơi",8000,13600,5600,41
TIKI,nha-sach-tiki,184779711,"Bách Khoa Cho Trẻ Em – Bách Khoa Vũ Trụ",131000,180000,49000,27
TIKI,nha-sach-tiki,11954630,"Combo Quản Lý Nghiệp (Tái Bản) + Năng Đoạn Kim Cương (Tái Bản 2018)",183040,208000,24960,12
TIKI,nha-sach-tiki,730678,"Tuần Của Bé Tháng 7 - Bé Hòa Đồng",11500,23000,11500,50
TIKI,nha-sach-tiki,199972960," Phong Bì Trắng A4 ĐL120,A5 ĐL 100, A6 ĐL 100 Xuất Xứ Việt Nam Quy Cách Tập 100 Chiếc",45000,45000,0,0
TIKI,nha-sach-tiki,196830267,"Bá Tước Dracula (Bìa Cứng) - Tái Bản",130000,175000,45000,26
TIKI,nha-sach-tiki,860415,"Cổ Tích Việt Nam - Sự Tích Đầm Mực - Legend Of The Ink Pond (Song Ngữ Anh - Việt)",19200,32000,12800,40
TIKI,nha-sach-tiki,167685123,"Sách Vượt Bẫy Cảm Xúc",131000,188000,57000,30
TIKI,nha-sach-tiki,2245453,"Đúng Việc (Tái Bản)",99500,99500,0,0
TIKI,nha-sach-tiki,73553846,"Sức Mạnh Niềm Tin (Tái Bản 2020)",67300,88000,20700,24
TIKI,nha-sach-tiki,67835582,"Chiến Quốc Tung Hoành - Thế Cục Quỷ Cốc Tử: Tập 10",126000,195000,69000,35
TIKI,nha-sach-tiki,186880508,"Slam Dunk - Deluxe Edition Tập 9 [Tặng Kèm Obi + Bìa Áo Limited Ngẫu Nhiên]",60000,60000,0,0
TIKI,nha-sach-tiki,68586415,"Cao Thủ Đổi Đen Thay Trắng - Tập 1 (Dành Cho Lứa Tuổi 18+)",112000,149000,37000,25
TIKI,nha-sach-tiki,190601856,"Tâm",61800,89000,27200,31
TIKI,nha-sach-tiki,105614601,"Cặp đựng tài liệu A4 Deli - 8 ngăn phân trang - file lưu trữ tài liệu - linfini - Xanh Dương / Trắng - 72456",45000,88200,43200,49
TIKI,nha-sach-tiki,1475793,"Little Stories - To Make You A Good Person",48100,65000,16900,26
TIKI,nha-sach-tiki,83680361,"ISMS - Hiểu Về Nghệ Thuật Hiện Đại",142100,239000,96900,41
TIKI,nha-sach-tiki,174037877,"Điểm Dối Lừa ( Tái Bản)",132800,205000,72200,35
TIKI,nha-sach-tiki,100395623,"Bước Đi Ngẫu Nhiên Trên Phố Wall (Tái Bản)",156400,249000,92600,37
TIKI,nha-sach-tiki,50322156,"Thấu Hiểu Tiếp Thị Từ A Đến Z - 80 Khái Niệm Nhà Quản Lý Cần Biết (Tái Bản 2020)",66300,115000,48700,42
TIKI,nha-sach-tiki,4687535,"Series Thám Tử Kỳ Phát: Kỳ Phát Giết Người",51000,107000,56000,52
TIKI,nha-sach-tiki,85258271,"Bút Gel xóa được Mondee Thiên Long TP-GELE003",14000,14000,0,0
TIKI,nha-sach-tiki,146846342,"Sapiens - Lược Sử Loài Người Bằng Tranh - Tập 2 : Những Trụ Cột Của Nền Văn Minh",228100,345000,116900,34
TIKI,nha-sach-tiki,173093879,"Liễu Phàm Tứ Huấn - Tích Tập Phúc Đức, Cải Tạo Vận Mênh (Tái Bản 2022)",45500,59000,13500,23
TIKI,nha-sach-tiki,62373311,"Nồi Niêu Xoong Chảo - Sổ Tay Bếp Núc Của Tôi (Sách Màu)",93000,120000,27000,23
TIKI,nha-sach-tiki,192333857,"Ông già và biển cả",131000,200000,69000,35
TIKI,nha-sach-tiki,91625816,"Trên Đỉnh Phố Wall (Tái bản 2021)",139000,219000,80000,37
TIKI,nha-sach-tiki,43665704,"Combo Chiến thắng kì thi 9 vào 10 chuyên môn Vật Lí( Tập 1 - Tập 2)",206000,358000,152000,42
TIKI,nha-sach-tiki,2583037,"Series Địch Công Kỳ Án: Ngự Châu Án",46000,99000,53000,54
TIKI,nha-sach-tiki,11475738,"Combo 2 Cuốn: Kế Toán Tài Chính (Tập 1 & 2)",495000,750000,255000,34
TIKI,nha-sach-tiki,73176340,"Combo 10 cuốn Truyện Ngụ ngôn Aesop Song ngữ - Truyện kể mầm non (giao ngẫu nhiên)",62400,120000,57600,48
TIKI,nha-sach-tiki,105614631,"Kéo mini tiện lợi 105mm Deli - 5 màu Đen/ Xanh/ Hồng/ Trắng - Dành cho văn phòng, học sinh, sắc bén - 6072",45000,45000,0,0
TIKI,nha-sach-tiki,53974339,"Combo 3 Cuốn Di Sản Của GS. Phan Văn Trường Để Lại Cho Thế Hệ Sau: Một Đời Thương Thuyết + Một Đời Quản Trị + Một Đời Như Kẻ Tìm Đường (Cả Đời Trên Thương Trường)",431950,431950,0,0
TIKI,nha-sach-tiki,191571444,"Anh Em Phi Hành Gia - Tập 30",45000,45000,0,0
TIKI,nha-sach-tiki,52805069,"Những Vị Thần Bắc Âu",122000,175000,53000,30
TIKI,nha-sach-tiki,173718231,"Combo 2 Cuốn Luyện viết Lớp 1 - Chương trình SGK Cánh diều",31200,60000,28800,48
TIKI,nha-sach-tiki,19662170,"Tên Tôi Là Đỏ (Tái Bản 2019)",114000,155000,41000,26
TIKI,nha-sach-tiki,27639410,"Toán Song Ngữ Tiền Tiểu Học - Sách Học 3",28100,36000,7900,22
TIKI,nha-sach-tiki,170352757,"Người Sống Cũng Phải Hồi Sinh",89100,129000,39900,31
TIKI,nha-sach-tiki,189940682,"Hãy Sống Cuộc Đời Như Bạn Muốn  (Tái bản)",69420,99000,29580,30
TIKI,nha-sach-tiki,185415267,"Bút gel B màu Pastel Thiên Long Flexoffice Pazto FO-GELB039/VN - Mực xanh (5 cây)",41000,50000,9000,18
TIKI,nha-sach-tiki,31993279,"4000 Từ Vựng Tiếng Anh Thường Dùng Nhất (Kèm CD Hoặc File MP3)",186000,248000,62000,25
TIKI,nha-sach-tiki,193895765,"Lập Kế Hoạch Công Việc chu Trình PDCA (Tái Bản)",103700,149000,45300,30
TIKI,nha-sach-tiki,27639420,"Toán Song Ngữ Tiền Tiểu Học - Sách Học 2",32400,36000,3600,10
TIKI,nha-sach-tiki,194959710,"Đâu Chỉ Độc Mình Tôi Đơn Độc",68000,88000,20000,23
TIKI,nha-sach-tiki,34750208,"Ngụ Ngôn Song Ngữ Anh - Việt: Con Quạ Thông Minh (Tái Bản 2019)",16800,28000,11200,40
TIKI,nha-sach-tiki,1205103,"Free Marketing  –  101 Ý Tưởng Phát Triển Doanh Nghiệp Với Chi Phí Thấp (Tái Bản 2017)",135400,199000,63600,32
TIKI,nha-sach-tiki,1750249,"Phân Tích Chứng Khoán",301400,499000,197600,40
TIKI,nha-sach-tiki,90480255,"Sách - Lão Tử Đạo Đức kinh - Nguyễn Hiến Lê ( Tuyển Tập Bách Gia Tranh Minh)",112000,159000,47000,30
TIKI,nha-sach-tiki,187503389,"Thiên Thần Diệt Thế - Seraph Of The End - Tập 24",22000,22000,0,0
TIKI,nha-sach-tiki,5743619,"Học Tiếng Anh Siêu Thú Vị : Sách Luyện - Tập 2",13000,24000,11000,46
TIKI,nha-sach-tiki,170298048,"Dịch Bệnh Atlantis",151000,195000,44000,23
TIKI,nha-sach-tiki,66398385,"Hành Trình Sinh Tử",75300,109000,33700,31
TIKI,nha-sach-tiki,75696174,"Vẫy Vùng Giữa Vũng Lầy",140000,140000,0,0
TIKI,nha-sach-tiki,89222118,"Sổ Vẽ Phác Thảo Deli 40 Trang - Gáy Lò Xo - Khổ Ngang A4/B5 - Giấy Định Lượng 100Gsm / 110Gsm - 7696 / 7697 / 73632",29000,57600,28600,50
TIKI,nha-sach-tiki,186262546,"BILLY SUMMERS – VỤ ÁM SÁT CUỐI CÙNG",209300,299000,89700,30
TIKI,nha-sach-tiki,176132390,"Truyện Thiếu Nhi Hạt Giống Tâm Hồn - Lễ Tạ Ơn",43100,56000,12900,23
TIKI,nha-sach-tiki,13362558,"Làm sạch tâm hồn - Các bài tập thiền",47800,69000,21200,31
TIKI,nha-sach-tiki,44911496,"Little Stories - The Best Book For Your Leisure Time",41800,65000,23200,36
TIKI,nha-sach-tiki,136939563,"Ho’Oopnopono: Phục Hồi Tự Nhiên, Chữa Lành Cuộc Sống, Hoàn Thiện Cuộc Đời",46100,66000,19900,30
TIKI,nha-sach-tiki,167019786,"Cơ Thể Tự Chữa Lành - Thanh Lọc Để Phục Hồi",221300,295000,73700,25
TIKI,nha-sach-tiki,4219547,"Người đàn ông đánh bại mọi thị trường - A man for all markets",349000,349000,0,0
TIKI,nha-sach-tiki,157412117,"Chưa Kịp Lớn Đã Phải Trưởng Thành",63000,79000,16000,20
TIKI,dien-thoai-may-tinh-bang,31820638,"Điện Thoại Bàn Panasonic KX-TS500MX - Panasonic KX-TS500MX Integrated Telephone System - Hàng chính hãng",299000,299000,0,0
TIKI,dien-thoai-may-tinh-bang,196760330,"Điện Thoại Vivo T1x 4GB/64GB - Hàng Chính Hãng",3379000,4490000,1111000,25
TIKI,dien-thoai-may-tinh-bang,37289936,"Điện thoại Oukitel WP2 chống nước,chống va đập, pin 10.000 mAh - Hàng chính hãng",5490000,5490000,0,0
TIKI,dien-thoai-may-tinh-bang,4048043,"Điện Thoại Bàn Panasonic KX-TS500",339000,369000,30000,8
TIKI,dien-thoai-may-tinh-bang,221518066,"Máy đọc sách Kindle Oasis 3 10th - Hàng nhập khẩu",6042210,6789000,746790,11
TIKI,dien-thoai-may-tinh-bang,194462682,"Điện thoại ZTE Blade A52 4GB l 64GB, Pin 5000mAh, Màn hình 6.52", Camera AI Triple - Hàng chính hãng",3490000,3490000,0,0
TIKI,dien-thoai-may-tinh-bang,273227290,"Combo Máy đọc sách Kindle Scribe kèm bút – thế hệ đầu tiên có thể đọc và viết, màn hình 10,2” 300PPI, đèn vàng warmlight, bộ nhớ 16-64GB, đồng bộ dữ liệu qua Microsoft Word - hàng nhập khẩu",11276100,11390000,113900,1
TIKI,dien-thoai-may-tinh-bang,171852890,"Điện thoại Masstel FAMI 60 4G ,Pin 2000 mah ,cỡ chữ to rõ ràng,âm thanh lớn,màn hình to- Hàng chính hãng",689000,689000,0,0
TIKI,dien-thoai-may-tinh-bang,80132874,"ĐIỆN THOẠI TÂN CỔ ĐIỂN DT16 bàn phím quay chuông thanh, dùng được nghe gọi âm thanh rõ ràng. Điện thoại để bàn tân cổ điển- Điện thoại bàn chất liệu gỗ để trang trí",2320000,2900000,580000,20
TIKI,dien-thoai-may-tinh-bang,196176544,"Điện Thoại Cho Người Già Masstel Fami 12 4G-hỗ trợ 4g-chữ to dành cho người già(Hàng Chính Hãng)",630000,630000,0,0
TIKI,dien-thoai-may-tinh-bang,198203859,"Điện Thoại Vivo V25 5G 2022 (8GB/128GB) - Hàng Chính Hãng",7490000,10490000,3000000,29
TIKI,dien-thoai-may-tinh-bang,198111545,"Điện Thoại Vivo V25e 2022 (8GB/128GB) - Hàng Chính Hãng",8490000,8490000,0,0
TIKI,dien-thoai-may-tinh-bang,181216830,"Điện thoại ZTE Blade V40 Vita (ZTE 8045) - MH giọt nước HD+ 6.75" - Pin 6000 mAh sạc nhanh 22.5W -  Bộ nhớ mở rộng (4+2)GB - Hàng chính hãng",4290000,4290000,0,0
TIKI,dien-thoai-may-tinh-bang,29440849,"điện thoại  IP622C - hàng chính hãng",1650000,1650000,0,0
TIKI,dien-thoai-may-tinh-bang,21317020,"Điện thoại bàn không dây Panasonic KX-TGF310 - Hàng Chính Hãng",2450000,2450000,0,0
TIKI,dien-thoai-may-tinh-bang,188030974,"Máy tính bảng Oukitel RT1 - hàng chính hãng  (chống nước,chống va đập , pin khủng,pin 10.000mAh,màn hình 10,1 inch,Ram 4Gb,Rom 64Gb,tám nhân,học online)",6990000,6990000,0,0
TIKI,dien-thoai-may-tinh-bang,4059671,"Điện Thoại Bàn Panasonic KXTS 520 - Hàng Chính Hãng",469000,489000,20000,4
TIKI,dien-thoai-may-tinh-bang,170727305,"Điện thoại bàn Panasonic KX-TS580 hàng chính hãng",999000,999000,0,0
TIKI,dien-thoai-may-tinh-bang,174085242,"Điện Thoại Cho Người Già Masstel Fami 12 4G - Viền Kim Loại, Ăng Ten FM Không Dây - Hàng Chính Hãng",612000,699000,87000,12
TIKI,dien-thoai-may-tinh-bang,14508445,"Điện thoại Ip phone Cisco CP-7841-K9 chính hãng",4200000,4200000,0,0
TIKI,dien-thoai-may-tinh-bang,157835051,"Điện Thoại Để Bàn Panasonic KX-TS500MX - Hàng Chính Hãng",380000,380000,0,0
TIKI,dien-thoai-may-tinh-bang,121154009,"Điện thoại bàn cố định không dây lắp các loại Sim Di động, Cố định (Viettel, Vinaphone, Mobifone...)",650000,650000,0,0
TIKI,dien-thoai-may-tinh-bang,91281318,"Máy Đọc Sách Likebook P10 - Hàng chính hãng",9090000,9090000,0,0
TIKI,dien-thoai-may-tinh-bang,52326343,"Cisco Unified IP Phone CP-7821-K9 - Hàng chính hãng",2580000,2580000,0,0
TIKI,dien-thoai-may-tinh-bang,11110653,"Điện thoại bàn không dây Panasonic KX-TGF320 - Hàng Chính Hãng",2500000,2500000,0,0
TIKI,dien-thoai-may-tinh-bang,117347869,"ĐIỆN THOẠI HỘI NGHỊ YEALINK CP960 -HÀNG CHÍNH HÃNG",15230000,15230000,0,0
TIKI,dien-thoai-may-tinh-bang,215125094,"Điện Thoại Di Động Forme D999 4G - Hàng Chính Hãng",760000,760000,0,0
TIKI,dien-thoai-may-tinh-bang,257866809,"Điện thoại để bàn tân cổ điển phím quay DT15",3900000,3900000,0,0
TIKI,dien-thoai-may-tinh-bang,113475741,"Điện thoại Panasonic KX-TS520MX - Trắng - Hàng chính hãng",450000,450000,0,0
TIKI,dien-thoai-may-tinh-bang,197905982,"Điện thoại di động Vtel E10 4G – Hàng Chính Hãng",379050,399000,19950,5
TIKI,dien-thoai-may-tinh-bang,140747649,"Điện thoại Realme C11 2021 (4GB/64GB) - Hàng chính hãng",3790000,3790000,0,0
TIKI,dien-thoai-may-tinh-bang,54882670,"Điện thoại để bàn tân cổ điển chuông thanh bàn phím quay mã DT10 dùng sim di động hoặc dùng cáp nghe gọi âm thanh rõ ràng và để trang trí (điện thoại bàn tân cổ điển)",2320000,2900000,580000,20
TIKI,dien-thoai-may-tinh-bang,16518032,"Điện thoại để bàn Panasonic KX-TS560 hàng chính hãng",730000,730000,0,0
TIKI,dien-thoai-may-tinh-bang,156222386,"Điện thoại Panasonic KX-TS520MX -Hàng chính hãng",449000,459000,10000,2
TIKI,dien-thoai-may-tinh-bang,55197731,"Điện thoại bàn màu đỏ KXT438",215000,215000,0,0
TIKI,dien-thoai-may-tinh-bang,94453667,"Điện thoại VoIP Yealink SIP-T30",1050000,1050000,0,0
TIKI,dien-thoai-may-tinh-bang,11376644,"Điện thoại bàn có dây Panasonic KX-TS560MX",730000,730000,0,0
TIKI,dien-thoai-may-tinh-bang,54683561,"ĐIỆN THOẠI TÂN CỔ ĐIỂN DT14 bàn phím quay chuông quả, dùng cáp điện thoại cố định nghe gọi âm thanh rõ ràng (điện thoại bàn tân cổ điển)",3520000,4400000,880000,20
TIKI,dien-thoai-may-tinh-bang,54989813,"Điện thoại tân cổ điển để bàn mã DT4 màu trắng kết hợp vàng, chuông thanh bàn phím quay, dùng sim di động nghe gọi âm thanh tốt và để trang trí (Điện thoại bàn tân cổ điển)",2900000,2900000,0,0
TIKI,dien-thoai-may-tinh-bang,125171841,"Điện Thoại Bàn Panasonic KX-TSC11 - Hàng Chính Hãng",620000,620000,0,0
TIKI,nha-cua-doi-song,44321391,"Tủ nhựa lắp ghép 6 Ô quần áo (70cm x 110cmx47cm)",279000,279000,0,0
TIKI,nha-cua-doi-song,85029640,"Ổ cắm Điện Quang ĐQ ESK 2WR 23-3U (2 lỗ 3 chấu, 3 USB, dây dài 2m, màu trắng đỏ)",214160,267700,53540,20
TIKI,nha-cua-doi-song,124691053,"Đệm thắt lưng tam giác Ema thế hệ 2 - Rộng hơn - Thoải mái xoay trở - Dành cho người thoát vị thắt lưng, bà bầu, người cao tuổi",200000,400000,200000,50
TIKI,nha-cua-doi-song,56451459,"Pin C carbon Panasonic R14UT/2S chính hãng",27550,29000,1450,5
TIKI,nha-cua-doi-song,190542051,"[70*140cm] Khăn Tắm Viên Nén HQ",8900,15000,6100,41
TIKI,nha-cua-doi-song,15262922,"Đầu Gắn Vòi Nước Rửa Chén Xoay 360 Độ Tiết Kiệm Nước XR581",18800,18800,0,0
TIKI,nha-cua-doi-song,78890431,"Bộ nắp bàn cầu nhà vệ sinh bằng nhựa cao cấp, thích hợp sử dụng với nhiều loại bồn cầu",65000,65000,0,0
TIKI,nha-cua-doi-song,55134471,"1kg - Túi đựng rác gia đình , Bao đựng rác văn phòng 3 màu size trung 55x65",34000,34000,0,0
TIKI,nha-cua-doi-song,145243898,"Bộ vòi bơm hút nước rửa chén gắn chậu rửa HOBBY Home Decor NRC4 màu đen đầu bơm Inox 304 kèm dây dẫn 120cm",209000,280000,71000,25
TIKI,nha-cua-doi-song,168837331,"Giấy Nến Lót Nồi Chiên Không Dầu Hình Khuôn Bánh Siêu Tiện Lợi - Thấm Giảm Thiểu Tối Đa Dầu Mỡ Bám - Hàng Chính Hãng MINIIN",99000,99000,0,0
TIKI,nha-cua-doi-song,195544340,"Bình Inox Đựng Rượu CCCP Truyền Thống Dung Tích 2.0L Dày 0,6 ly - 64OZ ( Loại 1 ), Kèm Bao Da Phong Cách",185000,398000,213000,54
TIKI,nha-cua-doi-song,39292323,"Bình Nước Thủy Tinh WATER Phong Cách Hàn Quốc 460ml",115000,115000,0,0
TIKI,nha-cua-doi-song,52577269," Đầu vòi rửa chén tăng áp nhựa mạ điện-Ba phương pháp thoát nước",38000,85000,47000,55
TIKI,nha-cua-doi-song,53116171,"PHÂN TRÙN QUẾ DẠNG VIÊN NÉN SFARM CHUYÊN DÙNG CHO LAN VÀ HOA KIỂNG TRỒNG CHẬU - BỔ SUNG HỆ VI SINH CÓ LỢI CHO ĐẤT",45000,45000,0,0
TIKI,nha-cua-doi-song,2391311,"Cân Treo Mini Bỏ Túi 1 Mặt Số 5kg Nhơn Hòa NHMGS-5 - Hàng Chính Hãng",69000,69000,0,0
TIKI,nha-cua-doi-song,162875961,"Hộp 10 Đôi Đũa  Sừng Chất Liệu Hợp Kim Mạ Vàng Cao Cấp Đầu Đũa Có Chống Trơn - Hàng Loại 1 - Chính Hãng MINIIN",32000,32000,0,0
TIKI,nha-cua-doi-song,170927755,"Hộp nhựa đựng thực phẩm Homepower trong suốt có khay lót đáy giúp ráo nước, chất liệu cao cấp, an toàn cho sức khỏe",149000,149000,0,0
TIKI,nha-cua-doi-song,26670490,"Kệ Góc Nhà Tắm Chống Nước",204000,222000,18000,8
TIKI,nha-cua-doi-song,139723967,"Combo Khăn Lau Đa Năng Mặt Siêu Thấm, Khăn Lau Bếp, Khăn Lau Kính, Khăn Lau Bát, Khăn Lau Tay, Khăn Lâu Ô Tô miDoctor",16000,16000,0,0
TIKI,nha-cua-doi-song,10404394,"Bình Đựng Thức Ăn Giữ Nhiệt ELmich Inox 304 EL0631 (500ml)",243000,469000,226000,48
TIKI,nha-cua-doi-song,96183241,"Chân đàn Organ, Piano đa năng - Kzm Kurtzman STX2 - Dáng chữ X đôi - Hàng chính hãng",210000,210000,0,0
TIKI,nha-cua-doi-song,20634384,"Ổ Khóa inox Mật Mã 4 Số",28000,28000,0,0
TIKI,nha-cua-doi-song,96271704,"Ổ Cắm Điện Thông Minh XSmart Đa Tính Năng Chống Giật Hàng Siêu Cao Cấp,  Chống Cháy Nổ Chịu Được Công Suất Cao, Chính Hãng",139000,139000,0,0
TIKI,nha-cua-doi-song,114204741,"Bình giữ nhiệt inox 304 Sunhouse 450ml KS-TU450I",98000,150000,52000,35
TIKI,nha-cua-doi-song,273377437,"Ổ cắm điện kéo dài Rạng Đông 2m/5m Model OC04, OC05 chống giật, rơ le tự ngắt chống quá tải",126000,140000,14000,10
TIKI,nha-cua-doi-song,87578488,"Găng tay y tế latex S Gloves - Bao tay y tế có bột màu trắng hộp 100 chiếc",54000,70000,16000,23
TIKI,nha-cua-doi-song,73608154,"ĐỒNG HỒ TREO TƯỜNG TRÒN KIM TRÔI SIZE LỚN ĐƯỜNG KÍNH 30CM",149000,149000,0,0
TIKI,nha-cua-doi-song,140204791,"Bộ 24 Quả Châu Bóng Nhũ Kim Tuyến Lấp Lánh Trang Trí Cây Thông Noel Giáng Sinh Giá Rẻ",78000,78000,0,0
TIKI,nha-cua-doi-song,135610861,"Ga thun lạnh đủ kích thước",55000,55000,0,0
TIKI,nha-cua-doi-song,2039747,"Bộ Nồi Inox 3 Đáy Sunhouse SH334",440000,690000,250000,36
TIKI,nha-cua-doi-song,14639229,"Nắp Kính Cường Lực Nồi Và Chảo Fivestar",55000,55000,0,0
TIKI,nha-cua-doi-song,68736740,"Ruột gối nằm lông vũ khách sạn cao cấp sợi microfiber nhân tạo Hanvico by Homemark có kích thước trẻ em và 50x70 cm",133000,250000,117000,47
TIKI,nha-cua-doi-song,75783351,"Máy Xay Tỏi Ớt Cầm Tay Mini Sạc Điện 100ml 250ml Tiện Lợi",160000,160000,0,0
TIKI,nha-cua-doi-song,85351583," 100 Túi bao Ổi, Cam, Na, Vú Sữa,.. túi bọc trái cây phòng ngừa sâu bệnh phá hoại - Dạng Rút Túi Chuyên Dụng",32000,32000,0,0
TIKI,nha-cua-doi-song,35449842,"hộp 200 ống hút giấy cao cấp _ Clean Paper Straw màu trắng kích thước 6mm x 197mm dùng cho cà phê, nước ép....",53000,53000,0,0
TIKI,nha-cua-doi-song,116198000,"Đệm Ngồi Thông Minh Lưu Thông Máu Thoáng Khí PEAFLO",145000,165000,20000,12
TIKI,nha-cua-doi-song,47462861,"Bộ 6 vỉ (12 viên pin) pin Kiềm Alkaline Panasonic AAA LR03T/2B-Hàng chính hãng",167000,180000,13000,7
TIKI,nha-cua-doi-song,90850071,"DECAL DÁN KÍNH CHỐNG NẮNG CÁCH NHIỆT XANH DƯƠNG(CUÔN 3M)",169000,169000,0,0
TIKI,nha-cua-doi-song,103118895,"Đèn pha led năng lượng mặt trời 300w 200w 100w 60w báo dung lượng pin pha nhôm chống nước IP67 có giấy bảo hành 2 năm",434000,434000,0,0
TIKI,nha-cua-doi-song,67811819,"Đèn LED Cảm Biến Chuyển Động Nhiều Kích Cỡ, Cảm Ứng Hồng Ngoại 3 Chế Độ",197000,197000,0,0
TIKI,nha-sach-tiki,165030720,"Miko! Tất Tần Tật - Best Selection",21600,25000,3400,14
TIKI,nha-sach-tiki,171549998,"Never Get Bored - Tí Ta Tí Toáy Ngoài Trời",120000,155000,35000,23
TIKI,nha-sach-tiki,2449681,"Sách Tương Tác - Big Book - Cuốn Sách Khổng Lồ Về Các Ngôi Sao Và Các Hành Tinh (Tái Bản)",131100,168000,36900,22
TIKI,nha-sach-tiki,192339908,"Cuộc Nổi Dậy Của Cô Nàng Mọt Sách - Phần 1 : Con Gái Của Người Lính II",165000,165000,0,0
TIKI,nha-sach-tiki,15634598,"Who? Chuyện Kể Về Danh Nhân Thế Giới: Coco Chanel (Tái Bản 2019)",41100,55000,13900,25
TIKI,nha-sach-tiki,182551495,"Black Jack 10 (Bìa Cứng)",96100,135000,38900,29
TIKI,nha-sach-tiki,59207573,"Luyện Viết Chữ Nhớ Từ Vựng Tiếng Anh Theo Chương Trình Sách Giáo Khoa Lớp 5 – Tập 2",34000,35000,1000,3
TIKI,nha-sach-tiki,531109,"i-Learn Smart Start Grade 3 Student's Book (Phiên Bản Dành Cho Các Tỉnh)",104500,110000,5500,5
TIKI,nha-sach-tiki,109960224,"Sách Dạy Con Học Nói Tập 1 (Tái Bản)",299000,299000,0,0
TIKI,nha-sach-tiki,103390740,"Sách Luật Kinh Doanh Bất Động Sản Hiện Hành (Sửa Đổi, Bổ Sung Năm 2020)",24000,24000,0,0
TIKI,nha-sach-tiki,273119803,"Cha Con Giáo Hoàng (Mario Puzo)",89000,135000,46000,34
TIKI,nha-sach-tiki,1029750,"Tuần Của Bé - Bé Thanh Lịch (Dành Cho Trẻ 3 - 6 Tuổi)",21850,23000,1150,5
TIKI,nha-sach-tiki,181131175,"Combo 4 Cuốn Đề Ôn Luyện Và Tự Kiểm Tra Toán + Tiếng Việt Lớp 1",116000,156000,40000,26
TIKI,nha-sach-tiki,13527009,"Thúc Đẩy Giao Tiếp - 300 Trò Chơi Và Các Hoạt Động Cho Trẻ Tự Kỷ",54800,79000,24200,31
TIKI,nha-sach-tiki,55605174,"Thả Diều Trên Đê - Thơ Cho Thiếu Nhi",76000,118000,42000,36
TIKI,nha-sach-tiki,57520291,"Kẻ Đại Lãn",78100,79000,900,1
TIKI,nha-sach-tiki,142791683,"Sourdough Bread - Bánh Mì Men Tự Nhiên",139000,179000,40000,22
TIKI,nha-sach-tiki,136684902,"Combo 3 sách luyện thi B1 Vstep: Luyện thi B1 Vstep 4 kỹ năng + 30 đề thi viết luận tiếng Anh B1, B2 Vstep + 10 bộ đề thi Đọc hiểu Vstep B1-B2-C1 ôn thi chứng chỉ ngoại ngữ bậc 3 Vstep writing, reading, speaking, listening",800000,800000,0,0
TIKI,nha-sach-tiki,72225310,"Cẩm Nang Chăm Sóc Răng Miệng Toàn Diện",51800,78000,26200,34
TIKI,nha-sach-tiki,184779719,"Bách Khoa Cho Trẻ Em – Bách Khoa Khủng Long",131000,180000,49000,27
TIKI,nha-sach-tiki,74217673,"Gi Gỉ Gì Gi, Cái Gì Cũng Biết - Dành Cho Lớp 3",88800,119000,30200,25
TIKI,nha-sach-tiki,719930,"Mom's Letters: Family",17000,18000,1000,6
TIKI,nha-sach-tiki,2583035,"Bé Chu Đáo",11500,23000,11500,50
TIKI,nha-sach-tiki,78975579,"Bí Mật Một Tâm Hồn Cuốn Hút (Tái Bản Lại Từ Cuốn: Để Có 1 Tâm Hồn Đẹp)",68400,96000,27600,29
TIKI,nha-sach-tiki,53772001,"Bên Lề Sách Cũ - Bìa Cứng (Tái Bản 2020)",86000,130000,44000,34
TIKI,nha-sach-tiki,3408331,"Những Trò Chơi Dân Gian Phổ Thông Và Vui Nhộn Dành Cho Thiếu Nhi (Tái Bản)",59600,80000,20400,26
TIKI,nha-sach-tiki,19383404,"10 khoen tròn xâu flashcard",66000,70500,4500,6
TIKI,nha-sach-tiki,106605687,"Giao Dịch Kỷ Luật Làm Chủ Thị Trường",110000,159000,49000,31
TIKI,nha-sach-tiki,21049645,"Xấp 10 Bìa lá A4 Plus dày ",21000,21000,0,0
TIKI,nha-sach-tiki,196054990,"Đông Dương: Một Nền Thuộc Địa Nhập Nhằng, Giai Đoạn 1858 - 1954",329000,439000,110000,25
TIKI,nha-sach-tiki,15686499,"Nghệ Thuật Quyến Rũ (Tái Bản 2019)",161000,161000,0,0
TIKI,nha-sach-tiki,136540009,"Toàn Thư Tâm Lý Học (Tặng Kèm Bookmark)",95300,126000,30700,24
TIKI,nha-sach-tiki,184081012,"Sách tham khảo Vật Lí 10 - Biên soạn theo chương trình GDPT mới",95000,95000,0,0
TIKI,nha-sach-tiki,73686632,"Combo 14 Truyện Ngụ ngôn Aesop - Truyện kể mầm non - Truyện cổ tích (Giao ngẫu nhiên)",83200,160000,76800,48
TIKI,nha-sach-tiki,39521136,"Để Hiệu Quả Trong Công Việc (Tái Bản 2019)",36000,52000,16000,31
TIKI,nha-sach-tiki,2601231,"Sài Côn Cố Sự",23000,120000,97000,81
TIKI,nha-sach-tiki,150838230,"Everybody Writes - Ai Rồi Cũng Viết (Cuốn Cẩm Nang Giúp Bạn Viết Content “Chất Như Nước Cất”)",133000,179000,46000,26
TIKI,nha-sach-tiki,176824195,"Cách Quản Trị Của Amazon (Working Backwards: Insights, Stories, And Secrets From Inside Amazon)",131000,205000,74000,36
TIKI,nha-sach-tiki,161426354,"Netflix - Phá Bỏ Nguyên Tắc Để Bứt Phá",119000,198000,79000,40
TIKI,nha-sach-tiki,190605360,"Người Bà Tài Giỏi Vùng Saga – Tập 1 (Tái Bản)",41100,52000,10900,21
TIKI,nha-sach-tiki,48659055,"Cuộc Sống "Đếch" Giống Cuộc Đời",62500,90000,27500,31
TIKI,nha-sach-tiki,181997205,"Nhập môn thuật toán",215000,215000,0,0
TIKI,nha-sach-tiki,184790643,"Nền kinh Tế Trải Nghiệm",185400,299000,113600,38
TIKI,nha-sach-tiki,188551111,"Tiệm Trừ Yêu Kì Ảo - Tập 15",33000,35000,2000,6
TIKI,nha-sach-tiki,28285288,"Little Stories - To Change Your Life",41800,65000,23200,36
TIKI,nha-sach-tiki,58444919,"Lời Nguyện Cầu Chernobyl (Biên Niên Sử Của Tương Lai)",127000,170000,43000,25
TIKI,nha-sach-tiki,112331969,"Quiz! Khoa Học Kì Thú: Thực Phẩm Dinh Dưỡng",49100,68000,18900,28
TIKI,nha-sach-tiki,184633072,"Tư Trị Thông Giám - Tập 8",188000,286000,98000,34
TIKI,nha-sach-tiki,118124353,"Thức Tỉnh Điều Vô Hình (Hành Trình Khám Phá Tâm Linh)",95600,138000,42400,31
TIKI,nha-sach-tiki,1028645,"Như Mây Thong Dong",57500,90000,32500,36
TIKI,nha-sach-tiki,167148807,"Tâm Lý Học Nói Gì Về Ấn Tượng Ban Đầu",89100,126000,36900,29
TIKI,nha-sach-tiki,76776247,"Hà Nội Bảo Thế Là Thường (Bìa Mềm)(Tản Văn)",96500,108000,11500,11
TIKI,nha-sach-tiki,71156902,"Máy Tính CASIO FX570ESPLUS-NEW (TL)",460000,460000,0,0
TIKI,nha-sach-tiki,9688926,"Phát Triển Tư Duy Đột Phá Giải Bài Tập Tài Liệu Dạy - Học Vật Lí Lớp 8",80400,134000,53600,40
TIKI,nha-sach-tiki,157169477,"Hộp Đựng Bút Viết Đa Năng Grepaco Bằng Vải Bố Canvas Tote Đẹp Nhiều Ngăn Dạng Túi Đựng Dụng Cụ Đồ Dùng Học Tập, Phụ Kiện Học Sinh, Sinh Viên, Đồ Cá Nhân Văn Phòng – Hàng Chính Hãng",49000,49000,0,0
TIKI,nha-sach-tiki,1534615,"Giáo Trình Chuẩn HSK 5 Bài Tập (Tập 1)",141000,188000,47000,25
TIKI,nha-sach-tiki,186265470,"Theo Dấu Chân Bác Hồ",59100,65000,5900,9
TIKI,nha-sach-tiki,3136211,"Bắt Đầu Với Câu Hỏi Tại Sao? ( Tái Bản )",99501,99501,0,0
TIKI,nha-sach-tiki,49747011,"Nghĩ Từ Trái Tim (Tái Bản 2020)",42500,50000,7500,15
TIKI,nha-sach-tiki,34749958,"Ngụ Ngôn Song Ngữ Anh - Việt: Cừu Non Nhanh Trí (Tái Bản 2019)",14000,28000,14000,50
TIKI,nha-sach-tiki,116397383,"Omoiyari - Nghệ Thuật Đối Nhân Xử Thế Của Người Nhật",119000,142000,23000,16
TIKI,nha-sach-tiki,77111961,"Bộ 5 thiệp vuông 12cm SDstationery LIVE GREEN sinh nhật, tình bạn, tình yêu, chúc mừng, truyền cảm hứng",92340,97200,4860,5
TIKI,nha-sach-tiki,192583632,"Lốc 10 Vở (Tập) Ô ly Siêu nhí Cao cấp 80 trang (4 ô ly - Giao mẫu ngẫu nhiên)",95250,127000,31750,25
TIKI,nha-sach-tiki,11743071,"Bộ gương lược bỏ túi mini hình chiếc bánh cookie - màu",40000,45000,5000,11
TIKI,nha-sach-tiki,2583031,"Bé Thông Thái",11500,23000,11500,50
TIKI,nha-sach-tiki,138342170,"Sức Mạnh Của Sự Tử Tế (Tái bản năm 2020)",88000,104000,16000,15
TIKI,nha-sach-tiki,485326,"Những Cuộc Phiêu Lưu Của Sherlock Holmes",63200,79000,15800,20
TIKI,nha-sach-tiki,102566681,"Làm Quen Với Môn Cắt Thủ Công",70500,89000,18500,21
TIKI,nha-sach-tiki,56111649,"Dây Đay Thừng Trang Trí Thủ Công Handmade 150 Mét",36000,125000,89000,71
TIKI,nha-sach-tiki,22099041,"KẸP BẤM 1 LỖ KIM LOẠI",32000,32000,0,0
TIKI,nha-sach-tiki,462169,"Đồng Hồ Angrybirds Năng Động",30000,30000,0,0
TIKI,nha-sach-tiki,190194623,"Không Phải Sói Nhưng Cũng Đừng Là Cừu",111360,128000,16640,13
TIKI,nha-sach-tiki,98355902,"Gọt Bút Chì Điện Tự Động Deli - 1 Chiếc - 502",135000,279000,144000,52
TIKI,nha-sach-tiki,51348621,"Bỉ Vỏ (Tái Bản)",36500,50000,13500,27
TIKI,nha-sach-tiki,184594032,"Không gia đình (Tái bản)",119250,159000,39750,25
TIKI,nha-sach-tiki,46332534,"Sherlock Holmes Toàn Tập (3 Tập - Hộp Đứng) (Bìa Mềm)(Tái Bản)",325000,495000,170000,34
TIKI,nha-sach-tiki,192692429,"Thức Tỉnh",94800,139000,44200,32
TIKI,nha-sach-tiki,109310241,"7 Chiến Lược Thịnh Vượng Và Hạnh Phúc (Tái Bản)",56100,85000,28900,34
TIKI,nha-sach-tiki,184476623,"Bút dạ quang màu Pastel Thiên Long Flexoffice Pazto FO-HL009/VN - Bút dạ quang rửa được - Không để lại vết khi Photocopy",11000,13000,2000,15
TIKI,nha-sach-tiki,66452062,"Trái Tim Của Brutus",98500,138000,39500,29
TIKI,nha-cua-doi-song,146926667,"Giây Ăn SAKARA Mã 6089 Siêu Mịn, Siêu Dai, Bốn Lớp, Không Mủn Giấy Ăn Cao Cấp Nhập Khẩu Thùng 30 gói",141897,141897,0,0
TIKI,nha-cua-doi-song,28604722,"Ghế bệt gỗ kiểu nhật D227 ( Hàng nhập khẩu )",320000,320000,0,0
TIKI,nha-cua-doi-song,104472138,"Tấm/Miếng Lót Nồi Bằng Gỗ Đường Kính 21cm",25000,25000,0,0
TIKI,nha-cua-doi-song,187829576,"VỎ GỐI NẰM,GỐI ÔM COTTON MỀM MỊN. THOÁNG MÁT GIÁ SIÊU RẺ,KÍCH THƯỚC 40X60.50X70.35X105",30400,40000,9600,24
TIKI,nha-cua-doi-song,189568098,"Bình giữ nhiệt inox 304 Elmich",220000,499000,279000,56
TIKI,nha-cua-doi-song,73759724,"Kệ Sách Đứng Để Sàn Cao Cấp FIVO Mẫu FB70 Lắp Ráp Đơn Giản, Phù Hợp Với Mọi Không Gian",749000,1168000,419000,36
TIKI,nha-cua-doi-song,84153167,"Kệ Sách Đa Năng Athena 5F Thương Hiệu IGEA",409000,445000,36000,8
TIKI,nha-cua-doi-song,8141095,"Bình nước Lock&Lock Aqua HAP739B/HAP739W 2,6L",68800,109000,40200,37
TIKI,nha-cua-doi-song,88230880,"Bóng đèn cảm ứng cảm biến chuyển động rada vi sóng 5.8 Hz tự động bật tắt đèn khi có người đi qua",41000,41000,0,0
TIKI,nha-cua-doi-song,137796584,"Thảm Lau Chân Nhà Tắm Đa Năng Chất Liệu Chống Trơn Trượt Cao Cấp 4 Lớp Thấm Hút Tốt 40x60cm Loại 1 - Hàng Chính Hãng -( Màu Và Chữ Ngẫu Nhiên)",94050,99000,4950,5
TIKI,nha-cua-doi-song,106677814,"Hộp thuỷ tinh chữ nhật Nikko 370 ml",43000,43000,0,0
TIKI,nha-cua-doi-song,66877577,"Hộp đựng cơm thủy tinh cao cấp 3 ngăn ( Giao mầu ngẫu nhiên)",89000,89000,0,0
TIKI,nha-cua-doi-song,184591044,"Đèn Pixar, Đèn Bàn Chống Cận Thị, Đèn Đọc Sách LED, Đèn Làm Việc Bảo Vệ Mắt - Hàng Chính Hãng",258000,320000,62000,19
TIKI,nha-cua-doi-song,134360858,"Bộ 8 Pin AA Panasonic 1,5V Không chì , Pin không chảy nước R6DT/4S - Hàng chính hãng",38000,60000,22000,37
TIKI,nha-cua-doi-song,121162213,"Set 10 Móc Treo Quần Áo Người Lớn Jodily inox 304 Sáng Bóng Bền Mãi Với Thời Gian",150000,150000,0,0
TIKI,dien-thoai-may-tinh-bang,197214029,"Apple iPhone 14",16490000,24990000,8500000,34
TIKI,nha-cua-doi-song,17164211,"Bộ 13 mũi khoan đa năng lục giác",44999,44999,0,0
TIKI,dien-thoai-may-tinh-bang,217706932,"Combo Máy đọc sách All New Kindle Paperwhite 5 (11th Gen) và Bao da - Hàng nhập khẩu",3980000,3980000,0,0
TIKI,nha-cua-doi-song,125149573,"Sáo Tiêu Recorder Soprano Yamaha YRS-402, YRS-20,YRS-24B Chính Hãng, Độ Bền Cao, Chất Liệu ABS An Toàn",135000,135000,0,0
TIKI,dien-thoai-may-tinh-bang,247823537,"Điện thoại Realme C55 (6GB/128GB) - Hàng chính hãng",3790000,4990000,1200000,24
TIKI,dien-thoai-may-tinh-bang,273942001,"Điện thoại Xiaomi Redmi Note 13 (6GB/128GB) - Hàng chính hãng",4090000,4490000,400000,9
TIKI,nha-cua-doi-song,176530481,"Chiếu điều hòa tencel Lidaco (Nhiều mẫu lựa chọn)",389000,560000,171000,31
TIKI,dien-thoai-may-tinh-bang,224873580,"Điện thoại Masstel izi 26 - Hàng chính hãng ",600000,600000,0,0
TIKI,dien-thoai-may-tinh-bang,274639765,"Điện thoại OPPO A2M 5G 6GB/128GB , Dimensity 6020 , Màn 90Hz , Rom tiếng việt - Hàng chính hãng",2990000,3690000,700000,19
TIKI,dien-thoai-may-tinh-bang,274544634,"Điện thoại Redmi Note 12R 5G 6/128GB Snapdragon 4 Gen 2, Rom Quốc tế có sẳn Tiếng việt - Hàng nhập khẩu",3050000,3590000,540000,15
TIKI,nha-cua-doi-song,20575031,"VÒI LAVABO LẠNH INOX SUS304",165000,165000,0,0
TIKI,nha-cua-doi-song,106281062,"Bộ 6 Ly Bia Thuỷ Tinh Luminarc Benidorm 450ml - LUBEG2616",309000,386000,77000,20
TIKI,nha-cua-doi-song,26149459,"Bộ Muỗng Đũa Cơm Trưa INOX 304 Thiết Kế Sang Trọng Mạ PVD Cao Cấp - Xanh Da Trời",120000,120000,0,0
TIKI,nha-cua-doi-song,34816875,"Dụng Cụ Thông Tắc Cống, Kẹp Gắp Rác Đa Năng Loại Tốt",21000,21000,0,0
TIKI,nha-cua-doi-song,77746708,"Dây đèn led đom đóm trang trí pin không nháy tiểu dây bóng đèn fairy light cao cấp, tinh tế sang trọng decor phòng, du lịch, lều trại, luôn sáng - Chính hãng DEHA",35000,65000,30000,46
TIKI,nha-cua-doi-song,51343718,"Thau Gập Gọn - Chậu Nhựa Gấp Gọn Đa Năng1 2x35cm, nhiều màu, giao màu ngẫu nhiên+ Tặng kèm móc treo",68135,126000,57865,46
TIKI,dien-thoai-may-tinh-bang,204671569,"Điện Thoại Oppo A17k 3GB/64GB - Hàng Chính Hãng",2529000,3290000,761000,23
TIKI,nha-cua-doi-song,42270992,"Bình Giữ Nhiệt Rinfere, Với Miệng Rộng, Nắp Quai Cầm - Nhiều Kích Cỡ Và Màu Sắc",305000,499000,194000,39
TIKI,dien-thoai-may-tinh-bang,121059239,"Máy Tính Bảng Samsung Galaxy Tab A7 Lite T225 3GB/32GB - Hàng Chính Hãng",3587000,3587000,0,0
TIKI,dien-thoai-may-tinh-bang,263073487,"Điện thoại Tecno CAMON 20 Pro 8GB/256GB - Camera 64MP + 32MP | Helio G99 | 5000 mAh/ 33W | 6.7'' FHD AMOLED - Hàng Chính Hãng - BH 13 Tháng",5490000,5490000,0,0
TIKI,dien-thoai-may-tinh-bang,274191773,"Điện thoại ZTE Libero 5G IV - 4GB/128GB Dimensity 700 , Kháng nước IP67 , Sạc nhanh 22,5W - Mới nguyên seal - Hàng nhập khẩu",2350000,2990000,640000,21
TIKI,nha-cua-doi-song,80874505,"Cốc gấu đựng bàn chải kem đánh răng, Cốc gấu dán tường siêu dính",14999,14999,0,0
TIKI,dien-thoai-may-tinh-bang,272555368,"XIAOMI 13T 5G (12GB-256GB) - Hàng chính hãng",11385000,11990000,605000,5
TIKI,nha-cua-doi-song,116199362,"Ly thủy tinh có chia vạch 625ml-B00322 ",35000,35000,0,0
TIKI,nha-cua-doi-song,93780998,"Đồng hồ hẹn giờ đếm ngược dùng trong nấu ăn, pha chế",185000,200000,15000,8
TIKI,nha-cua-doi-song,128935485,"Thìa Ăn Phở Ăn Soup - Inox 304 Jodily Cao Cấp Sáng Bóng Bền Mãi Với Thời Gian",15000,15000,0,0
TIKI,nha-cua-doi-song,117282929,"Phích ổ cắm đa năng LiOA chuyển 3 chân thành 2 chân 15A/220V Chân Tròn/Dẹt - Ổ điện chuyển đổi từ 3 chấu sang 2 chấu",18000,18000,0,0
TIKI,nha-cua-doi-song,165758266,"Bộ dao 3 chiếc Eco Family Sunhouse KS-KN3E1",283000,438000,155000,35
TIKI,dien-thoai-may-tinh-bang,274392442,"Điện thoại Oppo A38 - Hàng chính hãng",4490000,4490000,0,0
TIKI,dien-thoai-may-tinh-bang,262908601,"Máy tính bảng chắc chắn oukitel RT3 (chống nước,chống va đập,Ram 4Gb,Rom 64 Gb,màn hình 8 inch,pin 5150 mAh)- hÀng chính hãng",4990000,4990000,0,0
TIKI,dien-thoai-may-tinh-bang,274536294,"Máy đọc sách Kindle Paperwhite 5 (16GB) - Hàng chính hãng",4050000,4990000,940000,19
TIKI,nha-cua-doi-song,134407128,"Tủ Kệ Sách Trang Trí, Làm Từ Gỗ Công Nghiệp rẻ vô địch, Chất Lượng Cao, Dễ Dàng Lắp Ghép Nhiều Ngăn Để Đồ tiện lợi",252000,252000,0,0
TIKI,dien-thoai-may-tinh-bang,273664463,"Điện Thoại Oppo A18 4GB/128GB - Hàng Chính Hãng",3499000,3990000,491000,12
TIKI,dien-thoai-may-tinh-bang,270074304,"Điện Thoại Xiaomi Redmi Note 12S 8GB/256GB - Hàng Chính Hãng",4739000,6690000,1951000,29
TIKI,dien-thoai-may-tinh-bang,242434782,"Máy đọc sách New Kindle 11th 2022 (16GB) - Hàng nhập khẩu",2920000,2920000,0,0
TIKI,nha-cua-doi-song,72751318,"Báo Động Chống Trộm, Chuông Báo Khách Mở Cửa Đa Chức Năng Có Điều Khiển Từ Xa MC - 02, Báo Động Nhiều Chế Độ : Chống Trộm Xâm Nhập , Báo Chuông Cửa..",205000,249000,44000,18
TIKI,dien-thoai-may-tinh-bang,273016223,"Điện Thoại Xiaomi Redmi A2 2GB/32GB - Hàng Chính Hãng",1729000,2190000,461000,21
TIKI,dien-thoai-may-tinh-bang,274116886,"Điện Thoại Xiaomi Redmi A2+ 3GB/64GB - Hàng Chính Hãng",1989000,2790000,801000,29
TIKI,dien-thoai-may-tinh-bang,153581522,"Máy đọc sách All new Paperwhite Gen 5 (11th) màn hình 6.8 inch có đèn vàng warmlight",3690000,3800000,110000,3
TIKI,dien-thoai-may-tinh-bang,257861524,"Điện thoại để bàn tân cổ điển phím quay DT11",3500000,3500000,0,0
TIKI,dien-thoai-may-tinh-bang,270832077,"Điện thoại Xiaomi Redmi 12 (4GB-128GB) - Hàng Chính Hãng",3890000,3890000,0,0
TIKI,nha-cua-doi-song,53472238,"Kệ gỗ thông để giày đa năng",129800,129800,0,0
TIKI,dien-thoai-may-tinh-bang,270636882,"Điện Thoại Samsung M14 5G 4GB/64GB - Hàng Chính Hãng",2989000,4990000,2001000,40
TIKI,dien-thoai-may-tinh-bang,274101262,"Máy Tính Bảng Samsung Galaxy Tab A9 Plus Wifi 4GB/64GB - Hàng Chính Hãng",3990000,5990000,2000000,33
TIKI,dien-thoai-may-tinh-bang,270978486,"Điện thoại Samsung Galaxy M14 5G (6GB/128GB) - Đã kích hoạt bảo hành điện tử - Hàng chính hãng",3910000,5690000,1780000,31
TIKI,nha-cua-doi-song,37730520,"Thanh treo quần áo 4 chấu dán tường Hobby 4TV160 chuẩn Inox 304 - kèm keo dán siêu dính",147000,219000,72000,33
TIKI,dien-thoai-may-tinh-bang,270510406,"Điện thoại Vivo Y36 (8GB/128GB) - Hàng Chính Hãng - Camera 50MP - Sạc Nhanh 44W",5190000,5190000,0,0
TIKI,nha-cua-doi-song,7699055,"Chảo Nhôm Chống Dính Lock&Lock Baum Marble 1 Tay Cầm LBU1243C (24cm)",235000,451000,216000,48
TIKI,nha-cua-doi-song,98556230,"Kệ Gỗ Trang Trí Treo Tường Không Cần Khoan Với Móc Treo Inox Và Đầy Đủ Phụ Kiện Tặng Kèm, Dễ Dàng Gắn Lên Tường",119000,125000,6000,5
TIKI,dien-thoai-may-tinh-bang,273127929,"Điện thoại Xiaomi 13T 12GB-256GB - Hàng Chính Hãng",12990000,12990000,0,0
TIKI,dien-thoai-may-tinh-bang,270707514,"Máy Đọc Sách BOOX Tab Mini C - Hàng Chính Hãng",11850000,12990000,1140000,9
TIKI,dien-thoai-may-tinh-bang,271730109,"Điện thoại chắc chắn Ulefone Armor X13, (Ram 12GB(6Gb+6Gb),Rom 64GB,chống nước,chống va đập IP68/IP69K, Android 13,CPU MediaTek Helio G36 Octa Core,Màn hình 6,52 inch, Mạng: 4G, NFC,OTG)-hàng chính hãng",3990000,3990000,0,0
TIKI,nha-cua-doi-song,146393649,"Ngăn Mùi Hôi Cống  Ngăn Mùi Thoát Sàn Silicon-Nút Bịt Ống Cống Chống Hôi Hiệu Quả 100%",9499,9999,500,5
TIKI,dien-thoai-may-tinh-bang,273258830,"Điện thoại Samsung Galaxy A05 (4GB/128GB) - Đã kích hoạt bảo hành điện tử -Hàng chính hãng",2590000,3050000,460000,15
TIKI,nha-cua-doi-song,120166109,"Bóng Philips LED bulb Essential E27 (5W,7W,9W,11W,13W) - E27 (3000K/6500K)",50600,52200,1600,3
TIKI,dien-thoai-may-tinh-bang,271218081,"Máy đọc sách Kindle Oasis Edition 3 (8GB) - Hàng chính hãng",6500000,7690000,1190000,15
TIKI,dien-thoai-may-tinh-bang,153581568,"Điện thoại Masstel IZI 55 4G - Hàng chính hãng",659000,659000,0,0
TIKI,nha-cua-doi-song,74986118,"Màng Bọc Thực Phẩm PE Shinsen 30 x 40000",163000,163000,0,0
TIKI,dien-thoai-may-tinh-bang,273366296,"ulefone Armor 24 (TIÊU CHUẨN MIL-STD-810H ,IP69K, chống nước ,chống sốc,pin 22000mah , màn hình6,78 inch, NFC, Ram24GB(12Gb+12Gb),rom 256GB)-hàng chính hãng ",7990000,7990000,0,0
TIKI,dien-thoai-may-tinh-bang,274019932,"Điện thoại Masstel Izi 56 4G (LTE) Gọi HD Call ,Pin khủng ,loa lớn - Hàng Chính Hãng",548000,650000,102000,16
TIKI,dien-thoai-may-tinh-bang,168320000,"Điện Thoại Xiaomi Redmi 9A (2GB/32GB)- Đã kích hoạt bảo hành điện tử- Hàng Chính Hãng - Granite Gray",2088000,2088000,0,0
TIKI,dien-thoai-may-tinh-bang,258330471,"Điện thoại để bàn tân cổ điển phím bấm DT08, Điện thoại nghe gọi được",3500000,3500000,0,0
TIKI,dien-thoai-may-tinh-bang,252428990,"Điện thoại Tecno SPARK 10 Pro 8GB/256GB - Helio G88 | 5000 mAh | Sạc nhanh 18W | Cảm ứng vân tay - Hàng chính hãng",4149000,4490000,341000,8
TIKI,dien-thoai-may-tinh-bang,249890023,"Điện Thoại Xiaomi Redmi Note 12 Pro 5G 8GB/256GB - Hàng Chính Hãng",7249000,9490000,2241000,24
TIKI,dien-thoai-may-tinh-bang,262514707,"Điện thoại Xiaomi Redmi Note 12 Pro (8GB/256GB) - Hàng chính hãng",7990000,7990000,0,0
TIKI,nha-sach-tiki,170094970,"Bách Khoa Lịch Sử Thế Giới - Tái Bản",400000,550000,150000,27
TIKI,nha-sach-tiki,182541449,"Billy Summers - Vụ Ám Sát Cuối Cùng",208200,299000,90800,30
TIKI,nha-sach-tiki,87569364,"Bộ Dụng Cụ Vẽ Phác Thảo 27 Phụ Kiện Deli - Vẽ Mỹ Thuật - 1 Bộ - 58125",286200,286200,0,0
TIKI,nha-sach-tiki,189161030,"Điều Thuộc Về Em",89000,138000,49000,36
TIKI,nha-sach-tiki,62686754,"Thanh Gươm Diệt Quỷ Tập 14: Mu Trong Muichiro",25000,25000,0,0
TIKI,nha-sach-tiki,177312713,"Tâm Lý Học Thấu Hiểu Bản Thân",88000,119000,31000,26
TIKI,nha-sach-tiki,50246190,"Life A1 - A2 : Student Book with Web App Code with Online Workbook (British English) (Viet Nam Edition) (Second Edition)",234000,260000,26000,10
TIKI,nha-sach-tiki,100285591,"Bảng Tóm Tắt Toán Tiểu Học",5600,7000,1400,20
TIKI,nha-sach-tiki,177564112,"Cẩm Nang Tư Duy Phản Biện & Lập Luận Hiệu Quả",105000,160000,55000,34
TIKI,nha-sach-tiki,35924699,"Hộp 12 cây bút chì 2b Đức ( Hàng loại 1)",58000,58000,0,0
TIKI,nha-sach-tiki,104935828,"Truyện Ngắn Nguyễn Huy Thiệp (Bìa Cứng) - Ấn Bản Kỷ Niệm 70 Năm Ngày Sinh Tác Giả - Với Minh Họa Của Các Họa Sĩ (Tái Bản - Bìa Xanh)",295000,450000,155000,34
TIKI,nha-sach-tiki,192398103,"Cấu Trúc Dữ Liệu Và Thuật Toán (Xuất bản lần thứ năm - năm 2023)",138000,138000,0,0
TIKI,nha-sach-tiki,31375305,"Sống Lành Để Trẻ",59000,85000,26000,31
TIKI,nha-sach-tiki,111059103,"Bút dạ kính 2 đầu Deli - không xóa được, mực vĩnh cửu - Mực Đen/Xanh/Đỏ - 1 cây - EU10420 / EU10430 / EU10440",16200,16200,0,0
TIKI,nha-sach-tiki,131497044,"Sách 33 Bài Thực Hành Giúp Phát Triển Não Bộ Cho Trẻ Theo Phương Pháp Shichida",82100,118000,35900,30
TIKI,nha-sach-tiki,91343901,"Huyễn Tưởng Về Trí Tuệ Nhân Tạo",130000,169000,39000,23
TIKI,nha-sach-tiki,10392851,"Tôi Thấy Hoa Vàng Trên Cỏ Xanh",102000,150000,48000,32
TIKI,nha-sach-tiki,186575354,"Siddhartha",102000,120000,18000,15
TIKI,nha-sach-tiki,273643617,"Trạm Đọc Official | Sách: Quốc Gia Khởi Nghiệp",156000,209000,53000,25
TIKI,nha-sach-tiki,186290791,"Cô gái đến từ hôm qua (Tái Bản 2022)",59000,85000,26000,31
TIKI,nha-sach-tiki,92993878,"Truyện đọc cho bé trước giờ đi ngủ",70560,98000,27440,28
TIKI,nha-sach-tiki,120460868,"Thay Đổi Câu Hỏi Thay Đổi Cuộc Đời (Tái bản 2021 có bổ sung)",46000,63000,17000,27
TIKI,nha-sach-tiki,156821160,"Tổng Quan Về Tarot (Bìa Cứng)",226000,350000,124000,35
TIKI,nha-sach-tiki,179735870,"Ta Chỉ Gặp Nhau Vào Ban Đêm (Tặng Kèm 03 postcard (10x15 cm) + 01 bookmark)",93700,129000,35300,27
TIKI,nha-sach-tiki,107707548,"Nụ Hôn Dối Lừa (Bộ 2 Tập) - Biên Niên Sử Còn Sót Lại - Phần 1 (Tặng Kèm Bộ 2 Postcard)",120000,228000,108000,47
TIKI,nha-sach-tiki,167019723,"TalMud - Tinh Hoa Trí Tuệ Do Thái (Tái Bản)",85800,110000,24200,22
TIKI,nha-sach-tiki,170298038,"Harvard Bốn Rưỡi Sáng",102000,139000,37000,27
TIKI,nha-sach-tiki,145092099,"Thì Và Sự Phối Hợp Thì Trong Tiếng Anh",45000,70000,25000,36
TIKI,nha-sach-tiki,21130352,"Mùa Gặt Đỏ - Trinh Thám Cổ Điển Phương Tây",51000,102000,51000,50
TIKI,nha-sach-tiki,167034122,"Spotify Và Những Chuyện Chưa Kể  - Hành Trình Đánh Bại Apple, Google Và Amazon Trong Cuộc Đua Âm Thanh Số Của Nhà Sáng Lập Daniel Ek",137000,175000,38000,22
TIKI,nha-sach-tiki,2430427,"Thùng 5 Ream Giấy In Photo A4 Excel DL 80gsm",350000,350000,0,0
TIKI,nha-sach-tiki,88979638,"Sổ tay ghi chép A5 gáy xoắn 60 trang Deli - Kẻ ngang - Màu ngẫu nhiên - LA560-01",18000,37800,19800,52
TIKI,nha-sach-tiki,188930496,"Những Chàng Trai Ở Lộc Phong Quán – Tập 3 (Tái Bản)",39300,48000,8700,18
TIKI,nha-sach-tiki,77105728,"Có Thanh Xuân Nào Không Đau Đớn, Có Tuổi Trẻ Nào Không Bão Giông",100000,129000,29000,22
TIKI,nha-sach-tiki,31219037,"Làm Chủ Tuổi 20 (Phiên bản mới) - Dành cho độc giả từ 16-30",198000,198000,0,0
TIKI,nha-sach-tiki,2612737,"Thùng 5 ram giấy A4 Double A 70gsm",400000,400000,0,0
TIKI,nha-sach-tiki,116656411,"Bán hàng thời kỹ thuật số (Digital Selling: How to Use Social Media and the Web to Generate Leads and Sell More) - Tác giả: Grant Leboff",96000,96000,0,0
TIKI,nha-sach-tiki,43341578,"Tiểu Thuyết Trinh Thám 1/14 - Tập 3 - Lời Cảnh Báo (Tái Bản)",109000,175000,66000,38
TIKI,nha-sach-tiki,16564276,"TNT TOEIC - Intensive (Third Edition) (Kèm file MP3)",224000,298000,74000,25
TIKI,nha-sach-tiki,186880522,"Bí Mật Tiền Bạc Của Giới Siêu Giàu",71000,108000,37000,34
TIKI,nha-sach-tiki,180396223,"Sách 7 Thói Quen Hiệu Quả (The 7 Habits Of Highly Effective People)- Tặng sổ tay",235000,250000,15000,6
TIKI,nha-sach-tiki,381274,"Cẩm Nang Dưỡng Sinh Thông Kinh Lạc",224000,298000,74000,25
TIKI,nha-sach-tiki,43341584,"Tiểu Thuyết Trinh Thám 1/14 - Tập 5 - 14 Ngày Kinh Hoàng (Tái Bản)",105000,168000,63000,38
TIKI,nha-sach-tiki,25980689,"Complete IELTS B2 Student's Book with answer & CD-Rom",256700,279000,22300,8
TIKI,nha-sach-tiki,35473845,"Định Mệnh Chiến Tranh",137000,246000,109000,44
TIKI,nha-sach-tiki,2469667,"Dạy Con Theo Phương Pháp Montessori - Tớ Là Bạn Tốt",12240,13600,1360,10
TIKI,nha-sach-tiki,58063000,"Sông - Nguyễn Ngọc Tư (Tiểu Thuyết)(Tái Bản)",69380,99000,29620,30
TIKI,nha-sach-tiki,47161879,"Bách Khoa Toàn Thư Giáo Dục Và Phát Triển  Tâm Lý Tính Cách Trẻ 0 -6 Tuổi",104000,160000,56000,35
TIKI,nha-sach-tiki,137694341,"My First 1000 English Words - 1000 Từ Tiếng Anh Đầu Tiên Cho Bé (Bìa Cứng) (Tái Bản)",87100,120000,32900,27
TIKI,nha-sach-tiki,193897099,"Cuộc săn cừu hoang",107000,136000,29000,21
TIKI,nha-sach-tiki,67477617,"Phát Triển Trí Tuệ Cảm Xúc- Sự Tử Tế Đẹp Như Bông Hoa",37100,50000,12900,26
TIKI,nha-sach-tiki,171549942,"Black Jack 08 (Bìa Cứng)",131000,135000,4000,3
TIKI,nha-sach-tiki,47339151,"Sống Xanh Như Những Lá Trà",81000,109000,28000,26
TIKI,nha-sach-tiki,32921595,"Sổ Tay Học Nhanh , Toàn Diện Kiến Thức Và Dạng Bài Hóa Học Lớp 8 - 9",46600,68000,21400,31
TIKI,nha-sach-tiki,194205615,"Anh Chàng Hobbit",130000,175000,45000,26
TIKI,nha-sach-tiki,181920224,"Băng Keo Trong, Đục 100 Yard 1 Cây 6 Cuộn Nặng 1Kg Đóng hàng",44400,44400,0,0
TIKI,nha-sach-tiki,576300,"Hướng Dẫn Tự Lắp Ráp 100 Mạch Điện - Điện Tử",50000,50000,0,0
TIKI,nha-sach-tiki,94383325,"Người Bà Tài Giỏi Vùng Saga - Tập 3",41600,52000,10400,20
TIKI,nha-sach-tiki,23134440,"Hỷ Lạc Từ Tâm",96500,150000,53500,36
TIKI,nha-sach-tiki,189558189,"Vị Thần Lang Thang - Tập 23 [Tặng Kèm Postcard]",20000,20000,0,0
TIKI,nha-sach-tiki,159814614,"Đại Học Nghệ Thuật Tokyo",118000,149000,31000,21
TIKI,nha-sach-tiki,45299959,"Căn Bản Kỹ Thuật Nhiếp Ảnh",127000,135000,8000,6
TIKI,nha-sach-tiki,193450582,"Metaverse Handbook",145500,209000,63500,30
TIKI,nha-sach-tiki,2583027,"Bé Bao Dung",11500,23000,11500,50
TIKI,nha-sach-tiki,192339432,"Giao Tiếp Cơ Bản – Cẩm Nang Làm Chủ Mọi Cuộc Trò Chuyện",102000,129000,27000,21
TIKI,nha-sach-tiki,156968646,"Thiệp chúc mừng sinh nhật 12x12 SDstationery CLASSY BLUE họa tiết bong bóng, nến, màu xanh đơn giản tinh tế",50000,59400,9400,16
TIKI,nha-sach-tiki,13105198,"Combo Kĩ Năng Giao Tiếp - Dành Cho Bé 2-6 Tuổi (Trọn Bộ 10 cuốn)",107000,150000,43000,29
TIKI,nha-sach-tiki,115768007,"Ruột bút bi cao cấp PARKER",153000,180000,27000,15
TIKI,nha-sach-tiki,104273044,"3000 câu Ngữ Pháp và Từ Vựng hay sai – Cô Trang Anh",119000,200000,81000,41
TIKI,nha-sach-tiki,185854301,"Những bài đồng dao cho bé (Minh họa bằng tranh theo chủ đề - Dành cho bé tập nói, tập đọc)",36400,70000,33600,48
TIKI,nha-sach-tiki,35761355,"Binh Pháp Tôn Tử Trong Kinh Doanh",82100,118000,35900,30
TIKI,nha-sach-tiki,191782133,"Không Phải Huyền Thoại - Tiểu Thuyết Lịch Sử Đầu Tiên Về Đại Tướng Võ Nguyên Giáp Trong Chiến Dịch Điện Biên Phủ",152100,255000,102900,40
TIKI,nha-sach-tiki,193701771,"Truyện Cổ Nhật Bản",156000,209000,53000,25
TIKI,nha-sach-tiki,80927136,"Hệ thống bài tập & câu hỏi trắc nghiệm nguyên lý kế toán ",24000,24000,0,0
TIKI,nha-sach-tiki,185055215,"Kinh Doanh Nhỏ Thu Lợi Lớn (Tái Bản 2022)",63600,99000,35400,36
TIKI,nha-sach-tiki,179952631,"Chiến Dịch Trị - Thiên 1972",233300,280000,46700,17
TIKI,nha-sach-tiki,186237327,"Livestream – Hướng dẫn chi tiết cách kiếm tiền từ livestream",131600,189000,57400,30
TIKI,nha-sach-tiki,109982964,"Những Thăng Trầm Trong Cuộc Đời Và Sự Nghiệp Của Andersen",47500,60000,12500,21
TIKI,nha-sach-tiki,165030731,"Vượt Qua Chuyện Sao Hỏa - Sao Kim",89200,160000,70800,44
TIKI,nha-sach-tiki,730580,"Tuần Của Bé Tháng 7 - Bé Đảm Đang",11500,23000,11500,50
TIKI,nha-cua-doi-song,164771128,"Roi mây dẻo dai siêu thần thánh",22500,30000,7500,25
TIKI,nha-cua-doi-song,53830664,"Mùng ngủ không cửa giăng dây 4 góc truyền thống - Vải tuyn dày lỗ nhỏ chống muỗi tuyệt đối",155000,155000,0,0
TIKI,nha-cua-doi-song,132276408,"Ron pvc chặn khe hở - Thanh cao su dán chân cửa chắn khe hở, chống côn trùng, cách âm, phù hợp mọi loại cửa RPVC",35000,35000,0,0
TIKI,nha-cua-doi-song,112072065,"Túi Đựng Hộp Cơm Giữ Nhiệt - Túi Trữ Lạnh Cao Cấp Chống Thấm Nước – Túi Giữ Nhiệt Hàng Chính Hãng",36000,70000,34000,49
TIKI,nha-cua-doi-song,72707434,"BỘ KÍCH THÉP DI CHUYỂN ĐỒ NẶNG 500KG 12 BÁNH PU XOAY 360° GOODTOOL35",275000,275000,0,0
TIKI,nha-cua-doi-song,14257715,"Dụng Cụ Lấy Dấu, Định Vị Điểm Khoan - Chống Trượt",27999,27999,0,0
TIKI,nha-cua-doi-song,74329992,"Hộp Đựng Trang Sức Nữ Trang Cỡ Lớn Da Cao Cấp",150000,150000,0,0
TIKI,nha-cua-doi-song,76514380,"Ổ Cắm Điện Đa Năng Chống Giật Có 3 Cổng USB – Sạc Trực Tiếp – Tiết Kiệm Điện – Bộ Ổ Cắm Điện Xanh Lá Cao Cấp Chính Hãng Amalife - DE30",55000,55000,0,0
TIKI,nha-cua-doi-song,95333782,"Đế lót chậu cây có bánh xe MONROVIA, đế để chậu cây, kệ chậu cây do động, có bánh xe, mặt tròn hoặc vuông bằng gỗ tràm cao cấp loại 1, trên 10 năm tuổi, màu vàng đường kinh 30 cm, chính hãng thương hiệu MONROVIA",85000,85000,0,0
TIKI,nha-cua-doi-song,185380278,"Bình Xịt Nhật Bản - TAIKOMI Japan Chống Thấm Vết Nứt Mái Nhà, Sàn Nhà Vệ Sinh, Máng Xối, Mái Tôn, Sàn Nhà",99185,135000,35815,27
TIKI,nha-cua-doi-song,119446046,"Bát Tô Canh Sứ Trắng Đủ Size - Tô khum Sứ Long Phương - 6 inch",38400,38400,0,0
TIKI,nha-cua-doi-song,54075243,"Gối cao su non chống ngáy người lớn chất lượng êm ái cho giấc ngủ sâu hơn, gối cao su non, gối chống mỏi cổ, gối chống mỏi gáy (màu ngẫu nhiên)",49000,58997,9997,17
TIKI,nha-cua-doi-song,85763912,"Ghế đôn hộp, ghế ngồi kiêm hộp đựng đồ 2 IN 1. Ghế ngồi đa năng mẫu mới",149000,149000,0,0
TIKI,nha-cua-doi-song,53116344,"Súng bắn keo nến silicon + Tặng 10 cây keo silicon nến",35000,35000,0,0
TIKI,nha-cua-doi-song,117212183,"Ổ Cắm Nối Chia 3 Lioa, Phích Cắm 1 ra 3 Lioa - MITA",22000,22000,0,0
TIKI,nha-cua-doi-song,171174862,"Vỏ Thay Thế Cho Gối Nooz Mềm Mịn Kháng Khuẩn Và Không Gây Kích Ứng Da",150000,150000,0,0
TIKI,nha-cua-doi-song,70002562,"BÁO ĐỘNG CHỐNG TRỘM HỒNG NGOẠI HT1A-S 3 NÚT, 180-220V AC - 50Hz.",190000,190000,0,0
TIKI,nha-cua-doi-song,50098102,"Tủ Vải Quần Áo 3 Buồng 8 Ngăn To, Bền - Hàng Chính Hãng",385000,550000,165000,30
TIKI,nha-cua-doi-song,142989680,"Màn chụp tự bung đỉnh vuông Bảo An - Mẫu mùng chụp tự bung có viền chân chống muỗi tuyệt đối",207343,207343,0,0
TIKI,nha-cua-doi-song,143779168,"Thảm ngủ cá nhân văn phòng",25000,25000,0,0
TIKI,nha-cua-doi-song,135442231,"Máy Khoan Deli Chính Hãng Pin 12V Bắt Vít - Nhỏ Gọn, Tiện Dụng - Dùng Cho Sửa Chữa Vật Dụng - DL600012",551000,1006200,455200,45
TIKI,nha-cua-doi-song,189373783,"Máy Rửa Xe Mini Deli Công Suất Lớn - Tiết Kiệm Điện Năng, Phun Rửa Đa Năng - DL882201",1349000,2399000,1050000,44
TIKI,nha-cua-doi-song,120470467,"Bộ 6 Ly Cao Thuỷ Tinh Luminarc Louvre 350ml - LULON1807 ",289000,289000,0,0
TIKI,nha-cua-doi-song,696349,"Ổ Cắm Điện 4 Lỗ 3 Chấu 3m Philips SPN1248WB/74 (2500W)",280000,299000,19000,6
TIKI,nha-cua-doi-song,152446542,"Cây Cau Tiểu Trâm - cây cảnh để bàn",33000,46000,13000,28
TIKI,nha-cua-doi-song,51044868,"Vòi sen tăng áp, bát sen tắm inox 304 KAMA PK03, vòi nước tăng áp, bát sen tăng áp inox 304, bề mặt inox 304 nguyên bản, không rỉ sét, vòi sen tắm tăng áp lực nước",180000,180000,0,0
TIKI,nha-cua-doi-song,59273521,"Combo 02 Khăn tắm, khăn mặt FUNU, mềm mịn, siêu thấm, kháng khuẩn - Hàng chính hãng, hàng nhiều mẫu design, giao mẫu ngẫu nhiên",92000,100000,8000,8
TIKI,nha-cua-doi-song,19560656,"Bộ 4 Chiếc Kẹp Ga Giường",49000,49000,0,0
TIKI,nha-cua-doi-song,165029589,"VỢT BẮT MUỖI CAO CẤP 2 IN 1 DP - 834",99000,99000,0,0
TIKI,nha-cua-doi-song,138814386,"Set 10 móc phơi quần áo inox dày bọc nhựa cao cấp",25000,25000,0,0
TIKI,nha-cua-doi-song,57894229,"Kệ đựng để đồ đa năng có bánh xe 3 tầng (giao màu ngẫu nhiên)",80000,80000,0,0
TIKI,nha-cua-doi-song,96180139,"Chân đàn Organ/ Piano đa năng - Kzm Kurtzman STX1 - Dáng chữ X đơn - Màu đen - Hàng chính hãng",140000,140000,0,0
TIKI,nha-cua-doi-song,161024967,"Combo 2 hộp chia ngăn sắp xếp quần áo phong cách Nhật Bản Mai Anh House",210000,210000,0,0
TIKI,nha-cua-doi-song,67910007,"Vỉ 20 nẹp cố định dây điện dán tường, bàn ghế",12999,12999,0,0
TIKI,nha-cua-doi-song,62292300,"Bộ vòi sen tắm lạnh – tay sen tăng áp  (Hàng chính hãng)",209000,350000,141000,40
TIKI,nha-cua-doi-song,125667836,"Bộ Cờ Lê 14 Chi Tiết",235000,235000,0,0
TIKI,nha-cua-doi-song,13369293,"Bịt mắt ngủ có túi giải nhiệt làm mát mắt - #10",68000,68000,0,0
TIKI,nha-cua-doi-song,51368456,"Bộ 6 thìa Inox 304 pha nước (số 12)",174000,210000,36000,17
TIKI,nha-cua-doi-song,30691895,"Dụng cụ tách sò huyết inox cao cấp",40000,40000,0,0
TIKI,nha-cua-doi-song,5429807,"Bộ 50 cút nối dây điện nhanh CH-2",31000,31000,0,0
TIKI,nha-cua-doi-song,20484673,"Nắp ngồi rơi êm cao cấp thay thế cho các loại bồn cầu INAX thân dài 504-702-700-710-808-900",295000,295000,0,0
TIKI,nha-cua-doi-song,124480954,"Nhang trầm hương tự nhiên Thiên Mộc Hương, 20cm, Ít Khói, Mùi thơm nhẹ diu, an toàn cho sức khỏe",135000,200000,65000,33
TIKI,nha-cua-doi-song,16170433,"Combo 3 lõi lọc nước yamato 1,2,3 - 10 inch",143000,155000,12000,8
TIKI,nha-cua-doi-song,54348370,"Kệ di động Inochi hàng cao cấp",140000,150000,10000,7
TIKI,nha-cua-doi-song,133866129,"Móc Dán Tường Inox 304 Sang Trọng, Cứng Cáp, Dùng Keo 3M, Nhiều Kiểu Dáng Đẹp",43000,43000,0,0
TIKI,nha-cua-doi-song,51238343,"Túi Lọc Trà Lọc Gia Vị Vải Không Dệt (combo 100 túi)",28000,28000,0,0
TIKI,nha-cua-doi-song,134351529,"Đũa Gỗ Dùng 1 Lần KETILO Cao Cấp, Thân Thiện Với Môi Trường, Không Hóa Chất Độc Hại, An Toàn Sức Khỏe Người Dùng(Giao Ngẫu Nhiên) - CHÍNH HÃNG ĐG001",45000,53000,8000,15
TIKI,nha-cua-doi-song,4777363,"Bàn làm việc gấp gọn có khe cắm ipad - giao màu ngẫu nhiên",71000,71000,0,0
TIKI,nha-cua-doi-song,91063233,"Hạt Giống Hoa Mãn Đình Hồng Kép Nhiều Màu 20 hạt",13000,15260,2260,15
TIKI,nha-cua-doi-song,89642725,"Bình xịt nước tưới cây bằng nhựa, bình xịt nước tạo mẫu tóc, xịt nước làm bánh cao cấp - Hàng chính hãng, giao màu ngẫu nhiên",42750,45000,2250,5
TIKI,nha-cua-doi-song,70809147,"SET 2 TÚI ĐỰNG QUẦN ÁO KHUNG THÉP GẤP GỌN 66L -  Dài 50 cm x Rộng 40 cm x Cao 33 cm",139000,139000,0,0
TIKI,nha-cua-doi-song,83847675,"Combo 30 bịch giấy ăn gấu trúc",55000,107500,52500,49
TIKI,nha-cua-doi-song,892129,"Pin Max 4 + 2 Viên Energizer E92 BP4+2 AAA",73000,73000,0,0
TIKI,nha-cua-doi-song,108201708,"Bộ Rổ Nhựa Kèm Chậu 6 Món Cao Cấp Vàng xanh hàng đẹp loại 1",32000,47000,15000,32
TIKI,nha-cua-doi-song,168641002,"Kệ Góc Đa Năng White Corner 5F Thông Minh Phong Cách Hiện Đại",322000,350000,28000,8
TIKI,nha-cua-doi-song,193713061,"Bàn Học Và Làm Việc Thông Minh Đa Năng Mặt Bàn Nghiêng 90 Độ, Bàn Laptop Xếp Gọn Có Bánh Xe - Hàng Chính Hãng",717000,999000,282000,28
TIKI,nha-cua-doi-song,171198348,"Ghế Xoay Văn Phòng Công Thái Học Ergonomic Có Ngả Lưng Gác Chân TANNI Premium 02 Plus, Ghế Xoay Gaming Cao Cấp Nhập Khẩu",1198000,2450000,1252000,51
TIKI,nha-cua-doi-song,70564013,"Bộ Tua Vít Bỏ Túi Đa Năng 24 Món - Tô Vít Sửa Chữa Mở Điện Thoại Vi Tính cao cấp",39000,196992,157992,80
TIKI,nha-cua-doi-song,199263969,"Bàn Trang Điểm Mini Ngồi Bệt Hiện Đại Thương Hiệu IGA - GP143",385000,419000,34000,8
TIKI,nha-cua-doi-song,142096809,"Bàn làm việc có giá sách 1,2m 1m thiết kế hiện đại có giá sách, chân sắt sơn tĩnh điện mặt gỗ mdf phủ melamine",525000,829000,304000,37
TIKI,nha-cua-doi-song,67989898,"Bàn Học Bàn Làm Việc Kết Hợp Kệ Sách GP73",250000,250000,0,0
TIKI,nha-cua-doi-song,126120768,"Ghế Xoay Văn Phòng Làm Việc Thư Giãn Cao Cấp YLF2199 Có Thể Làm Ghế Gaming - Hàng Nhập Khẩu",820000,1399000,579000,41
TIKI,nha-cua-doi-song,52581646,"Dây Đèn LED Rèm Trăng Sao Chống Thấm Nước Trang Trí Ngoài Trời - Dài 2.5 Mét",105000,105000,0,0
TIKI,nha-cua-doi-song,158564745,"Cuộn 220 Tờ Khăn Giấy Lau Bếp Đa Năng",8000,9990,1990,20
TIKI,nha-cua-doi-song,213491032,"Bàn để ủi quần áo khung bằng thép Lebenlang LBB363",659000,959000,300000,31
TIKI,nha-cua-doi-song,577125,"Thang Nhôm Gấp Chữ A Nikawa NKD-06 - 6 Bậc - 1.5 Mét",1480000,1680000,200000,12
TIKI,nha-cua-doi-song,6816541,"Cân tiểu ly điện tử 3000g - 0.1g. Cân tiểu li điện tử có độ chính xác cao",68000,68000,0,0
TIKI,nha-cua-doi-song,85512749,"Kẹp dán tường thông minh - Không cần khoan lỗ, đục tường- Chịu lực lên đến 3Kg",4000,4000,0,0
TIKI,nha-cua-doi-song,15212797,"Đèn led năng lượng mặt trời SUN-28200 200W, Đèn năng lượng mặt trời IP 67",410000,410000,0,0
TIKI,nha-cua-doi-song,580040,"Chảo Đá Chống Dính Siêu Bền Sunhouse SBD24 24cm",171000,320000,149000,47
TIKI,nha-cua-doi-song,167545572,"Bộ 2 hộp đựng đồ chia 7 ngăn sắp xếp quần áo dododios - Hộp vải đa năng HQ2 tiện ích, chất liệu cao cấp, phong cách Nhật Bản sang trọng",139000,139000,0,0
TIKI,nha-cua-doi-song,72754059,"Nệm Gấp Văn Phòng, Đệm Ngủ Trưa Văn Phòng Gấp Gọn Tiện Lợi, Mặt Vải Chống Thấm Tặng Túi Đựng Nệm - Kích Thước 70 x 190cm",280000,280000,0,0
TIKI,nha-cua-doi-song,135322547,"Set 10 Móc áo chống trượt Inochi Hara 186",45100,45100,0,0
TIKI,nha-cua-doi-song,128623891,"Dây chằng hàng tăng đơ (dây cảo) bản 25mm dài 3 - 5m tải trọng 500-800kg - capthepgiasi",50000,50000,0,0
TIKI,nha-cua-doi-song,19920919,"Bật Lửa Mồi Lửa Bếp Gas Bếp Cồn An Toàn (Màu Sắc Ngẫu Nhiên)",13990,13990,0,0
TIKI,nha-cua-doi-song,90852479,"Bộ liền 2 nhả kem đánh răng tự động, Giá treo bàn chải kèm 3 cốc hút từ tính lắp đặt dán tường - OE2KEM",245000,450000,205000,46
TIKI,nha-cua-doi-song,174299634,"Giá Treo Bàn Chải Nhà Tắm OENON - Bộ nhả kem đánh răng tự động kèm cốc và miếng dán tường - OEKEM",99000,190000,91000,48
TIKI,nha-cua-doi-song,16861361,"Nắp ly giữ nhiệt 900ml màu trắng",28000,28000,0,0
TIKI,nha-cua-doi-song,181909421,"Nồi Thấp Suit LocknLock CSU1242PIK – 24cm - Màu Pink",602000,1184000,582000,49
TIKI,nha-cua-doi-song,98650585,"Bộ Ga Gối Cotton Kẻ 3F Lidaco Chuyên Dụng Cho Homestay, Khách Sạn (Nhiều Mẫu Lựa Chọn)",189000,250000,61000,24
TIKI,dien-thoai-may-tinh-bang,191689878,"Điện thoại OPPO CPH2387 - A57 Xanh - Hàng Chính Hãng",4632000,4632000,0,0
TIKI,dien-thoai-may-tinh-bang,164697930,"Máy tính bảng Samsung Galaxy Tab A8  (2022) - Hàng chính hãng - ĐÃ KÍCH HOẠT BẢO HÀNH ĐIỆN TỬ",5856000,5856000,0,0
TIKI,dien-thoai-may-tinh-bang,186149961,"Máy tính bảng Samsung Galaxy Tab A7 Lite 32GB Xám - Hàng Chính Hãng",3587000,3587000,0,0
TIKI,dien-thoai-may-tinh-bang,217158870,"Máy tính bảng Samsung Galaxy Tab A8 (4GB/64GB) - Hàng Chính Hãng",5856000,5856000,0,0
TIKI,dien-thoai-may-tinh-bang,253443951,"Điện Thoại Samsung Galaxy M14 5G (6GB/128GB) - Hàng Chính Hãng",5292000,5292000,0,0
TIKI,dien-thoai-may-tinh-bang,251275686,"Điện thoại OPPO A57 4GB/128GB Vàng - Hàng chính hãng",4632000,4632000,0,0
TIKI,dien-thoai-may-tinh-bang,247016383,"Điện Thoại Xiaomi Redmi 12C 4GB/64GB - Hàng Chính Hãng",3168000,3168000,0,0
TIKI,dien-thoai-may-tinh-bang,273636845,"Điện Thoại Samsung Galaxy A05 (4GB/64GB) - Hàng Chính Hãng",3025000,3025000,0,0
TIKI,dien-thoai-may-tinh-bang,190701486,"Điện Thoại OPPO A57 (4GB/64GB) - Hàng Chính Hãng",4284000,4284000,0,0
TIKI,dien-thoai-may-tinh-bang,270736028,"Điện thoại Samsung Galaxy Z Fold 5 - Hàng chính hãng",29990000,44990000,15000000,33
TIKI,dien-thoai-may-tinh-bang,273232944,"Máy tính bảng Masstel Tab 10.4 - Hàng chính hãng",4990000,4990000,0,0
TIKI,dien-thoai-may-tinh-bang,249730339,"Điện Thoại Masstel IZI 55 4G LTE - 2 Sim 2 Sóng - Pin 1800 mAh - Hàng Chính Hãng - Bảo Hành 12 Tháng",659000,659000,0,0
TIKI,dien-thoai-may-tinh-bang,249156531,"Điện thoại Realme C55 6GB/128GB Vàng nắng mai - Hàng chính hãng",4680000,4990000,310000,6
TIKI,dien-thoai-may-tinh-bang,274361820,"Máy Tính Bảng Học Tập Smart Study 1, Hàng Chính Hãng, Cho Trẻ Từ 5-12 Tuổi, 64GB, Tích Hợp Chương Trình Học Tập Toàn Diện",7900000,7900000,0,0
TIKI,dien-thoai-may-tinh-bang,263438199,"Máy tính bảng Edutab 10.1 Pro & Case da tặng Hệ thống quản lý học tập & kiểm soát dành cho Phụ huynh trọn đời",4989000,4989000,0,0
TIKI,dien-thoai-may-tinh-bang,273438724,"Điện Thoại Samsung A05s 4GB/128GB , Snapdragon 680 , Sạc nhanh 25W - Hàng Chính Hãng",3204000,3990000,786000,20
TIKI,dien-thoai-may-tinh-bang,230157205,"Điện thoại Xiaomi Redmi Note 10T 5G 4GB/64GB - Màn 90HZ - Chống Nước IP68 - Hàng Nhập Khẩu - Bản quốc tế",2420000,4190000,1770000,42
TIKI,dien-thoai-may-tinh-bang,212040697,"Điện Thoại Samsung Galaxy A04 (3GB/32GB) - Hàng Chính Hãng - Đã kích hoạt bảo hành điện tử",2130000,2990000,860000,29
TIKI,dien-thoai-may-tinh-bang,274516951,"Điện thoại Masstel izi 16 4G(LTE) , Bàn phím nổi, FM không dây - Hàng chính hãng",420000,499000,79000,16
TIKI,dien-thoai-may-tinh-bang,258787119,"Máy tính bảng OUKITEL RT2 chắc chắn (chống nước,chống va đập ,pin xài lâu,Pin  20.000Mah, Màn hình  10,1 inch,Ram 8GB,Rom  128 GB, lõi tám nhân,Máy ảnh 16MP,Android 12,sạc nhanh 33W)- hàng chính hãng",8990000,8990000,0,0
TIKI,dien-thoai-may-tinh-bang,274639670,"Điện thoại Realme V30T 4GB/128GB Dimensity 700 - Rom tiếng việt - Hàng nhập khẩu",2650000,3590000,940000,26
TIKI,dien-thoai-may-tinh-bang,220670303,"Yealink W73P - Điện thoại IP cầm tay không dây DECT - Hàng Chính Hãng - Điện thoại IP mẹ bồng con",2800000,2800000,0,0
TIKI,dien-thoai-may-tinh-bang,188948039,"Máy tính bảng Samsung Galaxy Tab A8 64GB Xám (2022) - Hàng Chính Hãng",5856000,5856000,0,0
TIKI,dien-thoai-may-tinh-bang,244303202,"Điện Thoại Samsung A14 4GB/128GB - Hàng Chính Hãng",3349000,4490000,1141000,25
TIKI,dien-thoai-may-tinh-bang,198858451,"Điện thoại Samsung Galaxy A04s (4GB/64GB) - Hàng chính hãng",3990000,3990000,0,0
TIKI,dien-thoai-may-tinh-bang,65091422,"Điện thoại Oukitel WP6 (Chống va đập,chống nước,Ram 6Gb,Rom 128Gb,pin 8.000mAh) hàng chính hãng",6990000,6990000,0,0
TIKI,dien-thoai-may-tinh-bang,190544267,"Điện Thoại Oppo A57 4GB/64GB - Hàng Chính Hãng",4284000,4284000,0,0
TIKI,dien-thoai-may-tinh-bang,91836155,"Điện Thoại  Dành Cho Người Già Masstel Fami 12 Phiên bản mới hỗ trợ đèn Pin siêu sáng- Hàng Chính Hãng - Màu đen",630000,630000,0,0
TIKI,dien-thoai-may-tinh-bang,220678495,"Điện thoại bàn DECT không dây Yealink W73H có chân đế - Hàng chính hãng",2200000,2200000,0,0
TIKI,dien-thoai-may-tinh-bang,271234577,"Điện Thoại Nokia 105 4G Pro - Hàng Chính Hãng",669000,680000,11000,2
TIKI,dien-thoai-may-tinh-bang,248185228,"Điện Thoại Masstel Lux 10 4G - Hàng Chính Hãng",675000,675000,0,0
TIKI,dien-thoai-may-tinh-bang,274507025,"Điện thoại Realme V50 5G 6GB/128GB ,CPU Dimensity 6100+ , Màn 120HZ , Rom Quốc tế có tiếng việt - Hàng nhập khẩu",3199000,3990000,791000,20
TIKI,dien-thoai-may-tinh-bang,258667842,"Điện thoại Xiaomi Redmi Note 12 Pro 4G (8GB/256GB) - Hàng chính hãng",7990000,7990000,0,0
TIKI,dien-thoai-may-tinh-bang,274410237,"Điện thoại người già IPRO F183 4G , Gọi HD Call , Có SOS , 2 sim 2 sóng - Hàng chính hãng",338000,450000,112000,25
TIKI,dien-thoai-may-tinh-bang,198868735,"Điện thoại IP Grandstream GRP 2601 hàng chính hãng",880000,880000,0,0
TIKI,dien-thoai-may-tinh-bang,271798615,"Điện thoại thông minh siêu bền Oukitel WP28 (màn hình 6.52‘' ,HD+ ,pin 10600mAh ,Ram 15Gb(8GB+7Gb),Rom 256GB ,Android13, camera 48MP)-hàng chính hãng",4990000,4990000,0,0
TIKI,dien-thoai-may-tinh-bang,260406257,"Điện thoại oukitel wp23 ( chống nước,chống va đập,pin 10600mAh,Ram 4Gb.Rom 64Gb,màn hình 6.52 inch,mạng 2,3,4G,Android 13 )-hàng chính hãng",3990000,3990000,0,0
TIKI,dien-thoai-may-tinh-bang,262516014,"Điện Thoại Samsung Galaxy A34 5G - Hàng Chính Hãng",7164000,7164000,0,0
TIKI,dien-thoai-may-tinh-bang,272270730,"Điện thoại Samsung Galaxy A05 (4GB/128GB) - Hàng chính hãng",2650000,3099000,449000,14
TIKI,dien-thoai-may-tinh-bang,248235765,"Điện Thoại Masstel iZi 26 4G - Hàng Chính Hãng",589000,640000,51000,8
TIKI,nha-sach-tiki,184087030,"Beethoven - Nhà Soạn Nhạc Cổ Điển Vĩ Đại Thế Giới",43300,60000,16700,28
TIKI,nha-sach-tiki,10761049,"Gôm Bút Mực Mono Tombow ES-512A",45000,50000,5000,10
TIKI,nha-sach-tiki,145540463,"Combo 2 cuốn: Đường xưa mây trắng - Theo gót chân Bụt( Bìa Mềm) + Hành Trình Của Linh Hồn ( Bộ Sách Trò Chuyện Cùng Tâm Linh/ Tặng Kèm Bookmark)",386500,386500,0,0
TIKI,nha-sach-tiki,13853115,"Chiến Lược Mở Rộng Kinh Doanh Từ Cốt Lõi",79100,109000,29900,27
TIKI,nha-sach-tiki,26707903,"Thiết Kế Kết Cấu Bê Tông Cốt Thép Theo Tiêu Chuẩn Eurocode - Cơ Sở Lý Thuyết Và Ví Dụ Áp Dụng",91000,112000,21000,19
TIKI,nha-sach-tiki,58839915,"Amulet Book 6 : Escape from Lucien (Graphic Novel)",312000,312000,0,0
TIKI,nha-sach-tiki,186669701,"Danh Nhân Thế Giới: Lincoln (Tái Bản 2022)",23100,30000,6900,23
TIKI,nha-sach-tiki,2583033,"Bé Trách Nhiệm",11500,23000,11500,50
TIKI,nha-sach-tiki,1995037,"21 Cách Học Tiếng Anh Du Kích - FuSuSu (Song ngữ)",150000,150000,0,0
TIKI,nha-sach-tiki,48035293,"Kỷ Luật Tự Giác Thói Quen Của Người Thành Công",111300,159000,47700,30
TIKI,nha-sach-tiki,191410859,"Trưởng Thành Sau Biến Cố",110000,130000,20000,15
TIKI,nha-sach-tiki,36996379,"Người Mẹ Tốt Hơn Là Người Thầy Tốt - Tập 2",136500,136500,0,0
TIKI,nha-sach-tiki,175724209,"Những Triết Gia Vĩ Đại",59000,90000,31000,34
TIKI,nha-sach-tiki,48362492,"Sách Tương Tác Vừa Học Vừa Chơi - Khủng Long Kỳ Thú",57200,79000,21800,28
TIKI,nha-sach-tiki,189938281,"Một Thư Viện Ở Paris",148000,148000,0,0
TIKI,nha-sach-tiki,169621664,"Anh Đừng Quyến Rũ Tôi - Tập 3",127000,169000,42000,25
TIKI,nha-sach-tiki,273537705,"Chinh Phục Cụm Động Từ Tiếng Anh",49000,65000,16000,25
TIKI,nha-sach-tiki,41754180,"Nghệ Thuật Bán Hàng Bằng Câu Chuyện (Tặng Bookmark dễ thương)",129000,188000,59000,31
TIKI,nha-sach-tiki,8121460,"Giáo Trình Hán Ngữ 1 - Tập 1 - Quyển Thượng (Phiên Bản Mới)",83520,116000,32480,28
TIKI,nha-sach-tiki,48320740,"[ Bookcare] Combo 50 Bìa Bọc Truyện Tranh Plastic Cao Cấp (Bọc mọi cuốn khổ 11,3x17,6cm)",120000,120000,0,0
TIKI,nha-sach-tiki,23437828,"English Vocabulary in Use: Elementary Book with Answers Reprint Edition: Vocabulary Reference and Practice (CD-ROM)",124620,134000,9380,7
TIKI,nha-sach-tiki,182972777,"Rồng Đỏ",98500,135000,36500,27
TIKI,nha-sach-tiki,159259017,"Ngày của người chết tập 1+ 2 - Đằng Bình - Truyện phiêu lưu viễn tưởng, mạt thế, kinh dị",231000,330000,99000,30
TIKI,nha-sach-tiki,185409456,"Bút Bi Nước Mực Gel Bấm Ngòi 0.5mm Deli - Thiết Kế Vỏ Trong Suốt Phù Hợp Văn Phòng Sinh Viên Học Sinh Ghi Chép Sổ Tay - A057B",8000,18000,10000,56
TIKI,nha-sach-tiki,74953479,"Em Bé Hạnh Phúc: Nuôi Dạy Trẻ Tại Nhà Theo Phương Pháp Montessori",78500,110000,31500,29
TIKI,nha-sach-tiki,177747013,"Giác Ngộ",98500,139000,40500,29
TIKI,nha-sach-tiki,145499994,"Sách Quẳng Gánh Lo Đi Và Vui Sống (Khổ Nhỏ) (Tái Bản 2021)",48500,68000,19500,29
TIKI,nha-sach-tiki,195845908,"EMPOWERED - Khai phóng tiềm năng nhân lực, sản phẩm công nghệ đột phá",206000,295000,89000,30
TIKI,nha-sach-tiki,176906756,"Dẫu Hóa Linh Hồn Xin Hãy Ở Bên Tôi",101000,118000,17000,14
TIKI,nha-sach-tiki,2099189,"Khéo Ăn Nói Sẽ Có Được Thiên Hạ (Bìa Cứng)",112500,150000,37500,25
TIKI,nha-sach-tiki,192474344,"BỘ SÁCH KỶ LUẬT: Không Sợ Chậm Chỉ Sợ Dừng – Càng Kỷ Luật Càng Tự Do",192000,238000,46000,19
TIKI,nha-sach-tiki,87726331,"Chết Vì Chứng Khoán",127400,199000,71600,36
TIKI,nha-sach-tiki,112053760,"Bồi dưỡng năng lực tự học Toán lớp 6 (Theo chương trình GDPT mới)",66000,66000,0,0
TIKI,nha-sach-tiki,166525107,"Lịch Sử Đô Thị Hiện Đại",133000,169000,36000,21
TIKI,nha-sach-tiki,197657395,"[PRE-ORDER] Tokyo Revengers - Tập 4 - Bản Thường",103500,115000,11500,10
TIKI,nha-sach-tiki,5458537,"Tài Chính Doanh Nghiệp - Corporate Finance",610000,659000,49000,7
TIKI,nha-sach-tiki,195801299,"Rembrandt Cuộc Đời Và Tác Phẩm Qua 500 Hình Ảnh",378400,599000,220600,37
TIKI,nha-sach-tiki,173156781,"Combo 2 Sách Thành thạo Tin học văn phòng: Thành thạo Hàm Excel phổ biến nhất + Thành thạo Soạn thảo văn bản Word - Mẹo xử lý lỗi Word Excel trong công việc -  tinhocmos",249000,308000,59000,19
TIKI,nha-sach-tiki,188930494,"Người Bà Tài Giỏi Vùng Saga – Tập 4",43700,52000,8300,16
TIKI,nha-sach-tiki,17493916,"Luyện Nói Tiếng Trung Quốc Cấp Tốc Cho Người Bắt Đầu - Tập 1 (Kèm file MP3) (Tái Bản)",126000,168000,42000,25
TIKI,nha-sach-tiki,270660229,"Who? Chuyện Kể Về Danh Nhân Thế Giới: Walt Disney",46000,55000,9000,16
TIKI,nha-sach-tiki,110448030,"Chuyện Xảy Đến Trong Đêm",139000,179000,40000,22
TIKI,nha-sach-tiki,21502913,"Thân Nhiệt: Chìa Khóa Để Sống Khỏe Mạnh Và Trường Thọ",120000,120000,0,0
TIKI,nha-sach-tiki,136941173,"Giải Mã Hành Vi Disc: Bạn Thuộc Kiểu Lãnh Đạo Nào Trong 8 Nhóm Hành Vi?",101000,148000,47000,32
TIKI,nha-sach-tiki,170352966,"Trí Tuệ Gia Đình Từ Vị Tu Sĩ Bán Đi Chiếc Ferrari",85000,130000,45000,35
TIKI,nha-sach-tiki,9734633,"Ngày đó có em",55000,55000,0,0
TIKI,nha-sach-tiki,8835539,"Vĩ Đại Do Lựa Chọn (Tái Bản)",92000,165000,73000,44
TIKI,nha-sach-tiki,49292724,"Bộ Màu nước vẽ cao cấp 36 màu nén tặng kèm 8 món gồm túi đựng, bút nước, bút lông, bút chì, miếng mút, giấy vẽ, gọt chì, tuýp màu lẻ",135000,135000,0,0
TIKI,nha-sach-tiki,56908132,"Đảo Giấu Vàng (Tái Bản 2020)",66000,100000,34000,34
TIKI,nha-sach-tiki,109088709,"Hứa Với Con, Ba Nhé",136700,179000,42300,24
TIKI,nha-sach-tiki,270660740,"Combo Cẩm Nang Sinh Hoạt Bằng Tranh Cho Bé (4 tập)",107000,144000,37000,26
TIKI,nha-sach-tiki,137555857,"Bộ Đề Kiểm Tra Tiếng Anh 8 (Chương Trình Thí Điểm)",68300,86000,17700,21
TIKI,nha-sach-tiki,161878354,"Combo 05 Cây Bút Lông Bảng FO-WB02 Và 01 Hộp Mực Lông Bảng FO-WBI02",70000,70000,0,0
TIKI,nha-sach-tiki,966505,"Tuần Của Bé - Bé Sâu Sắc",11500,23000,11500,50
TIKI,nha-sach-tiki,87672638,"Combo Lấy Nước Đường Xa và Nhà Giả Kim",160200,178000,17800,10
TIKI,nha-sach-tiki,190857214,"Dinh Dưỡng Lành Mạnh - Ngại Gì Bệnh Tim",165200,259000,93800,36
TIKI,nha-sach-tiki,1352355,"Bộ Kỹ Năng Trong Sinh Hoạt I - Ăn Thế Nào Cho Đủ - How To Eat Healthy (Song Ngữ Việt - Anh)",17000,29000,12000,41
TIKI,nha-sach-tiki,966501,"Tuần Của Bé - Bé Quyết Đoán",11500,23000,11500,50
TIKI,nha-sach-tiki,447497,"Phật Thuyết Đại Thừa Vô Lượng Thọ Trang Nghiêm Thanh Tịnh Bình Đẳng Giác Kinh (Quyển 1)",65000,65000,0,0
TIKI,nha-sach-tiki,1639671,"Ngay Bây Giờ Hoặc Không Bao Giờ (Tái Bản)",53800,79000,25200,32
TIKI,nha-sach-tiki,34751487,"Ngụ Ngôn Song Ngữ Anh - Việt: Một Cuộc Thi Chạy (Tái Bản 2019)",19200,32000,12800,40
TIKI,nha-sach-tiki,186862153,"Danh Nhân Thế Giới: Napoleon (Tái Bản 2022)",23100,30000,6900,23
TIKI,nha-sach-tiki,1021663,"Thủy Hử (Trọn Bộ 2 Tập)",210000,320000,110000,34
TIKI,nha-sach-tiki,56271593," Nắm Nhầm Một Bàn Tay, Tìm Được Người Như Ý",86200,99000,12800,13
TIKI,nha-sach-tiki,34567948,"Combo Phát Triển IQ Cho Trẻ Em: Chữ Số Biến Ảo + Nhận Biết Thế Giới + Tư Duy LôGic + Rèn Luyện Trí Tuệ + Nhanh Tay Tinh Mắt + Trò Chơi Trí Tuệ (Bộ 6 Cuốn - Tặng Kèm Postcard Greenlife)",198350,198350,0,0
TIKI,nha-sach-tiki,4439903,"Kĩ Năng Cho Bé Trong Giao Tiếp Hàng Ngày: Biết Cảm Ơn Khi Nhận (Tái Bản)",21000,35000,14000,40
TIKI,nha-sach-tiki,181379273,"Ngài Kẹo",31000,60000,29000,48
TIKI,nha-sach-tiki,54120846,"Hannibal Trỗi Dậy",102000,138000,36000,26
TIKI,nha-sach-tiki,58616751,"Nha Sĩ Yêu Quái (Tái Bản 2020)",74000,109000,35000,32
TIKI,nha-sach-tiki,76048205,"Sách - Tip Công Sở 2 - Khả Năng Đặt Câu Hỏi - Hỏi sao cho đúng",66000,97000,31000,32
TIKI,nha-sach-tiki,2679923,"Dây chữ Happy Birthday nét kiểu",54000,54000,0,0
TIKI,nha-sach-tiki,4439909,"Kĩ Năng Cho Bé Trong Giao Tiếp Hàng Ngày: Lời Chào Đi Trước (Tái Bản)",21000,35000,14000,40
TIKI,nha-sach-tiki,186239206,"Túi bọc sách truyện NOKISHI phù hợp với mọi loại sách truyện",13199,13199,0,0
TIKI,nha-sach-tiki,1073276,"Combo Mê Cung Phát Triển Tư Duy (4 Cuốn)",238400,298000,59600,20
TIKI,nha-sach-tiki,100931010,"BĂNG KEO TRONG - VÀNG DÁN THÙNG 200 YARD",25000,25000,0,0
TIKI,nha-sach-tiki,89764009,"Bóng của cây sồi",95200,136000,40800,30
TIKI,nha-sach-tiki,87642541,"Combo Lấy Nước Đường Xa và  Chú Bé Mang Pyjama Sọc  ",150250,150250,0,0
TIKI,nha-sach-tiki,45472472,"Hộp Viết Gỗ Để Bàn",78000,78000,0,0
TIKI,nha-sach-tiki,52855109,"SÁCH KẾ HOẠCH DẠY TRẺ CHẬM NÓI - Tự Kỷ (Tái bản lần I - 2020)",280000,280000,0,0
TIKI,nha-sach-tiki,510195,"Tiếng Gọi Nơi Hoang Dã (Khang Việt)",34000,72000,38000,53
TIKI,dien-thoai-may-tinh-bang,272909668,"[Mới] Điện thoại vivo V29e 5G (8GB/256GB) - Hàng Chính Hãng - Camera Selfie 50 MP - Vòng Sáng Aura 2.0 - Màn hình AMOLED 6.67",8690000,8990000,300000,3
TIKI,dien-thoai-may-tinh-bang,271966786,"iPhone 15",19490000,21490000,2000000,9
TIKI,dien-thoai-may-tinh-bang,212261734,"Điện thoại Masstel Play 10 4G Thiết kế hầm hố,Khung viền kim loại - Hàng chính hãng",558000,799000,241000,30
TIKI,dien-thoai-may-tinh-bang,273373436,"Điện thoại Xiaomi Redmi 13C (6GB/128GB) - Hàng chính hãng - Bảo hành 18 tháng",3028000,3490000,462000,13
TIKI,dien-thoai-may-tinh-bang,274166857,"Điện thoại Samsung Galaxy S23 FE (8GB/128GB) - Hàng chính hãng",14890000,14890000,0,0
TIKI,dien-thoai-may-tinh-bang,274316885,"Điện Thoại Xiaomi POCO X6 5G 8GB-256GB - Hàng chính hãng",7510000,9990000,2480000,25
TIKI,dien-thoai-may-tinh-bang,248704404,"Điện Thoại Samsung Galaxy A14 (4GB/128GB) - Hàng Chính Hãng",3672000,3672000,0,0
TIKI,dien-thoai-may-tinh-bang,270471106,"Điện Thoại Nokia 105 4G Pro TA-1538 - Hàng Chính Hãng",630000,680000,50000,7
TIKI,dien-thoai-may-tinh-bang,271118390,"Điện thoại OPPO Reno10 5G (8GB/256GB) - Hàng Chính Hãng",9190000,10990000,1800000,16
TIKI,dien-thoai-may-tinh-bang,271982547,"Điện thoại Oukitel  WP12 Pro (chống nước,chống va đập,RAM 8GB(Ram 4GB+ 4Gb),Rom 64 Gb,8 nhân)- hÀng chính hãng",3990000,3990000,0,0
TIKI,dien-thoai-may-tinh-bang,273774937,"Điện thoại Samsung Galaxy A15 (8GB/128GB) - Hàng chính hãng - Đã kích hoạt bảo hành điện tử",4455000,4990000,535000,11
TIKI,dien-thoai-may-tinh-bang,271494404,"Điện thoại Tecno POVA 5 (8GB+8GB/128GB) RAM mở rộng 16GB | Pin 6000 mAh | Màn 120Hz - Sạc nhanh 45W - Hàng Chính Hãng",3799000,4490000,691000,15
TIKI,dien-thoai-may-tinh-bang,274498288,"Điện Thoại Samsung Galaxy A35 5G (8GB/128GB)- Hàng Chính Hãng",7890000,8290000,400000,5
TIKI,dien-thoai-may-tinh-bang,273359059,"Điện Thoại Chắc Chắn OUKITEL WP23 PRO ( Ram 16Gb(8GB+8Gb),Rom 128GB ,Android13, Pin 10600mAh,Màn hình 6.52 "HD + ,13MP camera Sau,chống nước,chống va đập)-hàng chính hãng",4990000,4990000,0,0
TIKI,dien-thoai-may-tinh-bang,261946899,"Điện Thoại Samsung Galaxy A14 (6GB/128GB) - Hàng Chính Hãng",3999000,4990000,991000,20
TIKI,dien-thoai-may-tinh-bang,274059475,"Điện Thoại Samsung Galaxy S24 Ultra (12GB/256GB) - Hàng Chính Hãng",33990000,33990000,0,0
TIKI,dien-thoai-may-tinh-bang,273430216,"Điện thoại Ulefone Armor 13 (pin khủng,pin 13.200mAh, Ram 8Gb,Rom 256Gb,chống sốc,chống va đập,nội soi,tia hồng ngoại,tia lade,loa to,học online)- hàng chính hãng",7990000,7990000,0,0
TIKI,dien-thoai-may-tinh-bang,273958512,"Điện thoại Xiaomi Redmi Note 13 (6GB/128GB) - Hàng chính hãng",4890000,4890000,0,0
TIKI,dien-thoai-may-tinh-bang,273718967,"Điện Thoại Samsung A15 8GB/128GB - Hàng Chính Hãng",4349000,4990000,641000,13
TIKI,dien-thoai-may-tinh-bang,273252926,"Điện Thoại Oppo A18 (4GB/128GB) - Hàng Chính Hãng",3390000,3990000,600000,15
TIKI,dien-thoai-may-tinh-bang,248799307,"Điện thoại Xiaomi 13 Lite (8GB/256GB) - Hàng chính hãng",11490000,11490000,0,0
TIKI,dien-thoai-may-tinh-bang,257682739,"Điện thoại Samsung Galaxy A04 (3GB/32GB) - Đã kích hoạt bảo hành điện tử -  Hàng chính hãng",1999000,2990000,991000,33
TIKI,dien-thoai-may-tinh-bang,271128271,"Điện Thoại Oppo A58 6GB/128GB - Hàng Chính Hãng",4349000,4990000,641000,13
TIKI,dien-thoai-may-tinh-bang,272348047,"Điện Thoại Samsung A05s 4GB/128GB - Hàng Chính Hãng",3239000,3990000,751000,19
TIKI,dien-thoai-may-tinh-bang,209927605,"Combo máy đọc sách Kindle 2022 (11th) tặng kèm bao da ( Cover ) - Hàng nhập khẩu",3100000,3100000,0,0
TIKI,dien-thoai-may-tinh-bang,274179544,"Điện thoại Realme C51 (6GB/256GB) - Hàng Chính Hãng",3390000,4190000,800000,19
TIKI,dien-thoai-may-tinh-bang,274375122,"Điện thoại Xiaomi Redmi Note 13 Pro 4G (8GB/128GB) - Hàng chính hãng",6489000,7290000,801000,11
TIKI,dien-thoai-may-tinh-bang,273378164,"Điện thoại Xiaomi Redmi 13C (6GB/128GB) - Hàng chính hãng - Đã kích hoạt bảo hành điện tử",2960100,3490000,529900,15
TIKI,dien-thoai-may-tinh-bang,274542883,"Điện Thoại Samsung A35 5G 8GB/128GB - Hàng Chính Hãng",7369000,8290000,921000,11
TIKI,dien-thoai-may-tinh-bang,273553649,"Điện thoại Oppo A18 - Hàng chính hãng",3499000,3690000,191000,5
TIKI,dien-thoai-may-tinh-bang,25949745,"Máy Đọc Sách Kindle Oasis (10th Gen) 2019- 8GB - Hàng Chính Hãng",6043100,6790000,746900,11
TIKI,dien-thoai-may-tinh-bang,263073555,"Điện thoại Tecno CAMON 20 8GB/256GB - Camera 64MP + 32MP | 5000 mAh | Sạc nhanh 33W | 6.7'' FHD AMOLED - BH 13 Tháng - Hàng Chính Hãng",4990000,4990000,0,0
TIKI,dien-thoai-may-tinh-bang,273897523,"Điện thoại Tecno SPARK 20 (8+8)GB/128GB - Helio G85 | 5000 mAh | Sạc nhanh 18W | Hàng Chính Hãng",3390000,3490000,100000,3
TIKI,dien-thoai-may-tinh-bang,272222033,"Máy đọc sách Boox Palma - Hàng Chính Hãng",7200000,8590000,1390000,16
TIKI,dien-thoai-may-tinh-bang,263274580,"Điện thoại Samsung Galaxy M14 5G (4GB/64GB) - Hàng chính hãng - Đã kích hoạt bảo hành điện tử",2750000,3990000,1240000,31
TIKI,dien-thoai-may-tinh-bang,217640502,"Máy đọc sách Kindle Scribe - Hàng chính hãng",12590000,12590000,0,0
TIKI,dien-thoai-may-tinh-bang,52480318,"Điện thoại bàn cổ điển DT115",2500000,2500000,0,0
TIKI,dien-thoai-may-tinh-bang,271134741,"Điện thoại Samsung Galaxy Z Flip5 (8GB/512GB) - Hàng chính hãng",17639000,29990000,12351000,41
TIKI,dien-thoai-may-tinh-bang,274164078,"Máy tính bảng Samsung Galaxy Tab A9 WIFI 4GB-64GB- Hàng chính hãng",3210000,3990000,780000,20
TIKI,dien-thoai-may-tinh-bang,52002453,"Cisco Unified IP Phone 7962G - Hàng chính hãng",4900000,4900000,0,0
TIKI,dien-thoai-may-tinh-bang,181699208,"Máy tỉnh bảng Samsung Galaxy Tab A8 -Hàng chính hãng",5856000,5856000,0,0
TIKI,dien-thoai-may-tinh-bang,273186334,"Điện thoại Samsung Galaxy A05s 4GB/128GB- Hàng Chính hãng",3980000,3980000,0,0
TIKI,dien-thoai-may-tinh-bang,250113073,"Điện thoại Xiaomi Redmi Note 12 Pro 5G (8GB/256GB) - Hàng chính hãng",9000000,9000000,0,0
TIKI,dien-thoai-may-tinh-bang,196348143,"Điện Thoại OPPO A57 (4GB/64GB) - Hàng Chính Hãng",4284000,4284000,0,0
TIKI,dien-thoai-may-tinh-bang,253443652,"Điện Thoại Samsung Galaxy M14 5G - Hàng Chính Hãng",4212000,4212000,0,0
TIKI,dien-thoai-may-tinh-bang,168317790,"Điện Thoại Xiaomi Redmi 9A (2GB/32GB)- Đã kích hoạt bảo hành điện tử- Hàng Chính Hãng - Peacock Green",2088000,2088000,0,0
TIKI,dien-thoai-may-tinh-bang,272200109,"Điện Thoại Samsung Galaxy A04e - Hàng Chính Hãng",2340000,2340000,0,0
TIKI,dien-thoai-may-tinh-bang,244182370,"Điện thoại Samsung Galaxy S23 Ultra 1TB - Hàng chính hãng",44990000,44990000,0,0
TIKI,dien-thoai-may-tinh-bang,242657652,"Điện thoại Samsung Galaxy S23 Plus 256GB - Hàng chính hãng",26990000,26990000,0,0
TIKI,dien-thoai-may-tinh-bang,273947785,"Điện thoại AI Samsung Galaxy S24+ 12GB/256GB, Camera 50MP, Màn hình 6.7"- Đen- Hàng Chính Hãng",25490000,27490000,2000000,7
TIKI,dien-thoai-may-tinh-bang,273440662,"Điện thoại Xiaomi Redmi 12 (4GB/128GB) , Helio G88 , Màn 90HZ - Hàng chính hãng",3299000,4290000,991000,23
TIKI,dien-thoai-may-tinh-bang,273438458,"Điện thoại Samsung Galaxy A05 (4GB/128GB)- Helio G85 - Sạc nhanh 25W - Hàng chính hãng",2659000,3090000,431000,14
TIKI,dien-thoai-may-tinh-bang,252423003,"Điện thoại Tecno SPARK 10 4GB/128GB - Camera 50MP | 5000 mAh | Sạc nhanh 18W | Cảm ứng vân tay - Hàng chính hãng",3190000,3190000,0,0
TIKI,dien-thoai-may-tinh-bang,258373871,"Điện Thoại Itel S23 128GB/16GB (8GB+8GB) | Pin 5000mAh | 6.6 Inch | Camera 50MP | 90Hz | Face ID - Hàng chính Hãng",2342000,3490000,1148000,33
TIKI,dien-thoai-may-tinh-bang,262660017,"Điện Thoại Samsung Galaxy A24 (6GB/128GB) - Hàng Chính Hãng",5800000,5800000,0,0
TIKI,dien-thoai-may-tinh-bang,215135773,"Điện Thoại Di Động Forme D111 4G - Hàng Chính Hãng",520000,520000,0,0
TIKI,dien-thoai-may-tinh-bang,273366493,"Máy tính bảng chắc chắn Ulefone Armor Pad 2(màn hình 11" ,2K, pin 18600 mAh, IP68/IP69K, Android 13, NFC ,GPS, 4G, Ram 16GB(8gb+8gb),rom 256GB)- hàng chính hãng",7990000,7990000,0,0
TIKI,dien-thoai-may-tinh-bang,273511450,"Điện thoại Xiaomi Redmi 12 8GB/128GB - Hàng Chính Hãng",4390000,4390000,0,0
TIKI,dien-thoai-may-tinh-bang,160051501,"Điện thoại Masstel IZI 20 4G - Hàng chính hãng, Nguyên Seal",512000,512000,0,0
TIKI,dien-thoai-may-tinh-bang,207883258,"Điện thoại oukitel  wp21 (Ram 12Gb,Rom 256Gb ,chống sốc,chống nước,pin khủng, pin 9.800mAh) - hàng chính hãng",9970000,9970000,0,0
TIKI,dien-thoai-may-tinh-bang,274019962,"Điện thoại Masstel Fami 8 4G(LTE) Gọi HD call , Bàn phím chữ số lớn,Loa to - Hàng chính hãng",489000,550000,61000,11
TIKI,dien-thoai-may-tinh-bang,273454566,"Điện thoại Xiaomi POCO C65 (6GB/128GB) - Helio G85 - Màn 90HZ - Hàng chính hãng",2669000,2990000,321000,11
TIKI,dien-thoai-may-tinh-bang,200816374,"Điện Thoại Forme D888 - Hàng Chính Hãng",589000,699000,110000,16
TIKI,dien-thoai-may-tinh-bang,215543460,"Điện Thoại Samsung Galaxy A14 5G (4GB/128GB) - Hàng Chính hãng",5190000,5190000,0,0
TIKI,dien-thoai-may-tinh-bang,201001781,"Điện thoại Masstel Lux 10 4G - Nhiều chức năng - Hàng chính hãng",675000,675000,0,0
TIKI,dien-thoai-may-tinh-bang,226552005,"Điện thoại bàn Panasonic KX-TSC11 hàng chính hãng",600000,600000,0,0
TIKI,dien-thoai-may-tinh-bang,274456687,"Điện thoại Samsung Galaxy A55 5G (8GB/128GB) - Hàng chính hãng",9990000,9990000,0,0
TIKI,dien-thoai-may-tinh-bang,272113804,"[MỚI] Điện thoại vivo Y17s - Hàng chính hãng - Camera 50MP - Pin 5000 mAh - Sạc nhanh- RAM mở rộng đến 8GB",3790000,3990000,200000,5
TIKI,dien-thoai-may-tinh-bang,274030201,"Điện thoại TECNO SPARK 10 8GB/128GB - Hàng Chính Hãng",2832000,3590000,758000,21
TIKI,dien-thoai-may-tinh-bang,208171115,"Điện thoại OUKITEL WP18 (Chống nước ,chống va đập, pin khủng 12500mAh, Ram 4GB ,Rom 32GB ,màn hình 5.93 inch,Điện thoại chắc chắn) – HÀNG CHÍNH HÃNG",3990000,3990000,0,0
TIKI,dien-thoai-may-tinh-bang,251514670,"Điện thoại Xiaomi Redmi Note 12 (4GB/128GB) Màn AMOLED 120HZ, Snapdragon 685 , Sạc 33W - Hàng chính hãng",3599000,4990000,1391000,28
TIKI,dien-thoai-may-tinh-bang,212329857,"Điện thoại Xiaomi Redmi 9A 2GB/32GB Xám - Hàng chính hãng",2088000,2088000,0,0
TIKI,dien-thoai-may-tinh-bang,271234313,"Điện Thoại Nokia 110 4G Pro - Hàng Chính Hãng",699000,710000,11000,2
TIKI,dien-thoai-may-tinh-bang,274638430,"Điện thoại Redmi Note 13R 5G 4GB/128GB Dimensity 6100+ , Màn 90Hz , Rom quốc tế có sẳn Tiếng việt - Hàng nhập khẩu",2899000,3590000,691000,19
TIKI,dien-thoai-may-tinh-bang,102620086,"Điện thoại VoIP Yealink SIP-T30 - Hàng Chính Hãng",1200000,1200000,0,0
TIKI,dien-thoai-may-tinh-bang,271341795,"Điện thoại smartphone Masstel Hapi 15 (2GB/16GB) - 2 Sim, Tặng kèm ốp lưng - Hàng chính hãng - Bảo hành chính hãng",1499000,1499000,0,0
TIKI,dien-thoai-may-tinh-bang,248766283,"Máy đọc sách New Kindle 11th 2022 (Kids) kèm bao da - Hàng Chính Hãng",3010000,3299000,289000,9
TIKI,dien-thoai-may-tinh-bang,209872337,"Máy đọc sách Kindle 2022 (11th) - All new kindle 2022 11th màn hình 6inch 300PPI gấp 2 lần độ sắc nét, 16GB bộ nhớ trong với cổng kết nối USB-C - Hàng nhập khẩu",2300000,2300000,0,0
TIKI,dien-thoai-may-tinh-bang,249734070,"Điện Thoại Masstel Fami 12 4G LTE - 2 Sim- Pin 1400 mAh - Đọc số bằng giọng nói - Hàng Chính Hãng - Bảo Hành 12 Tháng",630000,630000,0,0
TIKI,dien-thoai-may-tinh-bang,131028406,"Máy tính bảng Fire HD 10 Plus 2021 thế hệ 11th",3551100,3990000,438900,11
TIKI,dien-thoai-may-tinh-bang,273659145,"Máy tính bảng Masstel Kidzone dành cho bé - quản lý thời gian cho bé - bé học tốt, hiệu quả cao - 1 đổi 1 trong 100 ngày - Hàng chính hãng",2990000,3990000,1000000,25
TIKI,dien-thoai-may-tinh-bang,273438769,"Điện thoại Xiaomi Redmi A2 2GB/32GB MediaTek Helio G36 , Pin 5000 mAh - Hàng chính hãng",1669000,2190000,521000,24
TIKI,dien-thoai-may-tinh-bang,200829966,"Điện thoại Mobell M239 4G - 2 SIM - Hàng chính hãng",415000,500000,85000,17
TIKI,dien-thoai-may-tinh-bang,250109584,"Điện thoại Xiaomi Redmi Note 12 (4GB/128GB) - Hàng chính hãng",3600000,4990000,1390000,28
TIKI,dien-thoai-may-tinh-bang,271364652,"Máy tính bảng Xiaomi Pad 6 (8GB/128GB) -  Hàng chính hãng - Đã kích hoạt bảo hành điện tử",8790000,9490000,700000,7
TIKI,dien-thoai-may-tinh-bang,272273169,"Điện thoại Samsung Galaxy M34 5G (8GB/128GB) - Hàng chính hãng",7590000,7990000,400000,5
TIKI,dien-thoai-may-tinh-bang,262688183,"ĐIỆN THOẠI MASSTEL IZI 30 4G-LTE-HÀNG CHÍNH HÃNG",560000,560000,0,0
TIKI,dien-thoai-may-tinh-bang,274542808,"Điện Thoại Samsung A55 5G 8GB/128GB - Hàng Chính Hãng",9499000,9990000,491000,5
TIKI,dien-thoai-may-tinh-bang,200819471,"Điện thoại Mobell Rock 4 4G , Pin 3250mah , Loa Siêu lớn - Hàng chính hãng",685000,799000,114000,14
TIKI,dien-thoai-may-tinh-bang,274611998,"Điện thoại Xiaomi Redmi 12 (4GB/128GB) - Hàng chính hãng",3790000,3790000,0,0
TIKI,dien-thoai-may-tinh-bang,274638556,"BÚT MÁY ĐỌC SÁCH KINDLE SCRIBE - HÀNG CHÍNH HÃNG",2500000,2500000,0,0
TIKI,dien-thoai-may-tinh-bang,263309601,"Điện thoại siêu bền Oukitel K16(mini,Vỏ lưng bằng da,Ram 8Gb,Rom 128Gb,camera 48MP,pin 3.050mAh)- hàng chính hãng",4990000,4990000,0,0
TIKI,dien-thoai-may-tinh-bang,202035122,"[HCM]Ốp Lưng IPHONE Cường Lực Trong Suốt Cao Cấp Cho Dòng Iphone 14/14Pro/14Plus/14 Pro Max, Iphone 13Mini/13Pro/13ProMax, Iphone 12/12Pro/12Promax, Iphone 11/11Pro/11ProMax- Hàng nhập khẩu",110000,110000,0,0
TIKI,dien-thoai-may-tinh-bang,258668285,"Điện thoại cố định Panasonic KX-TS520MX ( màu đen)-Hàng chính hãng",449000,469000,20000,4
TIKI,dien-thoai-may-tinh-bang,274545326,"Điện thoại OPPO A36 6GB/128GB, Chip Snapdragon 680 , Màn 90Hz , Rom Tiếng việt - Hàng nhập khẩu",3050000,3590000,540000,15
TIKI,dien-thoai-may-tinh-bang,198968094,"Điện Thoại Xiaomi Redmi A1 2GB/32GB - Hàng Chính Hãng",1749000,2190000,441000,20
TIKI,dien-thoai-may-tinh-bang,273559020,"Máy tính bảng Kindle Fire HD10 2023 13th - 32Gb - Hàng chính hãng",3390000,3390000,0,0
TIKI,dien-thoai-may-tinh-bang,270975124,"Điện Thoại Oppo A58 6GB/128GB - Hàng Chính Hãng",4990000,4990000,0,0
TIKI,dien-thoai-may-tinh-bang,230155305,"Điện thoại Xiaomi Redmi Note 10 JE 5G 4GB/64GB - Màn 90HZ - Chống Nước IP68 - Hàng Nhập Khẩu - Bản quốc tế",2276000,3990000,1714000,43
TIKI,dien-thoai-may-tinh-bang,179547641,"Máy đọc sách Kindle Paperwhite 5 (8GB) - Hàng chính hãng",3750000,3750000,0,0
TIKI,dien-thoai-may-tinh-bang,270164674,"Điện thoại OPPO A78 (8GB/256GB) - Hàng Chính Hãng",6990000,6990000,0,0
TIKI,dien-thoai-may-tinh-bang,249890677,"Điện Thoại Xiaomi Redmi Note 12 4GB/128GB - Hàng Chính Hãng",3599000,4990000,1391000,28
TIKI,dien-thoai-may-tinh-bang,270473116,"Điện thoại Xiaomi Redmi Note 12 (8GB/128GB) - Hàng chính hãng",4489000,5790000,1301000,22
TIKI,dien-thoai-may-tinh-bang,274393574,"Điện thoại Xiaomi Poco C65 - Hàng chính hãng",3090000,3090000,0,0
TIKI,dien-thoai-may-tinh-bang,191089547,"Điện Thoại Nokia 110 4G - Hàng Chính Hãng",675000,899000,224000,25
TIKI,dien-thoai-may-tinh-bang,271973414,"iPhone 15 Pro Max 256GB Titan Tự Nhiên",30990000,33990000,3000000,9
TIKI,dien-thoai-may-tinh-bang,245770248,"Điện thoại Xiaomi Redmi 12C (4GB/64GB) - Hàng chính hãng",3168000,3168000,0,0
TIKI,dien-thoai-may-tinh-bang,244308977,"Điện Thoại Xiaomi Redmi 12C 4GB/64GB - Hàng Chính Hãng",3168000,3168000,0,0
TIKI,dien-thoai-may-tinh-bang,205815576,"Apple iPad 10.9-inch (10th Gen) Wi-Fi, 2022",9990000,12990000,3000000,23
TIKI,dien-thoai-may-tinh-bang,216092766,"Điện Thoại Oppo Reno 8T 4G (8GB/256GB)",8136000,8136000,0,0
TIKI,dien-thoai-may-tinh-bang,271046571,"Điện thoại Xiaomi Redmi Note 12 (8GB/128GB) - Hàng chính hãng",3790000,4790000,1000000,21
TIKI,dien-thoai-may-tinh-bang,274162900,"Điện thoại OPPO A18 4GB-128GB - Hàng chính hãng",3690000,3990000,300000,8
TIKI,dien-thoai-may-tinh-bang,230055130,"Điện thoại Oppo Reno8 T (8GB/256GB) - Hàng chính hãng",10392000,10392000,0,0
TIKI,dien-thoai-may-tinh-bang,251407092,"Điện Thoại Samsung Galaxy A34 5G (8GB/128GB) ĐKH -  Hàng Chính Hãng",7164000,7164000,0,0
TIKI,dien-thoai-may-tinh-bang,246163082,"Điện Thoại Nokia C30 2GB/32GB - Hàng Chính Hãng",1599000,2290000,691000,30
TIKI,dien-thoai-may-tinh-bang,274316036,"Điện Thoại Samsung Galaxy M34 5G 8GB-128GB - Hàng chính hãng",6250000,7990000,1740000,22
TIKI,dien-thoai-may-tinh-bang,242771940,"Điện Thoại Samsung A04e 3GB/32GB - Hàng Chính Hãng",2109000,2990000,881000,29
TIKI,dien-thoai-may-tinh-bang,253395356,"Điện Thoại Samsung M14 5G 6GB/128GB - Hàng Chính Hãng",5292000,5292000,0,0
TIKI,dien-thoai-may-tinh-bang,274383701,"Điện thoại Samsung Galaxy A05s 6GB-128GB - Hàng chính hãng",3890000,3890000,0,0
TIKI,dien-thoai-may-tinh-bang,249169833,"Điện thoại Samsung Galaxy A34 5G 8GB/128GB Đen - Hàng chính hãng",7164000,7164000,0,0
TIKI,dien-thoai-may-tinh-bang,248754839,"Điện Thoại OPPO A17K (3GB/64GB) - Hàng Chính Hãng",3276000,3276000,0,0
TIKI,dien-thoai-may-tinh-bang,168094334,"Điện thoại Samsung Galaxy S20 FE (8GB/256GB) - Hàng chính hãng",8625000,8625000,0,0
TIKI,dien-thoai-may-tinh-bang,244167098,"Điện thoại Xiaomi Redmi 12C (4GB/64GB) - Hàng chính hãng",3168000,3168000,0,0
TIKI,dien-thoai-may-tinh-bang,248590019,"Điện thoại Xiaomi Redmi 12C (3GB/32GB) - Hàng chính hãng",2808000,2808000,0,0
TIKI,dien-thoai-may-tinh-bang,205846229,"Điện Thoại Oppo A57 4GB/128GB - Hàng Chính Hãng",4632000,4632000,0,0
TIKI,dien-thoai-may-tinh-bang,176438864,"Điện thoại Xiaomi REDMI 9A (2+32) Xanh dương - Hàng chính hãng (chỉ giao HN và một số khu vực)",2088000,2088000,0,0
TIKI,dien-thoai-may-tinh-bang,243165179,"Điện thoại OPPO Reno8 T 4G (8GB/256GB) - Hàng Chính Hãng",8136000,8136000,0,0
TIKI,dien-thoai-may-tinh-bang,225960096,"Điện Thoại Samsung Galaxy S23+ 5G - Hàng Chính Hãng",18000000,18000000,0,0
TIKI,dien-thoai-may-tinh-bang,273185467,"Điện thoại Samsung A05 4GB - hàng chính hãng",3112000,3112000,0,0
TIKI,dien-thoai-may-tinh-bang,219400421,"Điện thoại OPPO CPH2471 - A17k Xanh - Hàng Chính Hãng (chỉ giao HN và một số khu vực)",3276000,3276000,0,0
TIKI,dien-thoai-may-tinh-bang,175851126,"Máy Tính Bảng Galaxy Tab A8 4GB | 64GB - Hàng Chính Hãng",5856000,5856000,0,0
TIKI,dien-thoai-may-tinh-bang,274560616,"Máy tính bảng học tập giá rẻ Nexta Edutab Kid cho bé từ 5-8 tuổi, màn hình full HD 64GB, bao da, kính dán cường lực, hàng chính hãng",4990000,4990000,0,0
TIKI,dien-thoai-may-tinh-bang,274564360,"Điện Thoại Xiaomi Redmi 12 4G (4GB/128GB) - Hàng chính hãng",3290000,4990000,1700000,34
TIKI,dien-thoai-may-tinh-bang,273407277,"Máy tính bảng chắc chắn Oukitel RT7(Chống va đập,Màn hình 10.1" FHD+,Pin 32000mAh ,Ram 24GB,Rom 256GB, Android 13,Camera sau 48MP, tầm nhìn ban đêm 20MP,camera trước 32MP,5G) – hàng chính hãng",13990000,13990000,0,0
TIKI,dien-thoai-may-tinh-bang,197214015,"Apple iPhone 14 Plus",19490000,27990000,8500000,30
TIKI,dien-thoai-may-tinh-bang,273595363,"Oukitel wp30 Pro 5g SIÊU BỀN (sạc nhanh 120W ,pin 11000 mAh,màn hình 6.78 inch,Ram 24 GB(12gb + 12GB),Rom 512GB ,120Hz ,Android 13,camera 108mp)- hàng chính hãng",11990000,11990000,0,0
TIKI,dien-thoai-may-tinh-bang,271801317,"Máy tính bảng siêu bền Oukitel RT6 (chống nước,chống va đập,pin 20000mAh,Ram 16Gb(8GB+8Gb),Rom 256GB,Màn hình 10.1" ,FHD,Android 13,CPU MTK8788 ,Camera 16MP,sạc nhanh 33W)-hàng chính hãng",9990000,9990000,0,0
TIKI,dien-thoai-may-tinh-bang,249782771,"Máy tính bảng Xelex Gama Tab X8 EDU (Hàng chính hãng)",2890000,2890000,0,0
TIKI,dien-thoai-may-tinh-bang,273389282,"Điện Thoại ulefone armor 21(Loa to 122dB Speaker ,pin 9600mAh,sạc nhanh 33W,Màn hình 6.58 in,camera chính 64MP,ban đêm 24MP,Ram 16Gb(8+8),rom 256Gb, điều khiển từ xa đa năng)- hàng chính hãng",6990000,6990000,0,0
TIKI,dien-thoai-may-tinh-bang,136364272,"Máy tính bảng Masstel Tab 10.4" (4GB/64GB) - Hàng chính hãng - ĐÃ KÍCH HOẠT BẢO HÀNH ĐIỆN TỬ",4800000,4800000,0,0
TIKI,dien-thoai-may-tinh-bang,215119245,"Điện Thoại Di Động Forme D888 4G - Hàng Chính Hãng",680000,680000,0,0
TIKI,dien-thoai-may-tinh-bang,274364026,"Máy tính bảng học tập thông minh Nexta Edutab Pro tối ưu cho trẻ 9-12 tuổi, 64GB, tích hợp ứng dụng học tập - Hàng nhập khẩu",6490000,6490000,0,0
TIKI,dien-thoai-may-tinh-bang,274065746,"Điện thoại siêu bền Oukitel WP33 Pro 5G (Loa to 136 dB (5W) ,Pin 22000mAh,màn hình 6,6 inch FHD+,Ram 24GB(8+16),Rom 256GB, Camera 64MP,sạc nhanh 33W)- hàng chính hãng",8990000,8990000,0,0
TIKI,dien-thoai-may-tinh-bang,103168071,"Máy tính bảng Samsung Galaxy Tab A7 Lite LTE SM-T225 - Hàng Chính Hãng",3587000,3587000,0,0
TIKI,dien-thoai-may-tinh-bang,273231495,"Máy tính bảng Masstel tab 10.1 pro - Hàng chính hãng",4290000,4290000,0,0
TIKI,dien-thoai-may-tinh-bang,274524033,"Điện thoại người già Masstel Fami 12S 4G(LTE) , Bàn phím chữ số to, Loa lớn , Máy viền thép chắc chắn - Hàng chính hãng",569000,650000,81000,12
TIKI,dien-thoai-may-tinh-bang,200848570,"Điện thoại Mobell M539 4G - Màn hình lớn 2.8 inch - Hàng chính hãng",626000,730000,104000,14
TIKI,dien-thoai-may-tinh-bang,198671718,"Điện Thoại Samsung Galaxy A04s (4GB/64GB) - Hàng Chính Hãng - Đã kích hoạt bảo hành điện tử",2670000,3990000,1320000,33
TIKI,dien-thoai-may-tinh-bang,252073013,"Điện thoại hiệu Masstel Fami 60 - Hàng chính hãng - Giá rẻ - hỗ trợ 4G - dành cho người lớn tuổi",730000,730000,0,0
TIKI,dien-thoai-may-tinh-bang,272273680,"Điện thoại Samsung Galaxy A05s (4GB/128GB) - Hàng chính hãng",3174000,4290000,1116000,26
TIKI,dien-thoai-may-tinh-bang,274257669,"Điện thoại Masstel Izi S1 4G (LTE) Gọi HD Call - Hàng chính hãng",420000,499000,79000,16
TIKI,dien-thoai-may-tinh-bang,216934468,"Điện thoại Samsung Galaxy A14 5G (4GB/128GB) - Hàng chính hãng",5000000,5000000,0,0
TIKI,dien-thoai-may-tinh-bang,248185860,"Điện Thoại Masstel Fami 12 4G - Hàng Chính Hãng",630000,630000,0,0
TIKI,dien-thoai-may-tinh-bang,262055875,"Điện thoại POCO M5 4GB+64GB - Pin 5000mAh - MediaTek Helio G99 -  Sạc nhanh 18W - Hàng chính hãng",2599000,3990000,1391000,35
TIKI,dien-thoai-may-tinh-bang,249851724,"Điện Thoại 4G Masstel Lux 10 - 2 Sim 2 Sóng - Sóng 4G HD Call - Loa To Rõ - Pin Bền - Hàng Chính Hãng - Bảo Hành 12 Tháng",675000,675000,0,0
TIKI,dien-thoai-may-tinh-bang,175967811,"Điện Thoại Samsung Galaxy S20 FE 256GB | 8GB - Hàng Chính Hãng",8625000,8625000,0,0
TIKI,dien-thoai-may-tinh-bang,258766897,"Điện Thoại Masstel iZi 11 4G - Hàng Chính Hãng",468000,468000,0,0
TIKI,dien-thoai-may-tinh-bang,223859345,"Điện thoại Masstel Fami 60 - Hàng chính hãng ",730000,730000,0,0
TIKI,dien-thoai-may-tinh-bang,249168300,"Điện thoại OPPO A57 4GB/128GB Đen - Hàng chính hãng",4890000,4990000,100000,2
TIKI,dien-thoai-may-tinh-bang,68693081,"Điện Thoại Samsung Galaxy S20 FE (8GB/256GB) - Hàng Chính Hãng",8625000,8625000,0,0
TIKI,nha-sach-tiki,189076565,"Nhật ký Anne Frank (TB 2022)",66000,100000,34000,34
TIKI,nha-sach-tiki,138934612,"Combo 4 Cuốn: Tô Màu Phát Triển Trí Não Bộ Cho Bé 1-5 Tuổi",45000,64000,19000,30
TIKI,nha-sach-tiki,88783858,"Màu Nước Dạng Tuýp 5Ml Deli - 12 Màu/18 Màu/24 Màu - 73859 / 73860 / 73861",86400,86400,0,0
TIKI,nha-sach-tiki,52665707,"Nghệ Thuật Kiếm Tiền Của Người Do Thái (Tái Bản 2020)",59000,90000,31000,34
TIKI,nha-sach-tiki,95090938,"Bút chì màu chuyên nghiệp dạng cốc Deli 24/36/48 màu - 68123/68124/68125",106200,106200,0,0
TIKI,nha-sach-tiki,169621652,"Anh Đừng Quyến Rũ Tôi - Tập 2",127000,169000,42000,25
TIKI,nha-sach-tiki,128635778,"Thái Nhân Cách - Phía Sau Tội Ác (Khám Phá Bộ Não Của Những Kẻ Sát Nhân Máu Lạnh)",131600,189000,57400,30
TIKI,nha-sach-tiki,148802212,"Phong Ma Yến Tước Tập 1 - Nuối Tiếc Giang Hồ",164000,215000,51000,24
TIKI,nha-sach-tiki,51251660,"Chữa Lành Ánh Sáng Bản Thể",153000,220000,67000,30
TIKI,nha-sach-tiki,860788,"Harvard Bốn Rưỡi Sáng",111000,139000,28000,20
TIKI,nha-sach-tiki,173732586,"423 Lời Vàng của Phật Kinh Pháp Cú Dhammapada (Tái bản)",33000,33000,0,0
TIKI,nha-sach-tiki,101985321,"12 Quy Tắc Lãnh Đạo Từ Seal (Trách Nhiệm Tối Thượng - Thành Công Tối Đa)",142000,186000,44000,24
TIKI,nha-sach-tiki,104732038,"Tớ Học Lập Trình - Làm Quen Với Lập Trình Scratch",94500,105000,10500,10
TIKI,nha-sach-tiki,68330624,"Dế Mèn Phiêu Lưu Ký – Đậu Đũa Minh Họa - Ấn Bản Kỉ Niệm 100 Năm Tô Hoài",160000,225000,65000,29
TIKI,nha-sach-tiki,74416876,"Luyện Giải Bộ Đề Bồi Dưỡng Học Sinh Giỏi Tiếng Anh Lớp 6",53100,89000,35900,40
TIKI,nha-sach-tiki,273636803,"Trạm Đọc Official | Combo 2 Cuốn Hackers IELTS : Hackers IELTS Listening + Hackers IELTS Reading",373000,498000,125000,25
TIKI,nha-sach-tiki,57211761,"Nhóc Nicolas: Những chuyện chưa kể Tập 2 (Tái Bản 2020)",65800,85000,19200,23
TIKI,nha-sach-tiki,181699634,"Tổng Thống K. Thứ Tư",131000,200000,69000,35
TIKI,nha-sach-tiki,50586033,"The magic phép màu ( tái bản )",214000,238000,24000,10
TIKI,nha-sach-tiki,53303190,"Perfect IELTS Vocabulary",194000,259000,65000,25
TIKI,nha-sach-tiki,194005243,"Truyện cổ Andersen",58500,79000,20500,26
TIKI,nha-sach-tiki,174038516,"Máy tính Casio FX-570VN Plus New dành cho học sinh cấp 2-3 chuyên dụng phòng thi và thi đại học",549000,627000,78000,12
TIKI,nha-sach-tiki,16631728,"Sách Dám Nghĩ Lớn (Bìa Cứng)",131000,188000,57000,30
TIKI,nha-sach-tiki,1725947,"Combo Hồng Lâu Mộng (Trọn Bộ 4 Tập Bìa Cứng)",240000,499000,259000,52
TIKI,nha-sach-tiki,145288033,"Năm Tháng Tĩnh Lặng, Kiếp Này Bình Yên (Tái Bản)",104000,138000,34000,25
TIKI,nha-sach-tiki,73871086,"Bộ Dây Trang Trí Sinh Nhật Chữ Happy Birthday Thiết Kế Hoạt Hình",40000,40000,0,0
TIKI,nha-sach-tiki,160370109,"Chính Bắc (Discover Your True North) - Khám Phá Ra “Chiếc La Bàn Nội Tâm” Của Chính Mình Để Dẫn Dắt Bản Thân Nhằm Trở Thành Nhà Lãnh Đạo Đích Thực (Tái Bản)",120600,155000,34400,22
TIKI,nha-sach-tiki,95089958," Bút gel Deli - 0.5mm - Nắp đậy - Mực Xanh - 1 chiếc - EQ300-BL",10800,10800,0,0
TIKI,nha-sach-tiki,171549980,"Bức Tranh Toàn Cảnh - Nguồn Gốc Của Sự Sống, Của Nghĩa Lý Và Của Chính Vũ Trụ",208000,269000,61000,23
TIKI,nha-sach-tiki,84565498,"Thuật Xử Thế Của Người Xưa (Tái Bản 2021)",37000,55000,18000,33
TIKI,nha-sach-tiki,115897815,"Tâm Hơn Thuốc - Minh Chứng Khoa Học Về Sự Tự Chữa Lành",119000,179000,60000,34
TIKI,nha-sach-tiki,138504802,"Kinh Doanh Giỏi Phải Kiếm Được Tiền",110700,159000,48300,30
TIKI,nha-sach-tiki,7125311,"10 Vạn Câu Hỏi Vì Sao - Vật Lý Vui (Tái Bản 2018)",41000,55000,14000,25
TIKI,nha-sach-tiki,65443438,"Sách PACE Books - KPI thước đo mục tiêu trọng yếu (Key Performance Indicators) - David Parmenter",155000,195000,40000,21
TIKI,nha-sach-tiki,173347859,"Thiết Kế Sự Nghiệp Tương Lai",79100,109000,29900,27
TIKI,nha-sach-tiki,58946834,"Sách PACE Books - Lãnh đạo tỉnh thức (The Mindful Leader) - Michael Bunting",108000,108000,0,0
TIKI,nha-sach-tiki,53095307,"Nàng Tóc Đỏ (Nobel Văn Chương 2006)",89000,120000,31000,26
TIKI,nha-sach-tiki,555504,"Sách Đắc Nhân Tâm (Bìa Cứng) (Tái Bản)",74600,108000,33400,31
TIKI,nha-sach-tiki,138934624,"Tô Màu Phát Triển Trí Não Bộ Cho Bé 1-5 Tuổi - Tập 1",16000,16000,0,0
TIKI,nha-sach-tiki,109262820,"Gôm tẩy hình hoa anh đào Nhật Bản Deli -1 chiếc - dành cho học sinh - 71135 / 71136",7200,7200,0,0
TIKI,nha-cua-doi-song,121243851,"Vòi rửa bát inox 304 Pimisi gắn chậu rửa bát 1 đường nước lạnh đơn cho mọi loại chậu rửa chén phổ biến trong nhà bếp | Hàng chính hãng",463000,700000,237000,34
TIKI,nha-cua-doi-song,32004018,"PHÂN GÀ HỮU CƠ (NHẬT BẢN) - BAO 5KG - SẢN PHẨM CAO CẤP CHO MỌI LOẠI CÂY TRỒNG ( MS 025)",90000,90000,0,0
TIKI,nha-cua-doi-song,130978265,"Ổ cắm Xoay 90° Điện Quang ĐQ ESK RT 6GW (6 lỗ, màu xanh lá trắng)",77440,103300,25860,25
TIKI,nha-cua-doi-song,134361201,"Giấy Dán Tường Nhà Bếp Chống Thấm Dầu Mở, Chống Thấm Nước, Cách Nhiệt Tiện Dụng [Tặng Móc Dán Tường Treo Đồ",43000,43000,0,0
TIKI,nha-cua-doi-song,56562967,"Combo 5 Miếng Xốp Dán Tường Giả Gạch Dày 4mm -  Trắng",51299,53999,2700,5
TIKI,nha-cua-doi-song,67096743,"Combo Full Bộ Ống Hút Inox 304 Thép Không Gỉ, Tái Chế Sử Dụng, Thân Thiện Môi Trường - Hàng Chính Hãng",29000,29000,0,0
TIKI,nha-cua-doi-song,14526627,"Quánh Inox 430 Bếp Từ 3 Đáy Fivestar Nắp Kính",199000,199000,0,0
TIKI,nha-cua-doi-song,81936306,"Kệ Decor Phòng Gương 2 Tầng Morning House",169000,169000,0,0
TIKI,nha-cua-doi-song,196571419,"CHẢO CẠN INOX 5 ĐÁY SUNHOUSE 16-20-24-26-28CM (DÙNG TRÊN MỌI LOẠI BẾP)",175000,175000,0,0
TIKI,nha-cua-doi-song,186883908,"Khăn tắm nén du lịch (70x140cm) bằng cotton thấm hút tốt, dùng một lần tiện lợi - Chính hãng MINIIN",21000,29000,8000,28
TIKI,nha-cua-doi-song,83397956,"MXK4 - 25x15x10 cm - 20 Thùng hộp carton",52600,52600,0,0
TIKI,nha-cua-doi-song,50254577,"Thước Đo Khoảng Cách Bằng Tia Laser SNDWAY Phạm Vi 50m SW-M50 Cao Cấp AZONE",350000,350000,0,0
TIKI,nha-cua-doi-song,51915247,"Combo 200 túi lọc rác bồn rửa bát",22999,22999,0,0
TIKI,nha-cua-doi-song,76827765,"Pin Energizer ECR2025 Lithium 3V Chính Hãng | Bộ Vỉ 5 Viên",55300,59000,3700,6
TIKI,nha-cua-doi-song,142857607,"Thông tắc vệ sinh, dây thông cống lò xo, tiện dụng và được việc",45000,67500,22500,33
TIKI,nha-cua-doi-song,80657249,"Hộp vải đựng đồ đa năng có nắp TD3a và TD3b – Túi vải Thụy Điển có nắp rời 34L sang trọng vải Oxford chính hãng miDoctor",129000,200000,71000,36
TIKI,nha-cua-doi-song,177679445,"Chuông Cửa Không Dây Thông Minh Besti YBT01 (1 Nút Bấm, 1 Chuông ), Chống Nước, Khoảng Cách Sử Dụng Hiệu Quả 300M, 60 Loại Nhạc Chuông, 4 Mức Điều Chỉnh Âm Lượng - Hàng Chính Hãng",180000,180000,0,0
TIKI,nha-cua-doi-song,135059226,"Móc Dán Tường Inox 304 Dùng Keo 3M Siêu Chắc, Chịu lực lên đến hơn 20kg, Nhiều Kiểu Dáng Đẹp",41000,41000,0,0
TIKI,nha-cua-doi-song,17008839,"Thiết Bị Bấm Lỗ Dây Nịt Da Cầm Tay (6-9")",53091,53091,0,0
TIKI,nha-cua-doi-song,167046966,"Áo bọc bàn để ủi cầu là quần áo có mút Kokomega BU04 KT: 35*100cm( Và Sử Dụng Cho BU-120)",75050,79000,3950,5
TIKI,nha-cua-doi-song,186142362,"Ô Dù Chống Nắng Che Mưa Cản UV Tự Động Đóng Mở Khung 12 Xương",230000,230000,0,0
TIKI,nha-cua-doi-song,147593105,"Miếng chặn khe cửa chống bụi  Nẹp chặn cửa chắn khe hở chống bụi, chống côn trùng, chống thoát hơi gió điều hòa",20000,20000,0,0
TIKI,nha-cua-doi-song,16093882,"Phích Cắm Chuyển Đổi 3 Chấu Sang 2 Chấu Milliken NL-3106",15000,15000,0,0
TIKI,nha-cua-doi-song,50206492,"Thuốc trừ rầy, nhện, kiến, gián mối, bọ chét, ve chó Regent 800WG",40000,40000,0,0
TIKI,nha-cua-doi-song,159144262,"Cây lau nhà VILEDA Turbo Easy Wring&Clean đầu lau tam giác, xô giặt quay bằng chân, thêm 2 bông lau",659000,659000,0,0
TIKI,nha-cua-doi-song,81647926,"Đầu nối chia điện đa năng 3 cửa SOPOKA P11 P12 chịu tải 2200W",32000,32000,0,0
TIKI,nha-cua-doi-song,57863885,"Đồng hồ LED để bàn hình hộp gỗ - Nhiệt kế - Báo thức - Cảm ứng âm thanh",109000,159000,50000,31
TIKI,nha-cua-doi-song,33404972,"Tủ kệ sách để bàn HT003",45600,48000,2400,5
TIKI,nha-cua-doi-song,52188851,"Muỗng Thìa Cà Phê Cán Dài INOX304 24cm",30000,30000,0,0
TIKI,nha-cua-doi-song,59386141,"Bọc Giày Đi Mưa Silicon Siêu Bền Nhiều Màu",59900,59900,0,0
TIKI,nha-cua-doi-song,263076438,"Gối chống trào ngược dạ dày thực quản người lớn Ema giúp giảm trào ngược dạ dày, viêm họng mãn tính, nuốt vướng, nghẹn cổ, khó thở khi ngủ, ngáy ngủ",585000,1170000,585000,50
TIKI,nha-cua-doi-song,187843307,"Đèn Năng Lượng Mặt Trời Chống Lóa 100W 200W 300W, 4LED 200W 300W 500W",720000,900000,180000,20
TIKI,nha-cua-doi-song,63479866,"[CHÍNH HÃNG] Khoá treo đồng bấm Việt - Tiệp Cao cấp - Chống trộm | Mã SP: 01524",125970,132600,6630,5
TIKI,nha-cua-doi-song,135099603,"Cây lau nhà thay thế bộ lau nhà PX01 (Không bao gồm thùng vắt) - Parroti MOP-PX01",229000,280000,51000,18
TIKI,nha-cua-doi-song,39748239,"Kệ để đồ dán tường cho phòng tắm và nhà bếp (Giao ngẫu nhiên mẫu)",10000,20900,10900,52
TIKI,nha-cua-doi-song,117058329,"Giấy lọc cà phê Hario 100 cái (V60-VCF-01-100W)",89000,99000,10000,10
TIKI,nha-cua-doi-song,46207255,"Combo 2 túi lưới giặt đồ 2 lớp Polyester dạng lưới mịn giặt đồ chống biến dạng quần áo cho máy giặt dạng hộp khóa kéo phù hợp giặt đồ nhỏ đồ lót",45000,45000,0,0
TIKI,nha-cua-doi-song,90597884,"Bàn Học Bàn Làm Việc Ngồi Bệt Model 1 Thông Minh - GP116",382000,415000,33000,8
TIKI,nha-cua-doi-song,184903735,"Khay xếp quần áo chia ngăn 6 7 20, Hộp đựng đồ lót tất vớ chất liệu vải không dệt cao cấp",32000,32000,0,0
TIKI,nha-cua-doi-song,50825030,"Dụng cụ kẹp gắp bát, đĩa, đồ nóng",14500,14500,0,0
TIKI,dien-thoai-may-tinh-bang,249153684,"Điện thoại Realme C55 6GB/128GB Đen trời đêm - Hàng chính hãng",4680000,4990000,310000,6
TIKI,dien-thoai-may-tinh-bang,191764688,"Điện thoại Xiaomi Redmi 10A (2GB/32GB) - Hàng chính hãng",2556000,2556000,0,0
TIKI,dien-thoai-may-tinh-bang,273359931,"Điện Thoại Thông Minh siêu bền Oukitel WP27 (Ram 12GB,Rom 256GB,Màn hình 6.78 “FHD + ,pin 8300MAH,NFC, Android 13 ,CPU MTK G99,chống nước,chống sốc) –hàng chính hãng",6990000,6990000,0,0
TIKI,dien-thoai-may-tinh-bang,197045354,"ĐIỆN THOẠI MASSTEL LUX 20-4G  HÀNG CHÍNH HÃNG",750000,750000,0,0
TIKI,dien-thoai-may-tinh-bang,249730338,"Điện Thoại 4G Masstel Lux 20 - 2 Sim 2 Sóng - Sóng 4G Hd Call - Loa To Rõ - Hàng Chính Hãng - Bảo Hành 12 Tháng",790000,790000,0,0
TIKI,dien-thoai-may-tinh-bang,273958619,"Điện Thoại Xiaomi Redmi Note 13 6GB-128GB - Hàng chính hãng",4145000,4890000,745000,15
TIKI,dien-thoai-may-tinh-bang,205750556,"Điện Thoại Oppo A57 4GB/128GB - Hàng Chính Hãng",4632000,4632000,0,0
TIKI,dien-thoai-may-tinh-bang,105830021,"Máy Tính Bảng Samsung Galaxy Tab A7 Lite LTE T225 (3GB/32GB) ĐÃ KÍCH HOẠT BẢO HÀNH ĐIỆN TỬ - Hàng Chính Hãng",3587000,3587000,0,0
TIKI,dien-thoai-may-tinh-bang,160051494,"Điện thoại Masstel FAMI 60 4G - Hàng chính hãng, Nguyên Seal",689000,689000,0,0
TIKI,dien-thoai-may-tinh-bang,263675862,"Điện thoại OPPO A77 4GB+4GB/128GB - Sạc siêu nhanh 33W - Hàng nhập khẩu nhật - Bản quốc tế",3369000,4990000,1621000,32
TIKI,dien-thoai-may-tinh-bang,271972435,"iPhone 15 Pro 128GB Titan Đen",25490000,27990000,2500000,9
TIKI,dien-thoai-may-tinh-bang,201003623,"Điện thoại Masstel Fami 12 4G Dành cho người già - Hàng chính hãng",630000,630000,0,0
TIKI,dien-thoai-may-tinh-bang,273684137,"Máy tính bảng quản lý thời gian sử dụng dành cho trẻ em Masstel Kidzone-1 đổi 1 trong vòng 100 ngày",1990000,1990000,0,0
TIKI,dien-thoai-may-tinh-bang,167465856,"Điện thoại Masstel IZI 50 4G , Pin 1700 mah - Hàng chính hãng",419000,549000,130000,24
TIKI,dien-thoai-may-tinh-bang,274186881,"Máy tính bảng Samsung Galaxy Tab A9+ Wifi (4GB/64GB) - Hàng chính hãng",5990000,5990000,0,0
TIKI,dien-thoai-may-tinh-bang,273498357,"Điện Thoại Itel S23 16GB(8GB+8GB)/256GB | Pin 5000mAh | 6.6 Inch | Camera 50MP | HÀNG CHÍNH HÃNG",2490000,3490000,1000000,29
TIKI,dien-thoai-may-tinh-bang,16518729,"Điện thoại để bàn Panasonic KX-TS580 hàng chính hãng",850000,850000,0,0
TIKI,dien-thoai-may-tinh-bang,197670818,"Điện thoại Samsung Galaxy A04s (4GB/64GB) - Hàng chính hãng",2590000,3990000,1400000,35
TIKI,dien-thoai-may-tinh-bang,272328188,"Điện Thoại Samsung A05 4GB/128GB - Hàng Chính Hãng",2649000,3090000,441000,14
TIKI,dien-thoai-may-tinh-bang,274516245,"Điện thoại Masstel Fami 60S 4G(LTE) ,Bàn phím lớn, Khung viền kim loại - Hàng chính hãng",656000,750000,94000,13
TIKI,dien-thoai-may-tinh-bang,249730336,"Điện Thoại Masstel Fami 60 4G LTE - Pin 2000 mAh - Chức Năng SOS - Hàng Chính Hãng - Bảo Hành 12 tháng",730000,730000,0,0
TIKI,dien-thoai-may-tinh-bang,263041214,"Điện thoại Gaming Tecno POVA 4 8GB/128GB - Hàng Chính Hãng - MediaTek G99 | 6000mAh - 6.82 inch - Bảo hành 13 Tháng",3649000,4690000,1041000,22
TIKI,dien-thoai-may-tinh-bang,270814412,"Điện thoại Tecno CAMON 20 Premier 5G - 8GB/512GB | Dimensity 8050| Cụm Camera 108+50+ 2MP | AMOLED - Tần số quét 120Hz - Hàng chính hãng",11990000,11990000,0,0
TIKI,dien-thoai-may-tinh-bang,273411607,"Điện thoại Samsung Galaxy M14 5G (4GB/64GB) - Hàng chính hãng",2750000,3690000,940000,25
TIKI,dien-thoai-may-tinh-bang,274380639,"Điện thoại Oppo Reno11 F 5G (8GB/256GB) - Hàng Chính Hãng",7990000,8990000,1000000,11
TIKI,dien-thoai-may-tinh-bang,272392928,"Điện thoại Samsung Galaxy A05 (4GB/128GB) - Hàng chính hãng - ĐÃ KÍCH HOẠT BẢO HÀNH ĐIỆN TỬ",3090000,3090000,0,0
TIKI,dien-thoai-may-tinh-bang,271530789,"Combo Máy đọc sách All New Kindle Paperwhite 5 (11th) KIDS EDITTION (KHÔNG QUẢNG CÁO) và Bao da - Hàng chính hãng",4064300,4190000,125700,3
TIKI,dien-thoai-may-tinh-bang,252427658,"Điện thoại Tecno SPARK 10 Pro 8GB/128GB - Helio G88 | 5000 mAh | Sạc nhanh 18W | Cảm ứng vân tay - Hàng chính hãng",3679000,3990000,311000,8
TIKI,dien-thoai-may-tinh-bang,160556149,"Máy tính bảng Samsung Galaxy Tab A8 - Hàng chính hãng",5856000,5856000,0,0
TIKI,dien-thoai-may-tinh-bang,273872197,"Máy Tính Bảng Samsung Galaxy Tab A9 Wifi 4GB/64GB - Hàng Chính Hãng",2739000,3990000,1251000,31
TIKI,dien-thoai-may-tinh-bang,270471101,"Điện Thoại Nokia 110 4G Pro TA-1559 - Hàng Chính Hãng",650000,710000,60000,8
TIKI,dien-thoai-may-tinh-bang,274524742,"Điện thoại Fonrox F2163 4G , Gọi HD Call , Lướt WEB , 2 sim 2 sóng - Hàng chính hãng",339000,399000,60000,15
TIKI,dien-thoai-may-tinh-bang,263438008,"Điện thoại Masstel Hapi 30 4G Hàng Chính Hãng",2290000,2290000,0,0
TIKI,dien-thoai-may-tinh-bang,158742790,"Máy tính bảng Samsung Galaxy Tab A8 (4GB/64GB) - Hàng Chính Hãng",5856000,5856000,0,0
TIKI,dien-thoai-may-tinh-bang,274101255,"Máy Tính Bảng Samsung Galaxy Tab A9 Wifi 4GB/64GB - Hàng Chính Hãng",2650000,3990000,1340000,34
TIKI,dien-thoai-may-tinh-bang,274405521,"Điện Thoại Samsung A05 4GB/64GB - Hàng Chính Hãng",2409000,2990000,581000,19
TIKI,dien-thoai-may-tinh-bang,272056193,"Điện Thoại Xiaomi Redmi Note 12 8GB/128GB - Hàng Chính Hãng",4029000,5790000,1761000,30
TIKI,dien-thoai-may-tinh-bang,250111470,"Điện thoại Xiaomi Redmi Note 12 (8GB/128GB) - Hàng chính hãng",4190000,5790000,1600000,28
TIKI,dien-thoai-may-tinh-bang,273411606,"Điện thoại Samsung Galaxy M14 5G (4GB/128GB) - Hàng chính hãng",3590000,3990000,400000,10
TIKI,dien-thoai-may-tinh-bang,274542983,"Điện Thoại Samsung A05 6GB/128GB - Hàng Chính Hãng",3049000,3490000,441000,13
TIKI,nha-cua-doi-song,152816167,"Bình Đựng Nước 2L Dễ Thương Có Vạch Báo Giờ Uống Nước Mỗi Ngày Kèm Khăn Lau 2 Mặt BaoAn - Hàng Chính Hãng",89000,99000,10000,10
TIKI,nha-cua-doi-song,204279461,"Lư xông trầm gỗ hương nguyên khối cao cấp HÀ XÁ",199000,398000,199000,50
TIKI,nha-cua-doi-song,52760599,"Dây Đèn LED Đom Đóm Fairy Light Trang Trí Ngoài Trời Chống Nước, Nhiều Chế Độ Sáng",42000,42000,0,0
TIKI,nha-cua-doi-song,73371758,"Găng tay làm vườn -  Găng Tay Chống Cắt Ansell 11-801 Cấp Độ 1 - Chống Đâm Xuyên, Giặt Và Tái Sử Dụng",61750,65000,3250,5
TIKI,nha-cua-doi-song,134582057,"TẤM LÓT BẢO VỆ NỆM HÀNG KHÁCH SẠN CAO CẤP 1M/1M2/1M4/1M6/1M8/2M2",140000,140000,0,0
TIKI,nha-cua-doi-song,49116420,"Bút thử nước TDS, dụng cụ đo TDS, máy đo độ cứng của nước",102000,159000,57000,36
TIKI,nha-cua-doi-song,114938906,"Bộ 6 Ly Thấp Thuỷ Tinh Luminarc Louvre 260ml -  LULON1808",281000,281000,0,0
TIKI,nha-cua-doi-song,10768010,"Đèn bắt muỗi Điện Quang ĐQ EML06L ",300000,300000,0,0
TIKI,nha-cua-doi-song,155184630,"Móc Treo Quần Áo, Móc Treo Đa Năng Hara, Bộ Sưu Tập Móc Quần Áo Người Lớn Nhựa Cao Cấp Inochi",26950,26950,0,0
TIKI,nha-cua-doi-song,90510185,"Ghế gác chân, Gác chân Guitar - Kzm Kurtzman KGQ3 - Điều chỉnh 4 mức độ cao thấp - Hàng chính hãng",112000,112000,0,0
TIKI,nha-cua-doi-song,172123103,"Bàn làm việc thông minh kèm giá sách cho học sinh, sinh viên hiện đại kiểu Hàn từ gỗ MDF, phủ Melamin chống xước ND01",400000,400000,0,0
TIKI,nha-cua-doi-song,69253420,"Ổ khóa cao cấp Toplex, 1205-50mm",90000,90000,0,0
TIKI,nha-cua-doi-song,119025800,"Bộ 5 Hộp Đựng Thực Phẩm Giỏ Có Nắp Đậy Khay Nhựa Kèm Rổ Ráo Nước Để Tủ Lạnh Bảo Quản Thức Ăn Tiện Dụng",119935,119935,0,0
TIKI,nha-cua-doi-song,194496895,"Chặn cửa chân móng ngựa có lẫy gạt HOBBY Home Decor CMG1 chống va đập cửa ở bất kì vị trí nào tiện dụng",85000,129000,44000,34
TIKI,nha-cua-doi-song,179063461,"Bộ 2 khăn tắm cotton cao cấp dành cho gia đình, siêu thấm hút, mềm mại, kháng khuẩn",189000,189000,0,0
TIKI,nha-cua-doi-song,153770352,"Thanh Móc 9 Lỗ Treo Quần Áo Tiện Dụng",7500,12000,4500,38
TIKI,nha-cua-doi-song,181909432,"Chảo Suit LocknLock CSU1263PIK - Màu Pink",395000,759000,364000,48
TIKI,nha-cua-doi-song,14453485,"Combo 10 móc treo đồ dán tường",4790,4790,0,0
TIKI,nha-cua-doi-song,47461891,"Bộ 6 vỉ (12 viên pin) pin Kiềm Alkaline Panasonic AA LR6T/2B-Hàng chính hãng",172000,180000,8000,4
TIKI,nha-cua-doi-song,164326067,"Bộ Chổi Điện Cọ Rửa Đa Năng Spin 3 Đầu - Máy Chà Tẩy Rửa Vệ Sinh Thông Minh Dùng Cho Nhà Tắm, Nhà Bếp - HÀNG CHÍNH HÃNG",495000,495000,0,0
TIKI,nha-cua-doi-song,196362415,"Máy cắt cỏ, tỉa cành cầm tay LAPUSEN pin khủng 15000mah, động cơ mạnh 1800w",843600,888000,44400,5
TIKI,nha-cua-doi-song,20615119,"Pin sạc AAA NiMH dung lượng lớn 1300mah (4 Viên AAA)",119000,119000,0,0
TIKI,nha-cua-doi-song,167391475,"Kệ Để Giày Dép 05 Tầng Khung Inox, Giá Để Giày Inox 05 Tầng, Giày Dép, Kệ Để Đồ, Kệ Sách Loại Cao Cấp miDoctor",106000,180000,74000,41
TIKI,nha-cua-doi-song,54029566,"Bộ Dụng Cụ Tua Vít Đa Năng Nhiều Món Có Từ Tính 111 in 1 Dùng Tháo Lắp, Tháo Mở Và Sửa Chữa Điện Thoại Di Động, Máy Tính, PC/ Laptop, Máy Tính Bảng",175000,175000,0,0
TIKI,nha-cua-doi-song,204204717,"Nhang khoanh trầm hương HÀ XÁ xông nhà 100g đồ thờ cúng thanh lọc không khí, an toàn cho sức khỏe",199000,398000,199000,50
TIKI,nha-cua-doi-song,67111908,"Mật rỉ đường ủ phân bón (can 7kg) - Mật đường can 5 Lít",155000,155000,0,0
TIKI,nha-cua-doi-song,52145781,"Bàn Trà Cafe, Bàn Trà Sofa Phong Cách Bắc Âu Thương Hiệu IGEA",199000,218000,19000,9
TIKI,nha-cua-doi-song,517873,"Giá Phơi Đồ Inox Co Giãn Thông Minh Prota - 86 Cm",290000,290000,0,0
TIKI,nha-cua-doi-song,71544914," Ổ Cắm Wifi Thông Minh TP-Link Tapo P100 - Hàng Chính Hãng ",199000,199000,0,0
TIKI,nha-cua-doi-song,448378,"Hộp Cơm Giữ Nhiệt Zojirushi ZOCM-SL-JAF14-SA 4 Ngăn - 1.3L (Bạc)",950500,950500,0,0
TIKI,nha-cua-doi-song,163583429,"Máy Xay Hạt Cafe, Hạt Khô, Hạt Tiêu, Ngũ Cốc, Đậu Nành Đa Năng, Cối Xay Thép Không Gỉ SUS 304 Cao Cấp - Hàng Chính Hãng MINIIN",199000,199000,0,0
TIKI,nha-cua-doi-song,6329515,"Đèn gắn tường - đèn tường - đèn treo tường cao cấp FLOWER",118000,118000,0,0
TIKI,nha-cua-doi-song,7202329,"Bộ 3 Hộp Thủy Tinh KOVA KLOCK370 (370ml/ Hộp)",137000,200000,63000,32
TIKI,nha-cua-doi-song,149149135,"Kệ Gia Vị 3 Tầng Để Bàn Thương Hiệu IGA - GM04",181000,197000,16000,8
TIKI,nha-cua-doi-song,249157000,"Giá Treo Bàn Chải Đánh Răng OENON liền 2 Nhả Kem tự động kèm cốc hút từ tính lắp đặt dán tường gạch men",99000,180000,81000,45
TIKI,nha-cua-doi-song,127215514," Hộp Đũa Dán Tường Jodily Có Nắp Sang Trọng, Sạch Sẽ",205000,205000,0,0
TIKI,nha-cua-doi-song,170876560,"Khăn giấy ướt vịt vàng 10 gói kèm thùng nhựa tiện dụng siêu đáng - Amina",46550,49000,2450,5
TIKI,nha-cua-doi-song,148797223,"Bộ Hộp Cơm Giữ Nhiệt Văn Phòng Cao Cấp Cắm Điện inox 3 Tầng - Chính Hãng MINIIN",176000,199000,23000,12
TIKI,nha-cua-doi-song,173558017,"Lưỡi cắt cỏ tận gốc sợi thép siêu bền",85000,85000,0,0
TIKI,nha-cua-doi-song,166659124,"Dao Nhật Bản Siêu Sắc Bén Hàng Chính Hãng Cao Cấp ",365000,365000,0,0
TIKI,nha-cua-doi-song,43389470,"Bàn Ăn Thông Minh Tiết Kiệm Diện Tích Màu Sắc Hiện Đại",1127000,1220000,93000,8
TIKI,nha-cua-doi-song,132855126,"Rèm Cửa Sổ, Rèm Cửa Ra Vào Vintage Phong Cách Scandinavian Bắc Âu",358000,358000,0,0
TIKI,nha-cua-doi-song,71105497,"Bộ ấm trà xách tay đơn giản, sang trong, tiện lợi khi đi du lịch",299000,299000,0,0
TIKI,nha-cua-doi-song,106808360,"Bình Giữ Nhiệt Lock&Lock Riga Tumbler LHC4160 (897ml) - Hàng Chính Hãng, Bằng Thép Không Gỉ, Có Lưới Lọc Inox - Tặng Kèm Ống Hút Và Cọ Rửa Ống Hút",399000,735000,336000,46
TIKI,nha-cua-doi-song,72646362,"Bộ dụng cụ di chuyển đồ nặng chuyên dụng tải trọng tối đa 1000kg xoay 360 độ",275000,275000,0,0
TIKI,nha-cua-doi-song,241980823,"Combo 20 Kẹp Inox 304 Phơi Quần Áo, Chăn Mền",25000,25000,0,0
TIKI,nha-cua-doi-song,272452606,"Bộ cây lau nhà tự vắt thông minh 3 thanh vắt sợi microfiber",550000,1190000,640000,54
TIKI,nha-cua-doi-song,144527016,"Bộ Mũi khoan đa năng khoan gốm sứ tường, 1 Bộ 5 món 6/6/8/10/12mm",95195,95195,0,0
TIKI,nha-cua-doi-song,169518924,"Bình Giữ Nhiệt Inox 304 - YOGA QG, Dung Tích 1000ml - 15000ml, Giữ Nhiệt Tốt Đến 12h, Thiết Kế Sang Trọng, Màu Sắc Bắt Mắt - Hàng chính hãng",114000,125000,11000,9
TIKI,nha-cua-doi-song,162427187,"Dụng Cụ Bơm Hút Rượu Xăng Dầu Chất Lỏng Bóp Tay Tiện Lợi Đa Năng - Hàng Loại 1-  Chính Hãng MINIIN",47000,76000,29000,38
TIKI,nha-cua-doi-song,107016572,"Thùng rác văn phòng lưới Deli - Sọt đựng rác - Màu đen - 28cm - 9188/E9190",214200,214200,0,0
TIKI,nha-cua-doi-song,79665351," Đèn Led gắn tường, tủ đọc sách  tích điện đa năng 4 cấp độ",135000,135000,0,0
TIKI,nha-cua-doi-song,536498,"Bộ Vặn Vít Đa Năng 38 Chi Tiết Bosch 2607019506",439000,494000,55000,11
TIKI,nha-cua-doi-song,49300423,"Kệ Gương Gỗ",415000,430000,15000,3
TIKI,nha-cua-doi-song,213710307,"Lưỡi cưa xích RAKUTEN LOẠI 1 gắn máy mài cầm tay, bộ dụng cụ chuyển đổi máy mài thành máy cưa gỗ mini",132050,139000,6950,5
TIKI,nha-cua-doi-song,151555811,"Bàn làm việc có kệ - Màu vàng nhạt - 80cmx40cmx75cm",359000,359000,0,0
TIKI,nha-cua-doi-song,36452514,"Đèn pin siêu sáng mini 2in1",46505,86000,39495,46
TIKI,nha-cua-doi-song,108243510,"Chảo Inox cao cấp 5 Đáy chống dính siêu bền Sunhouse IN20M2 - 20 cm - Dùng trên mọi loại bếp - Hàng chính hãng",293000,450000,157000,35
TIKI,nha-cua-doi-song,59267058,"Bình Pha Cà Phê Cold Brew Thủy Tinh 1200ml",279000,279000,0,0
TIKI,nha-cua-doi-song,73553244,"Hộp Đựng Trang Sức MOHI MH10 Kích Thước 10x10x5.5cm - Hàng Chính Hãng",64400,70000,5600,8
TIKI,nha-cua-doi-song,73988526,"Đuôi thoát sàn ngăn mùi hôi, chống côn trùng trọng lực nhựa ABS Hiwin FD-50LID",54000,54000,0,0
TIKI,nha-cua-doi-song,176076047,"Khăn Lau  Nhà Bếp Siêu Thấm Nước Mềm Mại Size Lớn",9000,9000,0,0
TIKI,nha-cua-doi-song,73829087,"Kệ để đồ rửa chén bát gác trên bồn rửa inox 304 Hobby Home Decor KRC5 có khay hứng nước",99000,159000,60000,38
TIKI,nha-cua-doi-song,137136435," Keo silicon Apollo A500 chống thấm tốt, bền bỉ (keo trong - keo trắng đục) 300ml",61750,65000,3250,5
TIKI,nha-cua-doi-song,89227279,"Giấy bạc dán tường nhà bếp chống thấm dầu, thấm nước tiện dụng, cách nhiệt",69000,69000,0,0
TIKI,nha-cua-doi-song,176805088,"COMBO 3 Túi Phân Bón Lan ORCHID 1-2-3 - Dưỡng rễ, Cây, Kích Ra Hoa cho Phong Lan, cây kiểng - tan chậm Túi Lưới",79000,79000,0,0
TIKI,nha-cua-doi-song,170270819,"Ổ cắm chuyển đổi 3 chấu sang 2 chấu tiện lợi - Hàng nhập khẩu",12000,25000,13000,52
TIKI,nha-cua-doi-song,72901343,"Combo 4 Móc Dán Tường Inox 304 Hình Trụ Vuông MD02 Cao Cấp Chống Gỉ Sét Siêu Bền Siêu Chịu Lực - Móc Treo Đồ Gia Đình Tiện Dụng",135000,230000,95000,41
TIKI,nha-cua-doi-song,75339729,"Chổi Quét Trần Nhà, Chổi Phất Trần Có Cán Điều Chỉnh Độ Dài KUNBE Quét Mạng Nhện, Lau Chùi Bụi Bẩn Trên Cao Tiện Dụng",149000,149000,0,0
TIKI,nha-cua-doi-song,112976323,"Đèn LED cảm biến chuyển động SEASY SS02, cảm biến thông minh, ánh sáng bảo vệ mắt, sạc pin USB đời mới, dán tường, tủ quần áo, cầu thang, phòng ngủ - Hàng chính hãng",42000,89000,47000,53
TIKI,nha-cua-doi-song,67707813,"Phụ kiện Ngăn mùi nhà tắm - INOX 304 lắp thoát sàn chống mùi hôi ngăn vi khuẩn trào ngược lên – DH2011",98000,98000,0,0
TIKI,nha-cua-doi-song,191326374,"Bộ Sạc Pin AA, AAA Beston Tự ngắt khi đầy Sạc Tốc Độ Cao Có Led báo trạng thái sạc BST-C9009, Pin sạc chính hãng",60000,60000,0,0
TIKI,nha-cua-doi-song,124483451,"TREO CHỔI TREO CÂY LAU NHÀ TREO Ô DÙ VÒI HOA SEN VÒI NƯỚC JODILY DÁN TƯỜNG INOX 304",45000,45000,0,0
TIKI,nha-cua-doi-song,118090738,"Kệ Treo Tường - Thanh Ngang Trang Trí Màu Vân Gỗ Sồi Đơn Giản SIB Decor, Gỗ Chống Ẩm 25mm, Kết Cấu Không Giá Đỡ Chắc Chắn Thẩm Mỹ",159000,159000,0,0
TIKI,nha-cua-doi-song,187512713,"Ly Thủy Tinh Navivu Oval 380ml - Cốc Thủy Tinh Uống Trà",45000,45000,0,0
TIKI,nha-cua-doi-song,116194000,"Hộp đựng trứng, khay trứng, hộp bảo quản thực phẩm tủ lạnh Homepower cao cấp, trên nắp đậy có phần ghi chú thời gian bảo quản tiện lợi",169000,169000,0,0
TIKI,nha-cua-doi-song,95875948,"Ổ khóa cửa treo Việt Tiệp đồng vàng",58045,61100,3055,5
TIKI,nha-cua-doi-song,19448864,"Bộ võng xếp BAN MAI: khung sơn tĩnh điện VIP và lưới mềm dày 99 ( Giao màu ngẫu nhiên )",749000,1050000,301000,29
TIKI,nha-cua-doi-song,152446406,"Cây Chúc ( chanh thái ) - Cây chanh ăn lá ( chanh hấp gà ) + Tặng phân bón cho cây",39000,58000,19000,33
TIKI,nha-cua-doi-song,35876754,"Ổ Điện Đa Năng Chống Giật 3 Cổng USB và 9 ổ cắm iCART",37899,37899,0,0
TIKI,dien-thoai-may-tinh-bang,217276360,"Điện thoại Mobell F209 4G ,Loa to, Phím lớn - Hàng chính hãng",567000,670000,103000,15
TIKI,dien-thoai-may-tinh-bang,273951550,"Điện Thoại Samsung Galaxy A15 LTE (8GB/128GB)- Đã Kích Hoạt Bảo Hành Điện tử - Hàng Chính Hãng",4290000,4990000,700000,14
TIKI,dien-thoai-may-tinh-bang,270814388,"Điện thoại Tecno POVA 5 (8+8)/128GB - MediaTek Helio G99 - Sạc nhanh 45W - 6.8'' FHD+120HZ - Hàng Chính Hãng - BH 13 Tháng",3690000,4490000,800000,18
TIKI,dien-thoai-may-tinh-bang,274456447,"Điện thoại Samsung Galaxy A35 5G (8GB/128GB) - Hàng chính hãng",7949000,8290000,341000,4
TIKI,dien-thoai-may-tinh-bang,273668660,"Điện Thoại Oppo A18 4GB/64GB - Hàng Chính Hãng",3329000,3690000,361000,10
TIKI,dien-thoai-may-tinh-bang,274365104,"Điện thoại Xiaomi Redmi Note 13 Pro (8GB/128GB) - Hàng Chính Hãng",5990000,7290000,1300000,18
TIKI,dien-thoai-may-tinh-bang,272151221,"Điện thoại Xiaomi Redmi 10 2022 (4GB/128GB) - Hàng chính hãng",2690000,3990000,1300000,33
TIKI,dien-thoai-may-tinh-bang,203278278,"Điện Thoại Samsung A04 3GB/32GB - Hàng Chính Hãng",2159000,2990000,831000,28
TIKI,dien-thoai-may-tinh-bang,273348837,"Điện thoại Xiaomi Redmi 13C (6GB/128GB) - Hàng chính hãng",2890000,3290000,400000,12
TIKI,dien-thoai-may-tinh-bang,248655651,"Điện Thoại Samsung Galaxy A14 5G (4GB/128GB) - Hàng chính hãng - ĐÃ KÍCH HOẠT BẢO HÀNH ĐIỆN TỬ",5000000,5000000,0,0
TIKI,dien-thoai-may-tinh-bang,273165324,"Điện thoại Xiaomi Redmi A2 (2GB/32GB) - Hàng chính hãng",2190000,2190000,0,0
TIKI,dien-thoai-may-tinh-bang,251448280,"Samsung Galaxy A34 5G A346E (8+128G) Silver Bạc - Hàng Chính Hãng (chỉ giao HN và một số khu vực)",7164000,7164000,0,0
TIKI,dien-thoai-may-tinh-bang,203853390,"Điện Thoại Oppo A17k (3GB/64GB)",2390000,3290000,900000,27
TIKI,dien-thoai-may-tinh-bang,225936344,"Máy tính bảng Samsung Galaxy Tab A8 (4GB/64GB) - Hàng Chính Hãng",5856000,5856000,0,0
TIKI,dien-thoai-may-tinh-bang,219397711,"Điện thoại Samsung Galaxy A14 5G A146P (4+128G) Đen - Hàng Chính Hãng (chỉ giao HN và một số khu vực)",5080000,5080000,0,0
TIKI,dien-thoai-may-tinh-bang,273897681,"Điện thoại Tecno SPARK GO 2024 (4+4)GB/64GB - Unisoc T606 | 5000 mAh | 6,6" HD+ | Hàng Chính Hãng",2009000,2190000,181000,8
TIKI,dien-thoai-may-tinh-bang,270544863,"Điện Thoại Samsung Galaxy A24 (8GB/128GB) - Hàng Chính Hãng",6084000,6084000,0,0
TIKI,dien-thoai-may-tinh-bang,242712931,"Điện thoại Samsung Galaxy S23 Ultra 512GB - Hàng chính hãng",36990000,36990000,0,0
TIKI,dien-thoai-may-tinh-bang,219392186,"Điện thoại OPPO CPH2471 - A17k Vàng - Hàng Chính Hãng (chỉ giao HN và một số khu vực)",3276000,3276000,0,0
TIKI,dien-thoai-may-tinh-bang,273653444,"Máy tính bảng Kindle Fire Hd 10 2023 13th - Hàng nhập khẩu",3790000,3790000,0,0
TIKI,dien-thoai-may-tinh-bang,191636459,"Điện thoại Masstel IZI 11 4G - Hàng chính hãng",468000,468000,0,0
TIKI,dien-thoai-may-tinh-bang,272056889,"Điện Thoại Samsung A24 6GB/128GB - Hàng Chính Hãng",4789000,6490000,1701000,26
TIKI,dien-thoai-may-tinh-bang,271799133,"Máy tính bảng chắc chắn oukitel RT5 (chống nước,chống va đập,pin 11.000mAh,Màn hình 10.1 inch FHD, Ram 14Gb,Rom 256Gb, CPU : Mediatek 8788,lõi 8, lên đến 2.0 GHz, Camera Trước,sau 16 MP, Android 13)- hàng chính hãng",7490000,7490000,0,0
TIKI,dien-thoai-may-tinh-bang,273683300,"Điện thoại Samsung Galaxy A15 LTE (8GB/128GB) - Hàng chính hãng",4990000,4990000,0,0
TIKI,dien-thoai-may-tinh-bang,173789184,"Điện thoại bàn treo tường TC990",250000,250000,0,0
TIKI,dien-thoai-may-tinh-bang,271967379,"iPhone 15 Plus",22490000,25990000,3500000,13
TIKI,dien-thoai-may-tinh-bang,204802771,"Điện thoại Oppo A57 (4GB/128GB) - Hàng chính hãng",4632000,4632000,0,0
TIKI,dien-thoai-may-tinh-bang,103168844,"Máy tính bảng Samsung Galaxy Tab A7 Lite LTE SM-T225) - ĐÃ KÍCH HOẠT ĐIỆN TỬ - Hàng Chính Hãng",3587000,3587000,0,0
TIKI,dien-thoai-may-tinh-bang,273367316,"Điện Thoại Xiaomi Redmi 13C 6GB/128GB - Hàng Chính Hãng",2979000,3490000,511000,15
TIKI,dien-thoai-may-tinh-bang,217559440,"Điện thoại Samsung Galaxy A03s (3GB/32GB) - Hàng chính hãng",2990000,2990000,0,0
TIKI,dien-thoai-may-tinh-bang,215746882,"Điện thoại OPPO Reno8T 4G - Hàng chính hãng",8136000,8136000,0,0
TIKI,dien-thoai-may-tinh-bang,248762051,"Điện Thoại Samsung A34 5G 8GB/128GB - Hàng Chính Hãng",5939000,8490000,2551000,30
TIKI,dien-thoai-may-tinh-bang,196197701,"Điện thoại Samsung Galaxy Z Fold4 5G (12GB/256GB) - Hàng chính hãng",40990000,40990000,0,0
TIKI,dien-thoai-may-tinh-bang,253443788,"Điện Thoại Samsung Galaxy M14 5G (4GB/64GB) - Hàng Chính Hãng",6000000,6000000,0,0
TIKI,dien-thoai-may-tinh-bang,272241346,"Điện thoại Samsung Galaxy A05s (4GB/128GB) - Hàng chính hãng",3990000,3990000,0,0
TIKI,dien-thoai-may-tinh-bang,273029857,"Điện Thoại Samsung Galaxy A05s (4GB/128GB) - Hàng Chính Hãng",3980000,3980000,0,0
TIKI,dien-thoai-may-tinh-bang,213858174,"Máy tính bảng Samsung Galaxy Tab A7 Lite (3GB/32GB) - Hàng chính hãng - Màn hình 8.7inch TFT LCD, Camera sau 8MP - Bảo Hành 12 Tháng",3587000,3587000,0,0
TIKI,dien-thoai-may-tinh-bang,267178005,"Điện thoại Samsung Galaxy A24 - Hàng chính hãng",5808000,5808000,0,0
TIKI,dien-thoai-may-tinh-bang,263060294,"Điện thoại di động Samsung A24 (6G/128G) - Hàng chính hãng - Đã kích hoạt bảo hành điện tử",5808000,5808000,0,0
TIKI,dien-thoai-may-tinh-bang,273610105,"Điện Thoại Samsung Galaxy A05 - Hàng Chính Hãng",3025000,3025000,0,0
TIKI,nha-cua-doi-song,51966031,"Phân Hữu Cơ Gà Dynamic Nhật Bản Tốt Cây Xanh lá  Cung Cấp Đầy Đủ Dưỡng Chất , Dúng Bón Hoa Hồng ,Cây Kiểng , Cây Ăn Trái( Túi 1 KG)",35000,35000,0,0
TIKI,nha-cua-doi-song,52021362,"Bảng điện nổi V3 Điện Quang ĐQ FEP 32W 03S (màu trắng, 3 lỗ 2 chấu, 3 công tắc)",71000,91900,20900,23
TIKI,nha-cua-doi-song,46601114,"KỆ GƯƠNG 2 TẦNG ĐẦU GIƯỜNG GỖ THÔNG- GLASS SHELF- CAO 50CM x DÀI 30CM x RỘNG 30CM",180000,180000,0,0
TIKI,nha-cua-doi-song,12756233,"Ổ điện thông minh có 6 phích cắm 3 cổng USB (giao màu ngẫu nhiên)",41000,41000,0,0
TIKI,nha-cua-doi-song,142383214,"Hộp Đựng Giấy Ăn Để Bàn Có Ngăn Để Đồ Đa Năng, Hộp Khăn Giấy Nắp Gỗ",25624,25624,0,0
TIKI,nha-cua-doi-song,132209590,"Thảm chùi chân siêu thấm hút nước 3 giây  cho phòng tắm, phòng bếp, dễ dàng vệ sinh, nhanh khô vệ sinh nhà cửa an toàn với da.",28997,28997,0,0
TIKI,nha-cua-doi-song,96419574,"Màng PE trắng khổ 50cm 2,5kg - Màng PE quấn hàng.",135000,135000,0,0
TIKI,nha-cua-doi-song,84958837,"Kệ sách tổ ong đa năng.GP100",65000,75000,10000,13
TIKI,nha-cua-doi-song,141469357,"COMBO 50 Khay (Chén, Bát) Giấy FEST CHOICE FOOD TRAY 3x3 Inches THÁI LAN Hàng Nhập Khẩu Cao Cấp, Dùng 1 Lần Tiện Lợi, An Toàn - CHÍNH HÃNG F010 (Tặng Móc Khóa KETILO)",99000,99000,0,0
TIKI,nha-cua-doi-song,204230323,"Bộ nhang không tăm đầy đủ hộp đựng và máng đốt bằng gỗ nhà HÀ XÁ cao cấp",99000,198000,99000,50
TIKI,nha-cua-doi-song,43110675,"Móc Khóa Tua Vít mini đa năng sửa chữa kính, đồng hồ, điện thoại (6cm x 0,5cm)",9700,9700,0,0
TIKI,nha-cua-doi-song,36568964,"thước kep điện tử sợi carbon 0-150mm",49900,49900,0,0
TIKI,nha-cua-doi-song,26159911,"Decal dán tường thước đo chiều cao Hươu cao cổ 5 AmyShop (145 x 84 cm)",66900,75000,8100,11
TIKI,nha-cua-doi-song,35422376,"Ô Dù 4 Lớp Che Nắng, Đi Mưa Chống Tia UV",37996,37996,0,0
TIKI,nha-cua-doi-song,61278429,"Bình Nước Giữ Nhiệt Có Móc Treo (300ml)",68000,68000,0,0
TIKI,nha-cua-doi-song,202185819,"Bình Giữ Nhiệt Cao Cấp 304  Có Nắp Xoáy Tiện Lợi Giữ Nhiệt Nóng Lạnh",200000,200000,0,0
TIKI,nha-cua-doi-song,72797082,"Chảo Sâu Lòng DECOR Lock&Lock LDE1225IH 22cm (màu vàng) - Hàng chính hãng",397000,662000,265000,40
TIKI,nha-cua-doi-song,141001207,"Ghế Gấp Inox Phòng Chờ, Ghế Xếp Văn Phòng, Ghế Phòng Họp Gấp Gọn - Hàng Chính Hãng",479000,800000,321000,40
TIKI,nha-cua-doi-song,50324146,"Combo 5 Chai Thủy Tinh đựng nước 500ML - Nắp Thiếc vặn có dây treo (Bình thủy tinh đựng nước, đựng sữa - Chai thủy tinh đựng nước ép)",52999,52999,0,0
TIKI,nha-cua-doi-song,271696352,"Gối Niu Cao Cấp Ru9 - Công Nghệ Đột Phá Graphene Foam | Chất Liệu Foam Mềm Mại | Nâng Đỡ Đốt Sống Cổ | Chống Đau Vai Gáy",912000,950000,38000,4
TIKI,nha-cua-doi-song,4995493,"Thang Nhôm Rút Chữ A Sumika SK380D NEW - Chữ A cao 1.9m, chữ I cao 3.8m, tải trọng 300kg",1769000,2300000,531000,23
TIKI,nha-cua-doi-song,93154028,"Thảm lông trải sàn lông mịn kích thước 1.2 x 1.6m- dài Thảm lông trải sàn cao cấp phòng khách trang trí nhà cửa.",175000,175000,0,0
TIKI,nha-cua-doi-song,193095643,"Combo 2 Móc Dán Tường Trong Suốt Treo Đồ Dùng Thông Minh",6900,6900,0,0
TIKI,nha-cua-doi-song,226043852,"Chăn Gối Ngủ Văn Phòng Hình Mèo Kèm Chăn",148000,148000,0,0
TIKI,nha-cua-doi-song,117370665,"Chiếu ngủ trưa văn phòng cá nhân dày 3.5ly / Chiếu Cách Nhiệt Văn Phòng 100 X 190 cm",46000,46000,0,0
TIKI,nha-cua-doi-song,174307623,"Đệm Ngồi Bệt Tròn Cho Bàn Trang Điểm Vải Cao Cấp Kiểu Hàn Chính Hãng IGA - GC13",91000,99000,8000,8
TIKI,nha-cua-doi-song,57650806,"Máy bơm tăng áp mini tự động",480000,480000,0,0
TIKI,nha-cua-doi-song,143299139,"Bình Đựng Nước Cho Bé, Bình Nước Goki Rudy 450ml, Bình Nước Cao Cấp Chính Hãng Inochi Đạt Tiêu Chuẩn Xuất Nhật",82600,118000,35400,30
TIKI,nha-cua-doi-song,778124,"Bộ Hộp Cơm Giữ Nhiệt Lock&Lock LHC8015 (910ml) - Xám Bạc ",619000,1142000,523000,46
TIKI,nha-cua-doi-song,14886261," Máy sấy khử mùi giày",156988,156988,0,0
TIKI,nha-cua-doi-song,89792661,"[tặng kèm khay trúc 02 tầng] Bộ Ấm Chén Pha Trà Du Lịch 2 - Kiểu dáng trang nhã, Gọn gàng, Thích hợp mang đi du lịch, công tác",134964,134964,0,0
TIKI,nha-cua-doi-song,107486345,"Bộ chăn ga giường Lidaco cotton Tici cao cấp (Nhiều mẫu lựa chọn)",239000,339000,100000,29
TIKI,nha-cua-doi-song,159144266,"Cây lau nhà VILEDA Turbo Easy Wring&Clean đầu lau tam giác, xô giặt quay bằng chân",579000,579000,0,0
TIKI,nha-cua-doi-song,54082178,"Túi đựng rác lốc 3 cuộn 1kg - Bịch đựng rác 3 cuộn cỡ đại, trung, tiểu",24000,24000,0,0
TIKI,nha-cua-doi-song,98335248,"Đèn laser ánh sáng laze cảm biến âm thanh - Kết hợp Đèn LED xoay 7 màu dùng trang trí vũ trường, phòng karaoke",349000,349000,0,0
TIKI,nha-cua-doi-song,101870479,"Thanh treo rèm cửa đa năng, không cần khoan tường hay bắt vít, thay đổi vị trí linh hoạt",75000,120000,45000,38
TIKI,nha-cua-doi-song,10814223,"Dụng Cụ Gắp Rác Thông Tắc Đường Ống, Lavabo Tiện Ích (160cm)",32900,32900,0,0
TIKI,nha-cua-doi-song,89059076,"Chảo sâu lòng chống dính đáy từ Tefal Ultimate 28cm, dùng cho mọi loại bếp - Sản xuất tại Pháp - Hàng chính hãng",1699000,1699000,0,0
TIKI,nha-cua-doi-song,70372700,"Đèn Cây Dạng Đứng Đọc Sách Pixar, Đèn Sàn, Đèn Trang Trí Phòng Khách, Đèn Ngủ. Chống Cận Thị Bảo Vệ Mắt. Chiều Cao 1,85m. Hàng Chính Hãng Moontronics",399000,399000,0,0
TIKI,nha-cua-doi-song,72659852,"Kệ Nhà Tắm Dán Tường OENON chất liệu nhựa ABS có thêm thanh nhôm treo khăn - OE08",169000,300000,131000,44
TIKI,dien-thoai-may-tinh-bang,247925719,"Điện thoại Samsung Galaxy A14  (4GB/128GB) - Hàng Chính Hãng - Đã kích hoạt bảo hành điện tử",3672000,3672000,0,0
TIKI,dien-thoai-may-tinh-bang,272394241,"Điện thoại Samsung Galaxy A05s (4Gb/128Gb) - Hàng chính hãng - Đã kích hoạt bảo hành điện tử",3260000,3990000,730000,18
TIKI,dien-thoai-may-tinh-bang,254125720,"Điện thoại oukitel WP22 (Loa to,Chống nước ,chống sốc IP68/IP69K,Ram 13Gb(8GB+5Gb mở rộng),Rom 256Gb,Màn hình 6.58 FHD,tầm nhìn ban đêm,Pin 10.000mAh)- Hàng chính hãng",5990000,5990000,0,0
TIKI,dien-thoai-may-tinh-bang,273398391,"Điện thoại Ulefone Armor 18T (Ram 12Gb,Rom 256Gb,Camera 108MP,camera nhiệt FLIR,Pin 9600 mAh,5G,chống nước,chống va đập)-hàng chính hãng",14990000,14990000,0,0
TIKI,dien-thoai-may-tinh-bang,198868573,"Điện thoại IP Grandstream GRP 2601P hàng chính hãng",1050000,1050000,0,0
TIKI,dien-thoai-may-tinh-bang,217548686,"Máy đọc sách Kindle Scribe – thế hệ đầu tiên có thể đọc và viết, màn hình 10,2” 300PPI, đèn vàng warmlight, bộ nhớ 16-64GB, đồng bộ dữ liệu qua Microsoft Word - hàng nhập khẩu",11390000,11390000,0,0
TIKI,dien-thoai-may-tinh-bang,272397263,"Điện thoại Xiaomi 13T Pro (12GB/512GB) - Hàng chính hãng",16990000,16990000,0,0
TIKI,dien-thoai-may-tinh-bang,215617756,"Điện Thoại Samsung A14 5G 4GB/128GB - Hàng Chính Hãng",3439000,5190000,1751000,34
TIKI,dien-thoai-may-tinh-bang,274164375,"Máy Tính Bảng Samsung Galaxy Tab A9 Plus WIFI 4GB-64GB - Hàng chính hãng",4350000,5990000,1640000,27
TIKI,dien-thoai-may-tinh-bang,270260682,"Điện thoại Gaming Tecno POVA 4 8GB/128GB - Hàng Chính Hãng - MediaTek G99 | 6000mAh - 6.82 inch - Bảo hành 13 Tháng",3499000,4690000,1191000,25
TIKI,dien-thoai-may-tinh-bang,230203067,"Điện thoại OPPO A55s 5G 4GB/64GB - Màn 90hz - Chống nước IP68 - Hàng nhập khẩu - Bản quốc tế",2841000,3699000,858000,23
TIKI,dien-thoai-may-tinh-bang,274424330,"Điện thoại Người Già Good A60 Pro 4G (LTE) Gọi HD Call , Có SOS , Màn lớn - Phím to - Pin trâu - Sạc Type C - Hàng nhập khẩu",469000,490000,21000,4
TIKI,dien-thoai-may-tinh-bang,207914534,"Điện Thoại Nokia 5710 XpressAudio - Hàng Chính Hãng",1599000,1790000,191000,11
TIKI,dien-thoai-may-tinh-bang,214603586,"Điện Thoại Samsung Galaxy A04e (3GB/32GB)- Hàng Chính Hãng",1998000,2690000,692000,26
TIKI,dien-thoai-may-tinh-bang,212926651,"Điện Thoại Samsung Galaxy S20 FE 8GB/256GB - Hàng Chính Hãng - Đã Kích Hoạt Bảo Hành Điện Tử",8625000,8625000,0,0
TIKI,dien-thoai-may-tinh-bang,171685825,"Điện thoại Nokia 105 4G -  chính hãng - Đen",690000,690000,0,0
TIKI,dien-thoai-may-tinh-bang,217505504,"Máy tính bảng Kindle Fire HD8 PLUS 2022 (Fire HD 8 12th) - Màn hình 8inch HD, RAM 3GB, CPU Hexa-core 2.0 GHz, CÀI ĐƯỢC CH PLAY- Hàng nhập khẩu",2483100,2790000,306900,11
TIKI,dien-thoai-may-tinh-bang,271954384,"Điện thoại OPPO A58 6GB/128GB , Sạc nhanh 33W - Hàng Chính Hãng",4311000,4990000,679000,14
TIKI,dien-thoai-may-tinh-bang,272850971,"Điện thoại Libero 5G III - 4/64GB Dimensity 700 ,Màn OLED ,Kháng nước IP57 - Hàng nhập khẩu nhật",2244000,2990000,746000,25
TIKI,dien-thoai-may-tinh-bang,273412211,"Điện thoại Xiaomi Redmi 13C (4+128GB) | 6.74" 90Hz| Media Tek Helio G85| 5000mAh - Hàng chính hãng",2832000,3290000,458000,14
TIKI,dien-thoai-may-tinh-bang,274638659,"Điện Thoại Xiaomi Redmi Note 13 Pro 5G 8GB/128GB Snapdragon 7s Gen 2 , Màn OLED 120Hz, Rom Tiếng việt - Hàng nhập khẩu",5290000,6990000,1700000,24
TIKI,dien-thoai-may-tinh-bang,270714226,"Điện Thoại Itel S23 4GB/128GB | Pin 5000mAh | 6.6 Inch | Camera 50MP | HÀNG CHÍNH HÃNG",2290000,2590000,300000,12
TIKI,dien-thoai-may-tinh-bang,271329051,"Máy tính bảng Kindle Fire MAX 11, màn hình 11 inch, RAM 4GB, CPU Octa-core 2.2Ghz, bộ nhớ 64/128GB - Hàng chính hãng",5300000,5500000,200000,4
TIKI,dien-thoai-may-tinh-bang,195894801,"Masstel izi 26 4G - Chữ to - Loa to - Hàng Chính Hãng",489000,650000,161000,25
TIKI,dien-thoai-may-tinh-bang,274172292,"Điện thoại Samsung Galaxy A05 (4GB/64GB) - Hàng chính hãng",2990000,2990000,0,0
TIKI,dien-thoai-may-tinh-bang,262304313,"Điện thoại Xiaomi Redmi Note 12S (8GB/256GB) - Hàng chính hãng",5019000,6690000,1671000,25
TIKI,dien-thoai-may-tinh-bang,271451188,"Điện thoại Xiaomi Redmi A2| IPS LCD 6.52" HD+| MediaTek Helio G36| 5000 mAh - Hàng chính hãng",1669000,2190000,521000,24
TIKI,dien-thoai-may-tinh-bang,273258825,"Điện thoại Samsung Galaxy A05s (4GB/128GB) - Đã kích hoạt bảo hành điện tử - Hàng chính hãng",3190000,3950000,760000,19
TIKI,dien-thoai-may-tinh-bang,274415640,"Điện Thoại Xiaomi Redmi Note 13 Pro 8GB/128GB - Hàng Chính Hãng",6329000,7290000,961000,13
TIKI,dien-thoai-may-tinh-bang,270814316,"Điện thoại Tecno POVA 5 (8+8)/256GB - MediaTek Helio G99 - Sạc nhanh 45W - 6.8'' FHD+120HZ - Hàng Chính Hãng -  BH 13 Tháng",4529000,5290000,761000,14
TIKI,dien-thoai-may-tinh-bang,270625677,"Điện Thoại Oppo A78 8GB/256GB - Hàng Chính Hãng",5969000,6990000,1021000,15
TIKI,dien-thoai-may-tinh-bang,217645692,"Combo Máy đọc sách All New Kindle Paperwhite 5 (11th Gen) - 16Gb và Bao da - Hàng nhập khẩu",3980000,3980000,0,0
TIKI,dien-thoai-may-tinh-bang,272323566,"Điện Thoại Samsung M34 5G 8GB/128GB - Hàng Chính Hãng",6179000,7990000,1811000,23
TIKI,dien-thoai-may-tinh-bang,252884932,"Tay con điện thoại bàn Panasonic TGCA30- Hàng chính hãng-Chỉ xài được khi đã có máy mẹ",750000,750000,0,0
TIKI,dien-thoai-may-tinh-bang,273990229,"Điện Thoại Xiaomi Redmi Note 13 6GB/128GB - Hàng Chính Hãng",4289000,4890000,601000,12
TIKI,dien-thoai-may-tinh-bang,175845367,"Điện Thoại Samsung Galaxy S20 FE (8GB/256GB) Xanh Thanh Mát - Đã kích hoạt bảo hành điện tử - Hàng Chính Hãng",8625000,8625000,0,0
TIKI,dien-thoai-may-tinh-bang,274186112,"Máy tính bảng Samsung Galaxy Tab A9 Wifi (4GB/64GB) - Hàng chính hãng",3990000,3990000,0,0
TIKI,dien-thoai-may-tinh-bang,198648645,"Điện thoại Xiaomi Redmi A1 (2GB/32GB)",1715000,2190000,475000,22
TIKI,dien-thoai-may-tinh-bang,273357326,"Điện thoại Xiaomi Redmi 13C (6GB/128GB) - Hàng chính hãng",3490000,3490000,0,0
TIKI,dien-thoai-may-tinh-bang,249956458,"Điện thoại Xiaomi Redmi Note 12 (4GB/128GB) - Hàng chính hãng",4990000,4990000,0,0
TIKI,nha-cua-doi-song,116670105,"Dụng cụ di chuyển vật nặng",275000,275000,0,0
TIKI,nha-cua-doi-song,75356087,"Túi Đựng Hộp Cơm Giữ Nhiệt Đa Lớp Cỡ Lớn 34cm*25cm*15cm",60000,60000,0,0
TIKI,nha-cua-doi-song,192909616,"Khăn mặt khô KIPOR dùng 1 lần lau khô, lau ướt - 60 khăn/cuộn, kích thước 20x20cm - Hàng chính hãng",33000,65000,32000,49
TIKI,nha-cua-doi-song,115436781,"Đèn Fairy Light Năng Lượng Mặt Trời Điều Khiển Remote",270000,270000,0,0
TIKI,nha-cua-doi-song,162405563,"Cọ Bồn Cầu Toilet Nhà Vệ Sinh Cao Cấp Kèm Giá Cắm Chổi  Silicon - Hàng Loại 1 - Chính Hãng MINIIN",83000,109000,26000,24
TIKI,nha-cua-doi-song,191604178,"Đèn đốt nến thơm, an toàn, sang trọng, phù hợp mọi không gian",299000,299000,0,0
TIKI,nha-cua-doi-song,44297321,"Đèn Diệt Côn Trùng Đại Sinh DS-D6",585000,585000,0,0
TIKI,nha-cua-doi-song,94888985,"Sọt Đựng Quần Áo Bẩn Túi Đựng Đồ Đa Năng",65000,65000,0,0
TIKI,nha-cua-doi-song,58451521,"Combo 2 Miếng Lau Nhà Parroti Magic MG01 – Kích Thước 32x10 CM - Chất Liệu Microfiber Cao Cấp",55000,109000,54000,50
TIKI,nha-cua-doi-song,173673833,"Ghế Quầy Bar Cao Cấp Phong Cách Hiện Đại Decor Tại Nhà Hoặc Văn Phòng Thư Giãn - Hàng Chính Hãng",699000,935000,236000,25
TIKI,nha-cua-doi-song,117196166,"Pin Maxell R6P super AA hộp 40 viên tiểu",49900,49900,0,0
TIKI,nha-cua-doi-song,9805349,"Ổ cắm Điện Quang ECO ĐQ ESK 5WR 8ECO (8 Lỗ, dây dài 5m, màu trắng đỏ)",165000,223800,58800,26
TIKI,nha-cua-doi-song,191136118,"Bóng Đèn Led Bulb, Led Edison Đui E27 Các Loại - Hàng Chính Hãng NAVIVU",15000,15000,0,0
TIKI,nha-cua-doi-song,116452179,"SÉT 100 TÚI BỌC THỰC PHẨM GẤU HÀNG ĐẸP, DÀY DẶN LOẠI 1.",12798,12798,0,0
TIKI,nha-cua-doi-song,58448882,"Thanh xốp chắn khe cửa đa năng thông minh",20000,20000,0,0
TIKI,nha-cua-doi-song,39318884,"Hộp 60 Viên Pin AA Panasonic ( Pin Tiểu ) Hi Top - Hàng Chính Hãng",174000,179000,5000,3
TIKI,nha-cua-doi-song,31473727,"Combo 100 Túi Lọc Trà Có Dây Rút",24000,24000,0,0
TIKI,nha-cua-doi-song,19557637,"Combo 2 Gối Mây Đan Tổng Hợp Thoáng Mát",66999,66999,0,0
TIKI,nha-cua-doi-song,14338957,"Bộ 3 khăn tắm Nhật siêu mềm siêu thấm - khăn tắm khổ rộng 70x140",28998,28998,0,0
TIKI,nha-cua-doi-song,81988120,"Dây nguồn phích âm SOPOKA N8-N10 dây 2,3m-6,5m",43000,43000,0,0
TIKI,nha-cua-doi-song,109213631,"Chân đặt khung ảnh chân đặt khung hình thờ chữ L xếp lại gọn gàng chắc vững - Nhiều cỡ",52000,52000,0,0
TIKI,nha-cua-doi-song,70536777,"Đèn bắt muỗi, ruồi và các loại côn trùng Đại Sinh DS-D6",585000,585000,0,0
TIKI,nha-cua-doi-song,108243508,"Chảo sâu đáy từ miệng rót Sunhouse SHS20MRD - Dùng trên mọi loại bếp - Hàng chính hãng",272000,400000,128000,32
TIKI,nha-cua-doi-song,58228617,"Cuộn dây cáp làm giàn, có sợi gia cường, nhựa bọc kim loại cực kỳ bền chắc - 1kg",79000,79000,0,0
TIKI,nha-cua-doi-song,230062294,"Bộ dụng cụ tháo vặn ốc vít",148000,148000,0,0
TIKI,nha-cua-doi-song,15428054,"Đệm (Bồ đoàn) ngồi thiền Sunny",175000,175000,0,0
TIKI,nha-cua-doi-song,107713002,"Nam châm siêu trường, siêu mạnh, siêu hút dính dùng để trục vớt đồ vật, nâng vật nặng, treo đồ Dan House - DST15, Hàng chính hãng-D20",92000,92000,0,0
TIKI,nha-cua-doi-song,108025488,"BÀN CHẢI ĐÁNH RĂNG PIH HÀNG VIỆT NAM CAO CẤP SIÊU MỀM",4000,4000,0,0
TIKI,nha-cua-doi-song,51062179,"Keo dán đa năng siêu dính V - 370 gắn tất cả các loại vật liệu ( 50ml)",89000,89000,0,0
TIKI,nha-cua-doi-song,19853979,"Võng lưới số 9.2, căng kim dày BAN MAI, khổ rộng, cán thép 50 (Giao màu ngẫu nhiên)",215000,300000,85000,28
TIKI,nha-cua-doi-song,76468352,"Combo 200 CÁI TÚI LỌC RÁC BỒN RỬA CHÉN - KT: 10x10cm -Hàng chất lượng tốt",27999,27999,0,0
TIKI,nha-cua-doi-song,58415187,"Đèn cảm ứng gắn cầu thang, tủ đồ, toilet, tự động bật/tắt ánh sáng, sạc bằng USB tiện dụng",84000,84000,0,0
TIKI,nha-cua-doi-song,173710560,"Cuộn Khăn Giấy Lau Đa Năng - Chất Liệu Rayon An Toàn - Lau Chén Đĩa , Lau Nhà Bếp..vv - Hàng Chính Hãng",49000,58000,9000,16
TIKI,nha-cua-doi-song,196376951,"Cốc Giữ Nhiệt Nóng Lạnh Vusign Inox 304 Cao Cấp Viền Cao Su Cách Nhiệt Deli Dung Tích 510ml -Phù Hợp Cà Phê Trà Nước Ép Sinh Tố Đá Du Lịch Đi Học Tập Gym",119000,250200,131200,52
TIKI,nha-cua-doi-song,160570940,"Set 10  Khay giấy bạc lót nồi chiên không dầu tái sử dụng được ",11000,11999,999,8
TIKI,nha-cua-doi-song,73755163,"Hộp Đựng Mỹ Phẩm,Đồ Trang Điểm MOHI MT9 ,2 Ngăn Có Kệ Trên Và Nắp Đậy-Hàng Chính Hãng",414000,450000,36000,8
TIKI,nha-cua-doi-song,69543163,"Cây thông tắc bồn cầu, nhà vệ sinh đa năng cao cấp- Dụng cụ thông tắc bồn cầu, cống bằng khi nén áp lực siêu mạnh kèm bơm rời Morado - Hàng Chính Hãng",310000,310000,0,0
TIKI,nha-cua-doi-song,162189829,"Nhang Xanh Phổ Thông 30cm 500g (Đỏ)",163000,165000,2000,1
TIKI,nha-cua-doi-song,73566076,"Cây lau nhà tự vắt thông minh chổi lau nhà 360 độ, kèm 2 miếng lau Kitimop-RED, vắt kiệt nước dễ dàng, cầm nhẹ tay, chổi lau nhà thông minh",145000,145000,0,0
TIKI,nha-cua-doi-song,181936450,"Túi Lọc Trà Túi Lọc Cà Phê Cold Brew Vải Không Dệt Có Dây Rút 8X10Cm, Định Lượng 60G/Túi, Combo 10 Túi",14000,15000,1000,7
TIKI,dien-thoai-may-tinh-bang,274095168,"Điện thoại Xiaomi Redmi A2+ (3GB/64GB) - Hàng Chính Hãng",1890000,2790000,900000,32
TIKI,dien-thoai-may-tinh-bang,197143907,"Điện thoại POCO M5 4GB+64GB/6GB+128GB | Pin 5000mAh | MediaTek Helio G99 | Sạc nhanh 18W - Hàng chính hãng",2599000,3990000,1391000,35
TIKI,dien-thoai-may-tinh-bang,214756058,"Máy đọc sách New Kindle 11th 2022 (16GB) - Hàng chính hãng",2920000,2920000,0,0
TIKI,dien-thoai-may-tinh-bang,270447782,"Điện thoại Nokia C32 (4GB/128GB) - Hàng chính hãng",2090000,3290000,1200000,36
TIKI,dien-thoai-may-tinh-bang,273175604,"Máy đọc sách Boox Note Air 3 C - Hàng Chính Hãng",13980000,15990000,2010000,13
TIKI,dien-thoai-may-tinh-bang,263798932,"Máy đọc sách Boox Page - Hàng Chính Hãng",6700000,7990000,1290000,16
TIKI,dien-thoai-may-tinh-bang,247829297,"Điện thoại Realme C55 (8GB/256GB) - Hàng chính hãng",4470000,5690000,1220000,21
TIKI,dien-thoai-may-tinh-bang,205897182,"Máy tính bảng Xiaomi Redmi Pad (3GB/64GB) - Hàng chính hãng",6290000,6290000,0,0
TIKI,dien-thoai-may-tinh-bang,262706645,"Máy đọc sách kindle 2022 11th - hàng chính hãng",2790000,2790000,0,0
TIKI,dien-thoai-may-tinh-bang,271822725,"Máy Tính Bảng Samsung Galaxy Tab A8 2022 (3GB/32GB) - Hàng Chính Hãng",5856000,5856000,0,0
TIKI,dien-thoai-may-tinh-bang,115830124,"Điện Thoại Xiaomi Redmi 9A (2GB/32GB)- Đã kích hoạt bảo hành điện tử- Hàng Chính Hãng - Sky Blue",2088000,2088000,0,0
TIKI,dien-thoai-may-tinh-bang,58146831,"Điện Thoại Cổ Điển DT150 - Bản Dây Line",2500000,2500000,0,0
TIKI,dien-thoai-may-tinh-bang,191689727,"Điện thoại OPPO CPH2387 - A57 Đen - Hàng Chính Hãng",4284000,4284000,0,0
TIKI,dien-thoai-may-tinh-bang,261962220,"Điện Thoại Samsung Galaxy A24 (6GB/128GB) - Hàng Chính Hãng",5808000,5808000,0,0
TIKI,dien-thoai-may-tinh-bang,176438844,"Điện thoại Xiaomi REDMI 9A (2+32) Xanh lá - Hàng chính hãng (chỉ giao HN và một số khu vực)",2088000,2088000,0,0
TIKI,dien-thoai-may-tinh-bang,192036708,"Điện Thoại OPPO A57 (4GB/128GB) - Hàng Chính Hãng",4632000,4632000,0,0
TIKI,dien-thoai-may-tinh-bang,189658085,"Điện Thoại Oppo A57 (4GB/64GB)",4284000,4284000,0,0
TIKI,dien-thoai-may-tinh-bang,274160702,"Điện thoại Samsung Galaxy S24 Ultra - Hàng chính hãng",28390000,33990000,5600000,16
TIKI,dien-thoai-may-tinh-bang,273947792,"Điện thoại AI Samsung Galaxy S24 Ultra 12GB/256GB, Camera 200MP Zoom 100x, S Pen- Đen- Hàng Chính Hãng",31990000,34490000,2500000,7
TIKI,dien-thoai-may-tinh-bang,249143473,"Điện thoại Samsung Galaxy A34 5G (8GB/128GB) - Hàng chính hãng - ĐÃ KÍCH HOẠT BẢO HÀNH ĐIỆN TỬ",7164000,7164000,0,0
TIKI,dien-thoai-may-tinh-bang,261964853,"Điện thoại ulefone note 16 pro (Ram 16Gb(8+8),rom 128Gb,android 13 , camera 50MP,pin 4.400mAhm, Mở khóa vân tay, Mở khóa bằng khuôn mặt )-hàng chính hãng",5990000,5990000,0,0
TIKI,dien-thoai-may-tinh-bang,272238679,"Điện thoại Samsung Galaxy A05 (4GB/128GB) - Hàng chính hãng",3090000,3090000,0,0
TIKI,dien-thoai-may-tinh-bang,181699053,"Điện thoại Xiaomi Redmi 9A - Hàng chính hãng",2088000,2088000,0,0
TIKI,dien-thoai-may-tinh-bang,248929458,"Điện thoại Samsung Galaxy A34 5G (8GB/128GB) - Hàng chính hãng",7164000,7164000,0,0
TIKI,dien-thoai-may-tinh-bang,242712374,"Điện thoại Samsung Galaxy S23 Ultra 256GB - Hàng chính hãng",31990000,31990000,0,0
TIKI,dien-thoai-may-tinh-bang,195177036,"Máy tính bảng Samsung Galaxy Tab A7 Lite LTE SM-T225 - Hàng Chính Hãng",3587000,3587000,0,0
TIKI,dien-thoai-may-tinh-bang,274638822,"Điện thoại Xiaomi Redmi Note 12 Turbo , Snapdragon 7 Gen 2 , Màn OLED 120Hz , Sạc nhanh 67W , Rom tiếng việt  - Hàng nhập khẩu",5999000,7990000,1991000,25
TIKI,dien-thoai-may-tinh-bang,217505430,"Máy tính bảng Kindle Fire HD8 2022 (Fire HD 8 12th) - Màn hình 8inch HD, RAM 2GB, CPU Hexa-core 2.0 GHz, CÀI ĐƯỢC CH PLAY- Hàng nhập khẩu",2050000,2050000,0,0
TIKI,dien-thoai-may-tinh-bang,249730342,"Điện Thoại Masstel Fami 12 4G LTE - 2 Sim- Pin 1400 mAh - Đọc số bằng giọng nói - Hàng Chính Hãng - Bảo Hành 12 Tháng",630000,630000,0,0
TIKI,dien-thoai-may-tinh-bang,170449059,"Điện Thoại Masstel Izi 20 4G - Loa To, Pin Trâu, 2 Sim 2 Sóng, Hỗ Trợ 4G VoLTE, Đèn Pin Sáng, Giá Rẻ - Hàng Chính Hãng",482000,489000,7000,1
TIKI,dien-thoai-may-tinh-bang,217158529,"Máy tính bảng Samsung Galaxy Tab A7 Lite - Hàng chính hãng",3587000,3587000,0,0
TIKI,dien-thoai-may-tinh-bang,225912504,"Điện Thoại Forme D111 - Hàng Chính Hãng",499000,519000,20000,4
TIKI,dien-thoai-may-tinh-bang,274524050,"Điện thoại Masstel izi T2 4G(LTE), Màn hình 2.4 inch, Đèn pin siêu sáng, Loa to - Hàng chính hãng",489000,550000,61000,11
TIKI,dien-thoai-may-tinh-bang,248005118,"Điện Thoại Samsung Galaxy A34 5G (8GB/128GB) - Hàng Chính Hãng",7164000,7164000,0,0
TIKI,dien-thoai-may-tinh-bang,245770806,"Điện thoại Samsung Galaxy A14 LTE (4GB/128GB) - Hàng chính hãng",3672000,3672000,0,0
TIKI,dien-thoai-may-tinh-bang,273650151,"Điện thoại siêu bền Ulefone Power Armor X11(chống nước,chống va đập , Ram8 GB(4gb+4gb),Rom 32 GB, NFC, Helio G25, WiFi 2.4G/5G, Pin 8150 Mah,)-hàng chính hãng",3290000,3290000,0,0
TIKI,dien-thoai-may-tinh-bang,249730334,"Điện Thoại Masstel Izi 20 4G LTE - 2 sim -Pin 1700 mAh - Loa To - Camera 0.08 MP - Hàng Chính Hãng - Bảo Hành 12 Tháng",512000,512000,0,0
TIKI,dien-thoai-may-tinh-bang,165747145,"Điện thoại Xiaomi Redmi 9A 2GB/32GB - Chip MediaTek Helio G25 8 nhân (12 nm), Màn hình 6.53" HD+, Camera 13MP, Pin 5000 - Hàng Chính Hãng",2148000,2148000,0,0
TIKI,dien-thoai-may-tinh-bang,172920927,"Điện thoại Masstel izi 12 4G - Hàng chính hãng",10000000,10000000,0,0
TIKI,dien-thoai-may-tinh-bang,271284934,"Máy tính bảng Edutab 10.4 & Case da tặng Quà hot Hệ thống quản lý học tập & kiểm soát dành cho Phụ huynh trọn đời - Hàng Chính Hãng",5769000,5769000,0,0
TIKI,nha-cua-doi-song,67262282,"Túi Hút Chân Không Thực Phẩm Hai Mặt Trơn (1kg)",89000,89000,0,0
TIKI,nha-cua-doi-song,205801715,"[HCM - Nhận đặt hàng theo yêu cầu] [Euro Style] Kệ trang trí chân sắt màu Đen, gỗ nguyên tấm chắc chắn. Kệ trang trí đẹp, sang trọng, mang phong cách cổ điển Bắc Âu. Sản phẩm cao cấp, đạt tiêu chuẩn Hàn Quốc",310000,310000,0,0
TIKI,nha-cua-doi-song,54583763,"Đèn bàn học Rạng Đông chính hãng RD RL 38 LED",189000,189000,0,0
TIKI,nha-cua-doi-song,197850024,"Áo Mưa Trong Suốt Dáng Dài Vành Rộng Có Khóa Kéo - Áo Mưa Trong Suốt",145000,145000,0,0
TIKI,nha-cua-doi-song,73617595,"Ống Đựng Đũa Inox 304 Treo Tường Cao Cấp Chính Hãng GAGI Mã GD01 Không Gỉ Sét, Có Thể Để Bàn (2 in 1)",282000,304000,22000,7
TIKI,nha-cua-doi-song,90185010," Tấm gỗ thông mặt rộng 20cm x dày 2cm x dài 1m2 + láng nhẵn mịn 4 mặt",95000,95000,0,0
TIKI,nha-cua-doi-song,115543256,"Bình Giữ Nhiệt Lock&Lock Feather Light LHC4131 (450ml) - Hàng Chính Hãng, Bằng Thép Không Gỉ, Có Lưới Lọc Trà, Trọng Lượng Nhẹ Hoàn Hảo, Giữ Nóng Và Giữ Lạnh Tốt - Tặng Kèm Ống Hút Và Cọ Rửa Ống Hút",319000,578000,259000,45
TIKI,nha-cua-doi-song,56537855,"Bộ dụng cụ sửa chữa đa năng chính hãng HAKAWA HK-850",1490000,2490000,1000000,40
TIKI,nha-cua-doi-song,58990518,"Hộp đựng giấy nhà vệ sinh kèm kệ để đồ thông minh giao màu ngẫu nhiên",68000,68000,0,0
TIKI,nha-cua-doi-song,105812707,"Thảm Lông 1m2 x 1m6, 1m6 x 2m, 1m6 x 2m3 Trải Sàn Sang Trọng, Hiện Đại cho Phòng Khách, Ngủ, Chụp Hình và Các Sự Kiện",149000,149000,0,0
TIKI,nha-cua-doi-song,66948895,"Kệ Dán Tường Nhà Tắm  Hình Vuông Bằng Sắt Đa Năng, Chắc Chắn",16000,18899,2899,15
TIKI,nha-cua-doi-song,50485162,"Công tắc điều khiển từ xa 100m/3000W/220v bật tắt thiết bị điện từ xa-remote học lệnh, công tắc xuyên tường 100m",87000,87000,0,0
TIKI,nha-cua-doi-song,149758085,"Dụng cụ bơm hút rượu xăng dầu chất lỏng bóp tay - ống hút xăng dầu chất lỏng bóp tay, dụng để hút RƯỢU, NƯỚC BỂ CÁ",16000,22997,6997,30
TIKI,nha-cua-doi-song,43605340,"Giấy dán kính một chiều chống nhìn cho cửa - giấy decal dán kính phản quang",77000,77000,0,0
TIKI,nha-cua-doi-song,184858864,"Bình giữ nhiệt inox 304 có lõi lọc pha trà  giữ nhiệt 24h - 48h - YOGA QG ,  dây xách tiện lợi , bình nước giữ nhiệt cute nắp titan , dung tích 650ml- 800ml - 1000ml - 1300ml - 1500ml - Hàng chính hãng",170000,185000,15000,8
TIKI,nha-cua-doi-song,72621937,"Combo 3 tấm gỗ thông mới đẹp dài 50cm, rộng 14cm, dày 1.5cm thích hợp làm kệ treo, kệ ốp tường, trang trí, decorde",55000,55000,0,0
TIKI,nha-cua-doi-song,99211523,"Nồi inox FiveStar Standard 3 đáy sandwich bếp từ nắp kính tặng 1 muỗng canh ( 16cm / 18cm / 20cm / 24cm )",189000,189000,0,0
TIKI,nha-cua-doi-song,157537059,"Thảm chống trơn trượt nhà tắm size 30x30cm tiện dụng, Tấm thảm nhựa lót sàn nhà tắm kháng khuẩn chống trượt",7000,7798,798,10
TIKI,nha-cua-doi-song,73100258,"Kệ Nhà Tắm OENON Cao Cấp lắp đặt Dán Tường, Kệ để đồ phòng tắm cao cấp ",175000,350000,175000,50
TIKI,nha-cua-doi-song,112020406,"Bàn Chải Cọ Lưng Chà Lưng Khi Tắm Cao Cấp Nhật Bản Có Hộp",24999,24999,0,0
TIKI,nha-cua-doi-song,184318192,"Ly Giữ Nhiệt Matte 3 Lớp INOX304 900ml - Tặng Kèm Túi và Ống Hút",239000,239000,0,0
TIKI,nha-cua-doi-song,66672429,"Bộ 2 móc dán tường treo chổi, cây lau nhà, móc treo tường tiện lợi, Giao màu ngẫu nhiên",10500,10500,0,0
TIKI,nha-cua-doi-song,53643460,"Bộ quần áo mưa nam nữ cao cấp",238000,238000,0,0
TIKI,nha-cua-doi-song,4935951,"Kéo cắt cưa cành trên cao thép SK5 Nhật",146000,146000,0,0
TIKI,nha-cua-doi-song,113005302,"Bình Pha Trà, Cafe Thủy Tinh Cao Cáp Có Lõi Lọc Inox Chống Rỉ , Bình Giữ Nhiệt, Chịu Nhiệt 450/550ml Tiện Lợi Phong Cách Mang Đi Học, Đi Làm, Đi Chơi, Trải Nghiệm Uống Trà Hoàn Toàn Mới",373500,373500,0,0
TIKI,nha-cua-doi-song,76070067,"Giá Để Đồ Nhà Tắm OENON, Kệ treo máy sấy tóc chất liệu nhựa ABS cao cấp lắp đặt dán tường - OE039",145000,280000,135000,48
TIKI,nha-cua-doi-song,43808661,"Bồ đoàn (đệm) ngồi thiền vỏ đậu xanh The Yogis'Shop | Đường kính 25cm - 30cm",195000,195000,0,0
TIKI,nha-cua-doi-song,51461576,"Thùng rác đạp chữ nhật Hiro 10L",99000,99000,0,0
TIKI,nha-cua-doi-song,194818369,"Hộp Đựng Trang Sức Mini Cho Nữ, Đựng Vòng Cổ Nhẫn Bông Tai Hộp Đựng Đồ Trang Sức Có Khóa Kéo",76000,76000,0,0
TIKI,nha-cua-doi-song,127743951,"Thanh vắt khăn nhà tắm OENON, Giá treo dép phòng tắm dán tường gạch men chất liệu nhựa ABS - OE48",139000,250000,111000,44
TIKI,nha-cua-doi-song,106280895,"Bộ 6 Ly Thuỷ Tinh Cao Luminarc Islande 290ml - LUISD6293",146000,190000,44000,23
TIKI,nha-cua-doi-song,148873333,"Sạc Thông Minh K65 3.7V 4.2V Sạc Các Loại Pin 14500, 18650 (Sạc tự ngắt, có đèn báo, không kèm pin)",99000,99000,0,0
TIKI,nha-cua-doi-song,76254098,"Ruột Chăn Hè Thu Lidaco Chần Bông Bông Trắng Tinh Khiết Kích Thước 2mx2,2m",209000,280000,71000,25
TIKI,nha-cua-doi-song,174502547,"[CHÍNH HÃNG ABLUE] Ghế Curble Comfy chỉnh dáng ngồi đúng, chống gù. Hàn Quốc (Made in Korea). Màu Đen/ Xám trắng / Đỏ / Xanh dương",616420,629000,12580,2
TIKI,nha-cua-doi-song,75440160,"Móc dán tường chịu lực",700,4000,3300,83
TIKI,nha-cua-doi-song,23096307,"Bình chữa cháy bột ABC MFZL4-4kg",225000,380000,155000,41
TIKI,nha-cua-doi-song,99338532,"LƯỚI VÕNG DUY LỢI MỀM MỊN NẰM ÊM",429000,429000,0,0
TIKI,nha-cua-doi-song,73743740,"Combo 6 tấm lót bàn ăn cao cấp chịu nhiệt, chống thấm, chống trượt giúp trang trí bàn ăn sang trọng như khách sạn 5 sao - Hàng chính hãng",155100,165000,9900,6
TIKI,nha-cua-doi-song,106563599,"Bóng đèn PHILIPS LED Bright E27-Công suất (9W, 11W, 13W, 15W, 17W) ánh sáng vàng, ánh sáng trắng",64600,66600,2000,3
TIKI,nha-cua-doi-song,153027290,"Vỏ Bọc, Áo Trùm Máy Giặt Cửa Ngang ( Vải Dù Siêu Bền Chống Mưa Nắng )",179000,179000,0,0
TIKI,nha-cua-doi-song,131407865,"bàn làm việc chân gấp gọn",405000,450000,45000,10
TIKI,nha-cua-doi-song,49724259,"Nệm Foam Cao Cấp Nest Ru9 15cm - Màu Xám | 2 Lớp Foam Nâng Đỡ | Bao Gồm 6 Kích Thước | 100 Đêm Ngủ Thử",5790000,5790000,0,0
TIKI,nha-cua-doi-song,55502241,"Bộ chăn ga gối cotton LIDACO PL1 - Dưa Hấu Hồng (SP001111)",197000,309000,112000,36
TIKI,nha-cua-doi-song,62734430,"Gói 5 Kg Phân bón đầu trâu hữu cơ vi sinh cao cấp Trichoderma + TE giúp kháng bệnh và tăng trưởng khỏe cho cây trồng",125000,125000,0,0
TIKI,nha-cua-doi-song,162210732,"Bộ Tua Vít Deli Cao Cấp 30 Chi Tiết Đa Năng Vặn Ốc Vít, Bu Lông - Phù Hợp Sửa Chữa Vật Dụng, Xe Máy - DL1130",164000,268000,104000,39
TIKI,nha-cua-doi-song,13561925,"Nồi Hấp 2 Tầng Bằng Inox Lock&Lock LLH1282 (28cm)",791000,1319000,528000,40
TIKI,nha-cua-doi-song,112218352,"Ron Gioăng Chữ T Dán Chặn Che Khe Hở Khung Chân Cửa Chống Gió Bụi Côn Trùng Thoát Hơi Máy Lạnh",13000,13000,0,0
TIKI,nha-cua-doi-song,162767378,"Bình giữ nhiệt có ống hút, quai đeo cho bé dung tích 1L",93099,97999,4900,5
TIKI,nha-cua-doi-song,49098494,"Kệ Góc Nhà Tắm, Kệ Góc Tường, Kệ Nhà Tắm Inox 304 2 tầng Cao Cấp L1",380000,550000,170000,31
TIKI,nha-cua-doi-song,125968227,"Cây lau nhà phun sương thông minh 2 trong 1, đầu xoay 360 độ tiện lợi - Broom Green Pro 02",64986,64986,0,0
TIKI,nha-cua-doi-song,984246,"Kèn Melodion - Melodica Suzuki MX-37 37 Phím",750000,750000,0,0
TIKI,nha-cua-doi-song,200936447,"Bàn Trà Cafe, Bàn Trà Sofa Phong Cách Bắc Âu Thương Hiệu IGEA",176000,176000,0,0
TIKI,nha-cua-doi-song,101627081,"Ô dù cầm tay siêu nhẹ 105g cho phái đẹp, chống tia UV - Nason Feather Umbrella for Lady - Dù gấp gọn bỏ túi Nason",195000,195000,0,0
TIKI,nha-cua-doi-song,54752502,"Bộ 10 khăn lau 2 mặt xuất Nhật Toki - Khăn lau không phai màu không rụng sợi- nhanh khô- Khăn lau bếp, khăn lau kính, lau bát lau tay - HN09421L",9999,9999,0,0
TIKI,nha-cua-doi-song,148877182,"Ruột gối nằm K-Bedding chất liệu Microfiber màu ngẫu nhiên (45x65cm)",320000,400000,80000,20
TIKI,nha-cua-doi-song,117291914,"Bàn Trang Điểm Ngồi Bệt IGA Sắp Xếp Mỹ Phẩm, Son Gọn Gàng - GP143",385000,419000,34000,8
TIKI,nha-cua-doi-song,146289201,"Túi đựng hộp cơm giữ nhiệt, túi đựng đồ ăn trưa văn phòng đa chức năng phù hợp cho cả nam và nữ có tay cầm tiện lợi, chống thấm nước",59000,59000,0,0
TIKI,nha-cua-doi-song,56596052,"KỆ ĐỂ BÀN CHẢI ĐÁNH RĂNG VÀ NHẢ KEM ĐÁNH RĂNG TỰ ĐỘNG KÈM 2 CỐC HÚT TỪ TÍNH",106799,119999,13200,11
TIKI,nha-cua-doi-song,48175833,"KỆ VUÔNG 3 TẦNG GỖ THÔNG- DÀI 35cm x CAO 65cm",159000,250000,91000,36
TIKI,nha-cua-doi-song,207227522,"Giấy nến nấu ăn thương hiệu MyJae",55000,130000,75000,58
TIKI,nha-cua-doi-song,136227595,"Khay đựng remote  - điện thoại dán tường có khe luồn sạc nhỏ gọn tiện lợi  ( Giao màu ngẫu nhiên ) - Hàng chính hãng ",16000,30000,14000,47
TIKI,nha-cua-doi-song,168878527,"SET 10 KHĂN LAU NHÀ BẾP ĐA NĂNG THIẾT KẾ 2 MẶT CHỐNG THẤM DẦU CAO CẤP",28000,28000,0,0
TIKI,nha-cua-doi-song,115986066,"Miếng Dán Chân Bàn Ghế Chống Trượt Hamart Bọc Lót Chân Bàn Ghế Chống Ồn Chống Xước Nền Nhà",18000,29000,11000,38
TIKI,nha-cua-doi-song,794973,"Gối Cao Su Liên Á Oval LAGOV4565 (45 x 65 cm) - Trắng",790000,790000,0,0
TIKI,nha-cua-doi-song,175432384,"Bàn để ủi quần áo cao cấp Nakagami tư thế đứng có giá đỡ chất lượng Công nghệ Nhật Bản - Màu ngẫu nhiên - Hàng chính hãng",399000,399000,0,0
TIKI,nha-cua-doi-song,158816154,"Bộ 5 Tấm Xốp Dán Tường Hoạt Hình Mèo Ú Siêu Dễ Thương Sẵn Keo 70x77",85000,85000,0,0
TIKI,nha-cua-doi-song,72049797,"Set 02 Cuộn Giấy Nến, Giấy Sáp, Giấy Lót Nướng Bánh, Lẩu Nướng, Hấp Bánh, Nướng Thực Ăn Chịu Nhiệt, Chống Dính, Không Thấm Dầu Tiện Dụng 30cm x 5m + Tặng Chổi Phếu Dầu Ăn",45000,45000,0,0
TIKI,nha-cua-doi-song,20680352,"Combo 5 bẫy diệt chuột thông minh",75000,75000,0,0
TIKI,nha-cua-doi-song,108418530,"Kệ bồn cầu 3 tầng để sau bồn cầu, kệ nhà vệ sinh trên toilet, Kệ nhà tắm đa năng tiện lợi",212900,212900,0,0
TIKI,nha-cua-doi-song,154157961,"Màn Dây Không Cửa FUNU Chống Muỗi Cao Cấp, Vải Màn Mềm, Mịn, Mắt Dày Dặn Chống Muỗi Tuyệt Đối - Hàng Chính Hãng",133000,140000,7000,5
TIKI,nha-cua-doi-song,111705115,"Túi đựng dụng cụ 13 inch INGCO HTBG281328",108000,108000,0,0
TIKI,nha-cua-doi-song,35475781,"Bộ củ sen tắm nóng lạnh bồn tắm inox 304 gồm ( củ sen tắm, vòi sen inox, giá đỡ vòi sen inox, dây sen inox)",276000,550000,274000,50
TIKI,nha-cua-doi-song,148026925,"Bình Đựng Nước 2L Dễ Thương Có Vạch Báo Giờ Uống Nước - Hàng Loại 1 - Chính Hãng MINIIN",94000,120000,26000,22
TIKI,nha-cua-doi-song,113833830,"Tấm Lót Bảo Vệ Nệm Cao Cấp PHÚC HẠNH - Lót Chống Thấm",171000,190000,19000,10
TIKI,nha-cua-doi-song,189208326,"Thảm nhà tắm, nhà bếp siêu thấm nước, chống trơn trượt tối giản, hiện đại NAVIVU",99000,99000,0,0
TIKI,nha-cua-doi-song,10115744,"Ổ cắm Điện Quang ECO ĐQ ESK 2BR 6ECO (6 Lỗ, dây dài 2m, màu đen đỏ)",88000,88000,0,0
TIKI,nha-cua-doi-song,58814335,"Xe đẩy hàng 4 bánh SUMIKA T300 - Khung thép, tay cầm gấp mở tiện lợi, tải trọng 300kg",1265000,1950000,685000,35
TIKI,nha-cua-doi-song,195891839,"Đèn LED Mini Móc Khóa - Đèn Pin COB - Đèn Pin Dã Ngoại - Sạc USB Tiện Dụng - Hàng Loại 1 - Chính Hãng MINIIN",51000,59000,8000,14
TIKI,nha-cua-doi-song,85930722,"Ổ cắm điện đa năng Hoco DC15 sạc nhanh PD18W hỗ trợ 4 cổng USB- cổng AC tiện dụng - Hàng chính hãng",338000,500000,162000,32
TIKI,nha-cua-doi-song,66090300,"Bộ 20 dụng cụ kẹp giữ dây điện gọn gàng",12999,12999,0,0
TIKI,nha-cua-doi-song,73639522,"Miếng lau nhà thay thế Cây lau nhà KITIMOP-RED ( 38 x 12cm)",15000,19000,4000,21
TIKI,nha-cua-doi-song,169208973,"Bộ 3 Hộp Nhựa đựng Thực Phẩm Chữ Nhật Hokkaido Inochi 500 -1000 -2000 ML Chịu Nhiệt Giao Màu Ngẫu Nhiên",77000,198000,121000,61
TIKI,nha-cua-doi-song,59163919,"Túi Đựng Chăn Màn (Được Chọn Màu) - Hộp Đựng Quần Áo Khung Sắt Gấp Gọn - Tủ Vải Chăn Màn Tiện Lợi",84000,130000,46000,35
TIKI,nha-cua-doi-song,21326864,"Decal giấy dán tường kệ xương rồng  HM71007",49000,94000,45000,48
TIKI,nha-cua-doi-song,87118108,"Decal dán kính mờ - có keo sẵn khổ rộng 1,2m dài 3m",116000,116000,0,0
TIKI,nha-cua-doi-song,6641279,"Đồng hồ báo thức cảm biến phát sáng trong đêm",78900,78900,0,0
TIKI,nha-cua-doi-song,112321653,"Thảm lau chân nhà tắm siêu thấm cao cấp chất liệu sợi lông cừu dày mềm mại - Hàng nhập khẩu",89000,89000,0,0
TIKI,nha-cua-doi-song,214614554,"Dụng cụ thông tắc bồn cầu, cống bằng khí nén áp lực",201000,210000,9000,4
TIKI,nha-cua-doi-song,43759208,"Đèn Ngủ Quả Cầu Mây - Đèn Ngủ Trang Trí Led Blackinner (đế xếp) Có Điều Chỉnh Độ Sáng - Hàng chính hãng",129000,246000,117000,48
TIKI,nha-cua-doi-song,11858785,"2kg Than không khói, than nướng sạch không khói BBQ",37000,37000,0,0
TIKI,nha-cua-doi-song,136117748,"Táp đầu giường gỗ, tủ đầu giường, tủ để đồ đầu giường",115997,115997,0,0
TIKI,nha-cua-doi-song,158646229,"Dụng cụ cắt gạch thông minh - Dao cắt gạch men và kính đa năng ốp lát gạch nền xây dựng chuẩn công ty",159000,159000,0,0
TIKI,nha-cua-doi-song,188196590,"Nạo, Gọt Vỏ Hoa Củ Quả Inox 304 Cán Gỗ Cao Cấp Jodily StarHome",55000,55000,0,0
TIKI,nha-cua-doi-song,184833497,"Pin sạc 3.7V 18650 Dung Lượng Cao 9800mAh Cho Sạc Dự Phòng, Đèn Pin, Quạt Mini, Đồ Chơi",58000,58000,0,0
TIKI,nha-cua-doi-song,46211207,"Bộ Drap Thun Lạnh Hàn Quốc ( 4 món } màu xám đẳng cấp",158000,158000,0,0
TIKI,nha-cua-doi-song,144532704,"[HÀNG CHÍNH HÃNG]Kéo nhà bếp đa sắc màu dài 25cm, lưỡi kéo dài 14cm bằng thép không gỉ của GGOMi Hàn Quốc GG173",62560,68000,5440,8
TIKI,nha-cua-doi-song,173972990,"Bộ 3 hộp tròn 400ml đựng cơm kèm túi hộp thủy tinh chịu nhiệt cường lực COBA'COOK- XẢ KHO",196000,339000,143000,42
TIKI,nha-cua-doi-song,204768319,"Kìm bấm cúc áo kèm túi 100 cúc",45000,45000,0,0
TIKI,nha-cua-doi-song,104557047,"   Ổ cắm Điện Quang ĐQ ESK 5W.SM750SL (5 lỗ 3 chấu dây 5 mét màu Trắng Đỏ)",202000,202000,0,0
TIKI,nha-cua-doi-song,192120961,"Túi Zip Lụa Nhựa CPE Trong Mờ Có Khóa Kéo Đa Năng",41000,41000,0,0
TIKI,nha-cua-doi-song,186654717,"Combo 4 Miếng Dán Treo Kệ, Rổ, Miếng Treo Dành Cho Hộp Giấy Ecoco",24000,24000,0,0
TIKI,nha-cua-doi-song,186557908,"Túi 100 Dây Rút, Lạt Nhựa (Trắng/Đen) Siêu Bền Để Làm Vườn, Thi Công Tiện Lợi",25000,25000,0,0
TIKI,nha-cua-doi-song,155287344,"Hộp Đựng Trứng Hai Tầng 32 Ô Tiện Dụng Tích Hợp Khay Trượt Đựng Trứng gà Phong Cách Nhật Bản",56000,59999,3999,7
TIKI,nha-cua-doi-song,193723418,"Lót Ly Siêu Thấm Diatom Mud Họa Tiết Gạch Terrazzo",39000,39000,0,0
TIKI,nha-cua-doi-song,171507665,"Đèn bắt muỗi, ruồi và các loại công trùng cao cấp 2022 SeaSy SS69 – Máy bắt muỗi kiêm đèn Led ngủ thông minh, chống lóa mắt, an toàn, dễ dàng sử dụng, thân thiện với môi trường - Hàng chính hãng",299000,437000,138000,32
TIKI,nha-cua-doi-song,69240971,"Ổ khóa cao cấp Toplex, chống cắt tròn, size 40mm",80000,80000,0,0
TIKI,nha-cua-doi-song,1325531,"Combo 10 Cặp Nút Tai Chống Ồn 3M 1100 - Cam, Nút bịt tai chống ồn khi đi máy bay, làm việc trong xưởng in, ôn thi",60000,60000,0,0
TIKI,nha-cua-doi-song,69182343,"Bộ Hộp Cơm Giữ Nhiệt Thủy Tinh Văn Phòng Cao Cấp - Kèm Túi Xách giữ nhiệt hình cá ( mầu sắc ngẫu nhiên)",125000,125000,0,0
TIKI,nha-cua-doi-song,107443884,"Combo 05 Khăn Nhà Bếp Lau Tay - Lau Chén Dĩa Đa Chức Năng",17885,17885,0,0
TIKI,nha-cua-doi-song,183719122,"GỐI CHỮ U CAO SU NON - GỐI KÊ CỔ DU LỊCH, NGỦ TRƯA HOẠ TIẾT SỌC TRƠN",139000,139000,0,0
TIKI,nha-cua-doi-song,11097788,"Ổ cắm công suất lớn Điện Quang ĐQ ESKHP 3RB 5M (3 lỗ, màu đỏ đen, dây dài 5m)",200560,250700,50140,20
TIKI,nha-cua-doi-song,196675194,"Đệm Ngồi 3D Silicon 2 Lớp Tổ Ong Lót Ghế Thoáng Khí Chống Đau Mỏi Lưng Amalife ",107700,107700,0,0
TIKI,nha-cua-doi-song,104269645,"Giấy thơm quần áo Aroma hương sen dùng cho máy giặt khô LG styler",260000,260000,0,0
TIKI,nha-cua-doi-song,71489738,"1000ml - Bình xịt sơn chống thấm trần nhà Bixuan dung tích lớn, sơn chống thấm chống dột tường công nghệ Thụy Sĩ",79000,79000,0,0
TIKI,nha-cua-doi-song,52676101,"Bộ Combo 100 Túi Lọc Rác Siêu Tiên Ích Cho Bồn Rửa Bát",13999,13999,0,0
TIKI,nha-cua-doi-song,32729258,"Gói 1+1 Cây lăn bụi lớn Scotch Brite 3M XA010909407",119000,119000,0,0
TIKI,nha-cua-doi-song,68354418,"LỒNG BÀN GIỮ NHIỆT DELISH GIỮ MÓN ĂN NÓNG HỔI, THƠM NGON",98999,98999,0,0
TIKI,nha-cua-doi-song,141825121,"Chai thông tắc đường ống, lavabo, bồn rửa bát Daichi Nhật Bản",59000,59000,0,0
TIKI,nha-cua-doi-song,16363204,"Cân Điện Tử Cầm Tay Thép Ngang PT153 – Cân Điện Tử Mini Dạng Treo Nhỏ Gọn Tiện Lợi",129000,129000,0,0
TIKI,nha-cua-doi-song,144868820,"Hương nhang Quế Dương Minh nhang sạch 100% thành phần organic nhang thơm tự nhiên không hóa chất nhang cây an toàn",98000,180000,82000,46
TIKI,nha-cua-doi-song,99211918,"Nắp kính cường lực Fivestar dùng cho nồi -chảo-quánh-bộ nồi xửng(16 cm /18cm /20cm/ 22cm/24cm / 26cm / 28cm/ 30cm/ 32cm)",59000,59000,0,0
TIKI,nha-cua-doi-song,50231438,"Bộ 3 túi giặt dây rút túi vải lưới giặt đồ thông minh tiện lợi",69000,69000,0,0
TIKI,nha-cua-doi-song,10914085,"Ổ cắm Điện Quang ĐQ 001A-02-2M (2 lỗ dây 2 mét)",78400,98000,19600,20
TIKI,nha-cua-doi-song,20933262,"Đèn pin sạc Kennedeled  KN-4110 (Giao màu ngẫu nhiên)",65000,65000,0,0
TIKI,nha-cua-doi-song,28324641,"Bình Nước Handle Bottle 1.4L-PP-VN-15 HAP817GRY",43000,83000,40000,48
TIKI,nha-cua-doi-song,190791221,"Hộp 4 pin sạc AA AAA Beston dung lượng cao, sạc lại nhiều lần - Hàng chính hãng",60000,60000,0,0
TIKI,nha-cua-doi-song,169325250,"Combo 4 Đế Kê Chân Tủ Lạnh , Máy Giặt Chống Rung Lắc , Chống Trầy Xướt Nền Nhà PaKaSa - Hàng Việt Nam",39000,78000,39000,50
TIKI,nha-cua-doi-song,106281094,"Bộ 6 ly thủy tinh thấp Luminarc Salto 320ml  -LUSAG2562",281000,281000,0,0
TIKI,nha-cua-doi-song,138822649,"Túi 12/50 viên khăn mặt viên nén NIKKORI NHẬT BẢN",30000,30000,0,0
TIKI,nha-cua-doi-song,50252568,"Thước Đo Khoảng Cách Laser SNDWAY 50m - 70m - 100m - 120m Phạm Vi Đo Tùy Chọn Chuyên Dụng Cho Thiết Kế",350000,350000,0,0
TIKI,nha-cua-doi-song,137181690,"Nhang Xanh Trầm Hương - Cao 20cm Hộp 200 gram",82500,82500,0,0
TIKI,nha-cua-doi-song,116766480,"Túi Đựng Bình Nước Grepaco Giữ Nhiệt Dạng Quai Xách Thể Thao Phù Hợp Bình/Ly Nước Thể Tích 500ml, 750ml, 800ml, 900ml, 1500ml – Vải Bố Canvas",59000,59000,0,0
TIKI,nha-cua-doi-song,372944,"Chảo Nướng Chống Dính Kova Vuông HGS",344000,450000,106000,24
TIKI,nha-cua-doi-song,161683477,"Xô nước nhựa màu xám 10L và 14L",119000,119000,0,0
TIKI,nha-cua-doi-song,120338124,"Băng keo chống thấm x2000 Nhật Bản chống thấm dột, dán tường, dán mái tôn, dán ống nước",21848,21848,0,0
TIKI,nha-cua-doi-song,181223608,"Bộ vòi xịt vệ sinh rửa toilet tăng áp inox 304 Hobby home decor VSR1 dây sen 1.2m",148000,229000,81000,35
TIKI,nha-cua-doi-song,140011015,"Vòi hoa sen Luva VS6, đường kính bát sen 11cm, Bật/Tắt trực tiếp trên vòi sen",248000,248000,0,0
TIKI,nha-cua-doi-song,125685284,"Móc Nhựa Treo Quần Áo Đa Năng Tiết Kiệm Không Gian Tiện Dụng",2000,3500,1500,43
TIKI,nha-cua-doi-song,105731887,"Kìm bấm ghim 3 trong 1 INGCO HSG1405",146000,153000,7000,5
TIKI,nha-cua-doi-song,162116332,"Bộ 6 Tô Thuỷ Tinh Luminarc Diwali Lines 18cm - LUDIQ1672",321000,630000,309000,49
TIKI,nha-cua-doi-song,75881900,"Kệ để lò vi sóng 2 tầng hình chữ Z, khung thép sơn tĩnh điện, mặt bằng gỗ MDF xử lý chống ẩm - Chính hãng",395000,395000,0,0
TIKI,nha-cua-doi-song,22008086,"Bật lửa quẹt gas hình thỏi vàng sáng bóng",64000,64000,0,0
TIKI,nha-cua-doi-song,80934535,"Ổ chia điện, đầu nối thông minh SOPOKA Q3T-Q5T chia 3 chia 5 siêu gọn, siêu tiết kiệm",28000,31200,3200,10
TIKI,nha-cua-doi-song,19522394,"Bộ Đàn Ukulele Concert BWS - Bao, Capo, Móng Gẩy BWS (Bảo trì trọn đời - Uku Gỗ Mahogany trơn cỡ trung 23 inch B-01 - Kèm Sách giáo trình học Ukulele online cơ bản dài 80 trang)",590000,590000,0,0
TIKI,nha-cua-doi-song,191356959,"Dù Chống Tia UV MINI Siêu Gọn 8 Xương Có Hộp Đựng Chống Sốc",220000,220000,0,0
TIKI,nha-cua-doi-song,107409149,"Bộ dây đàn Guitar Classic (Nylon) - D'Addario EJ27N - Normal Tension, Clear Nylon - Hàng chính hãng",252000,252000,0,0
TIKI,nha-cua-doi-song,23587570,"Chai Thủy Tinh Nắp Cài Kín Hơi 1 Lít",29000,29000,0,0
TIKI,nha-cua-doi-song,104273703,"Đèn LED Để Bàn Thông Minh Tự Động 2200mAh Cho Phòng Ngủ, Văn Phòng, Bàn Học, Bảo Vệ Mắt - Hàng Chính Hãng Baseus",531500,531500,0,0
TIKI,nha-cua-doi-song,73330346,"Đèn ngủ cảm ứng gắn giường, cầu thang, toilet, tủ đồ, tự động bật/tắt ánh sáng ban đêm, sạc bằng USB - Ánh sáng trắng dài 10cm",84000,84000,0,0
TIKI,nha-cua-doi-song,67811815,"Đèn pin mini 3in1 chiếu sáng, laser, tia cực tím sạc điện",87500,87500,0,0
TIKI,nha-cua-doi-song,754592,"Ổ Cắm Điện 3D + 3S Dây 3m x 2 Lioa 3D3S32 - Đen",98000,98000,0,0
TIKI,nha-cua-doi-song,87159755,"Cây Lăn Bụi Đa Năng ( Lông Động Vật, Sợi Vải, Đồ Da, Chăn Nệm, Ghế Salon...)",12000,12000,0,0
TIKI,nha-cua-doi-song,58811344,"CHẾ PHẨM VI SINH EMZEO - PHÂN GIẢI, KHỬ MÙI HÔI PHẾ THẢI HỮU CƠ - GÓI 200GR ",31000,31000,0,0
TIKI,nha-cua-doi-song,41457535,"Khoá tủ vân tay JMX 3892",375000,490000,115000,23
TIKI,nha-cua-doi-song,180026928,"Đồng Hồ Báo Thức Để Bàn Phong Cách Vintage, 2 Quả Chuông To - Hàng Chính Hãng",125000,125000,0,0
TIKI,nha-cua-doi-song,53926277,"Combo 6 cuộn Túi đựng rác gia đình, Bao đựng rác văn phòng tiện lợi màu đen size trung 55x65",59000,59000,0,0
TIKI,nha-cua-doi-song,10329092,"Dao trổ kèm 5 lưỡi phụ - dao trổ",67000,67000,0,0
TIKI,nha-cua-doi-song,20223034,"Decal dán tường kệ hoa trang trí SK6093DS",80000,80000,0,0
TIKI,nha-cua-doi-song,39317473,"Hộp 60 Viên Pin AAA Panasonic NEO ( Pin Đũa ) - Hàng Chính Hãng",198000,198000,0,0
TIKI,nha-cua-doi-song,144492733,"Nệm cói/đệm ngồi bệt cói ONGTRE cao cấp dành cho nhà hàng, quán cafe, phòng khách, đệm yoga",69000,115000,46000,40
TIKI,nha-cua-doi-song,137907353,"Giá treo ô dù dán tường, móc treo ô dù, móc treo chổi siêu chắc, tiện lợi, siêu dính, chịu lực tốt",15000,15000,0,0
TIKI,nha-cua-doi-song,155268009,"Găng tay y tế không bột, bao tay cao su hộp 100 cái",58000,58000,0,0
TIKI,nha-cua-doi-song,138456818,"Màng bọc thực phẩm Laspalm chính hãng MBTP00006163",105000,174900,69900,40
TIKI,nha-cua-doi-song,138615688,"Lò xo uốn ống điện",40000,40000,0,0
TIKI,nha-cua-doi-song,39286757,"Túi lưới giặt giày quần áo tổ ong có khoá kéo cao cấp dùng cho máy giặt nhanh chóng và tiện lợi",48000,85000,37000,44
TIKI,nha-cua-doi-song,162122783,"Bộ 6 Đĩa Sâu Thuỷ Tinh Luminarc Diwali Lines 20cm - LUDIQ1662",312000,470000,158000,34
TIKI,nha-cua-doi-song,197676301,"Tủ nhựa TABI Vân gỗ cao cấp, chất lượng, giá rẻ, nhiều mẫu mã chính hãng Nhựa Duy Tân",1079000,1300000,221000,17
TIKI,nha-cua-doi-song,16341786,"Bình Giữ Nhiệt Lock&Lock LHC1439 Dung Tích 1000ml",299000,569000,270000,47
TIKI,nha-cua-doi-song,50819884,"Cuộn Màng Bọc Hàng, Màng Co, Màng Chít, Màng PE bảo vệ hàng hóa 2.4kg x 50cm ",90000,90000,0,0
TIKI,nha-cua-doi-song,59518200,"Nệm tiện ích Everon  201 ( Màu ngẫu nhiên )",350000,350000,0,0
TIKI,nha-cua-doi-song,179505447,"Bình Nước Giữ Nhiệt Cute 800ml Chất Liệu Inox 304 Giữ Nhiệt Không Gỉ Nóng Lạnh 24 Giờ Kèm Ống Hút Và Sticker - Hàng Loại 1 - Chính Hãng MINIIN",114000,131000,17000,13
TIKI,nha-cua-doi-song,14632647,"Đệm ngồi 3D thoáng khí chống đau mỏi Egg sister",165000,165000,0,0
TIKI,nha-cua-doi-song,73571741,"Bàn Trà Sofa Hiện Đại Thương Hiệu IGEA",304000,320000,16000,5
TIKI,nha-cua-doi-song,59359188,"PHÍCH  CẮM CHUYỂN ĐỔI 3 CHẤU SANG 2 CHẤU VÀ CHIA 2 Ổ TOSHINO PS18-A2  2000W - HÀNG CHÍNH HÃNG",49000,49000,0,0
TIKI,nha-cua-doi-song,99213205,"Nồi inox Fivestar 3 đáy bếp từ nắp inox (16cm ) ,tặng 1 muỗng canh",189000,189000,0,0
TIKI,nha-cua-doi-song,150851260," Miếng Xốp Dán Tường Giả Gạch 3D- Trang Trí Nhà Cửa, Phòng Học, Nhà Hàng , Chống Thấm, Ẩm Mốc -Lớp Dán Siêu Chắc - Hàng Chính Hãng MINIIN(70 x 77cm)",13000,15000,2000,13
TIKI,nha-cua-doi-song,160306737,"Nắp Bồn Cầu,Nắp Bồn Cầu Rơi Êm Bệt Rời Viglacera,Dococera,HC,Thiên Thanh,American Standard,...",230000,450000,220000,49
TIKI,nha-cua-doi-song,107711424,"ÁO MƯA EVA  MÀU XANH- LOẠI TỐT - XUẤT NHẬT/ HÀN/ CHÂU ÂU / ÁO MƯA BÍT - phù hợp cả NAM & NỮ (không mùi, an toàn cho sức khỏe) ",137214,198198,60984,31
TIKI,nha-cua-doi-song,68788653,"Tủ Quần Áo miDoctor Cải Tiến Thế Hệ Mới, Tủ Vải Quần Áo 3 Buồng 8 Ngăn 1,7m Cao Cấp",389000,550000,161000,29
TIKI,nha-cua-doi-song,58357816,"Cây lau nhà inox 360 độ thái lan G7 + tặng kèm bông lau nhà ( màu ngẫu nhiên ) cao cấp",64900,64900,0,0
TIKI,nha-cua-doi-song,79445924,"Nến thơm hoa khô thiên nhiên, sáp nến thơm phòng MO hi cao cấp - Hàng chính hãng, giao màu, hình, họa tiết hộp ngẫu nhiên",41400,45000,3600,8
TIKI,nha-cua-doi-song,51737688,"Túi Đựng Chăn Màn - Hộp Đựng Quần Áo Khung Sắt Gấp Gọn Amalife - Màu Ngẫu Nhiên",88000,130000,42000,32
TIKI,nha-cua-doi-song,101858930,"Áo Mưa Khoá Kéo, Áo Mưa Măng Tô Vải Dù Cao Cấp, Hàng Việt Nam, Khổ To Rộng, Chống Thấm Hiệu Quả, Phù Hợp Nam Và Nữ, Có Túi Đựng, Có Lựa Chọn Màu Sắc",140000,140000,0,0
TIKI,nha-cua-doi-song,52316356,"Bộ máy khoan pin RAKUTEN 66V  khoan tường, khoan sắt, khoan bê tông máy 2 pin, đảo chiều và mũi khoan",558600,588000,29400,5
TIKI,nha-cua-doi-song,3747855,"Tủ vải đựng quần áo 3 buồng 8 ngăn tiện dụng",207000,207000,0,0
TIKI,nha-cua-doi-song,179759048,"Bộ 10 Móc Dán Tường Gạch Men INOX304, Móc Dán Tường Keo 3M Treo Đồ Dùng Gia Đình - M08",69000,120000,51000,43
TIKI,nha-cua-doi-song,25421013,"Bộ Nồi Inox 3 Đáy Sunhouse SH335(16cm, 20cm, 24cm ) - Dùng trên mọi loại bếp - Hàng chính hãng",356000,620000,264000,43
TIKI,nha-cua-doi-song,36461827,"bàn làm việc chân sắt - vàng nhạt",177000,177000,0,0
TIKI,nha-cua-doi-song,184614872,"Chảo Đá Siêu Bền SUNHOUSE SBD20",196000,300000,104000,35
TIKI,nha-cua-doi-song,176534657,"Topper nệm chất liệu microfiber, dày 5cm Giao màu ngẫu nhiên",1092000,1400000,308000,22
TIKI,nha-cua-doi-song,147100752,"Dụng cụ bơm hút rượu, xăng dầu chất lỏng bóp tay , hút chất lỏng bóp tay",16000,22996,6996,30
TIKI,nha-cua-doi-song,109310666,"Kệ để kinh phật hoa sen bằng gỗ MDF phủ Melamine 2 mặt/ Bàn tụng kinh/ bàn đọc sách",380000,380000,0,0
TIKI,nha-cua-doi-song,116274323,"Kệ sách treo tường hình chữ Z xinh xắn! dài 90cm",229000,239000,10000,4
TIKI,nha-cua-doi-song,10647257,"Ổ cắm Điện Quang ĐQ ESK 2B.SM750SL (5 lỗ 3 chấu dây 2 mét màu Đen Trắng Đỏ)",190960,238700,47740,20
TIKI,nha-cua-doi-song,52027172,"Phích cắm thông minh Điện Quang Apollo ĐQ SP1.1 01 Wifi (Kiểu 1 lỗ, sử dụng wifi)",201876,237501,35625,15
TIKI,nha-cua-doi-song,59602156,"Combo Bộ 2 gối nằm + 1 gối ôm - Gòn bông nhân tạo an toàn sức khỏe - Có khóa kéo dễ dàng thêm bớt gòn bên trong - Êm ái, mềm mịn",220000,220000,0,0
TIKI,nha-cua-doi-song,24163146,"Kệ đựng bàn chải dán tường gạch men 2 ngăn Hobby Home Decor CD3M - Inox 304 không rỉ kèm keo dán gạch men",145000,199000,54000,27
TIKI,nha-cua-doi-song,186256010,"Vỏ gối nằm cotton tici Lidaco kích thước tiêu chuẩn (1 chiếc)",29000,45000,16000,36
TIKI,nha-cua-doi-song,162173209,"100G NaOH Tinh Khiết Dạng Hạt - Dùng Làm Xà Phòng - Trong Phòng Thí Nghiệm",18000,18000,0,0
TIKI,nha-cua-doi-song,100867528,"Hộp Thủy Tinh Kháng Khuẩn Tròn Nikko 400ml-620ml-950ml Chính Hãng Inochi",40000,40000,0,0
TIKI,nha-cua-doi-song,200782721,"Hộp vải đựng quần áo chia ngăn, khay đựng đồ lót, tất vớ,có nắp gấp gọn tiện lợi",29000,37000,8000,22
TIKI,nha-cua-doi-song,69754010,"Keo dán Đa Năng Nhật Bản Dán thủy tinh, bê tông, gạch, đá, gỗ , nhựa cứng ULTRA SU HARD (CỨNG) 10ml #05140, chống thấm nước  (Hàng nội địa Nhật)",110880,138600,27720,20
TIKI,nha-cua-doi-song,59358608,"Combo 2 Ron Thanh Nẹp Xốp Chèn Chắn Cửa Chống Bụi Côn Trùng Dài 95cm Legaxi",40000,40000,0,0
TIKI,nha-cua-doi-song,52774383,"Đèn LED Đom Đóm Chipsbling Dùng Pin Năng Lượng Mặt Trời",149000,149000,0,0
TIKI,nha-cua-doi-song,177068285,"Trầu Bà Lá Xẻ - trầu bà nam mỹ - cây cảnh để trong nhà + tặng phân bón cho cây mau lớn",65000,110000,45000,41
TIKI,nha-cua-doi-song,154835137,"Thìa, Muỗng Mạ Inox 304 Mạ Vàng Jodily Cao Cấp - Thìa Vàng Bắc Âu KT: 20.5x4 cm ",45000,45000,0,0
TIKI,nha-cua-doi-song,152446878,"Cây mai xanh thái lan - Cây cảnh sân vườn trồng cổng rào ban công",55000,70000,15000,21
TIKI,nha-cua-doi-song,103757642,"Chuông Báo Khách Cửa Hàng, Báo Động Chống Trộm Cảm Biến Chuyển Động Hồng Ngoại Không Dây CTFAST 02 - Lời Chào Báo Khách Ghé Thăm, Dọa Trộm Xâm Nhập",375000,409000,34000,8
TIKI,nha-cua-doi-song,146845870,"Đèn Bàn Học Chống Cận Thị, Đèn Đọc Sách, Đèn Làm Việc Bảo Vệ Mắt - Đèn Bàn Học LED USB Di Động Cao Cấp Có Thể Gập Hai Chỗ – 03 Chế Độ Ánh Sáng Vàng Bảo Vệ Mắt Chống Cận, đèn học để bàn, đèn học cho học sinh sinh viên, trang trí - Hàng Chính Hãng dododios",198000,198000,0,0
TIKI,nha-cua-doi-song,41227454,"Combo 30 móc treo quần áo Prota",63000,75000,12000,16
TIKI,nha-cua-doi-song,111631559,"Hộp đựng đồ kiêm ghế ngồi đa năng - Ghế sofa đựng đồ gấp gọn cứng cáp tiện lợi có chọn size, hàng chính hãng miDoctor",295000,500000,205000,41
TIKI,nha-cua-doi-song,137942665,"Móc treo dính tường siêu tiện lợi",950,1000,50,5
TIKI,nha-cua-doi-song,108998775,"Kệ Úp Chén Inox Đa Năng 2 Tầng Hình Chữ S PEAFLO",219000,290000,71000,24
TIKI,nha-cua-doi-song,789439,"Găng Tay Chống Cắt Cấp Độ 5 3M (Size M) - Xám",125000,125000,0,0
TIKI,nha-cua-doi-song,31023051,"Ghế xếp Inox lùn",124900,124900,0,0
TIKI,nha-cua-doi-song,15666493,"Bộ 6 thìa Inox 304 ngắn bún phở DandiHome",179500,210000,30500,15
TIKI,nha-cua-doi-song,97933907," Máy Xay Tỏi Ớt Cầm Tay Mini Sạc Điện 250ml Tiện Lợi (Sạc Điện)",75990,75990,0,0
TIKI,nha-cua-doi-song,90023970,"10 Tấm Keo Bẫy Chuột Siêu Dính - Để lâu, tái sử dụng nhiều lần",130000,130000,0,0
TIKI,nha-cua-doi-song,192178657,"Bộ Chăn Gối Văn Phòng - Gối Mền 3in1 Chó Shiba, Voi, Thỏ Ngọc, Chuột",225000,225000,0,0
TIKI,nha-cua-doi-song,85029113,"Set 5 Phích cắm công suất lớn cao cấp Điện Quang ĐQ EPR HP 2PN (Màu ngẫu nhiên)",83045,97700,14655,15
TIKI,nha-cua-doi-song,167042076,"Bộ 6 Ly Rượu Shot Thủy Tinh cao cấp 34ML, Ly uống Rượu đế dày wine glass",29000,39100,10100,26
TIKI,nha-cua-doi-song,70825693,"Pin Cr2025 Energizer 3V vỉ 1 viên",30000,30000,0,0
TIKI,nha-cua-doi-song,52385659,"Combo 10 Móc Dán Tường Inox 304 treo đồ gia đình siêu dính",41990,41990,0,0
TIKI,nha-cua-doi-song,153843550," Dụng Cụ Hút Rượu, Hút Chất Lỏng Xăng Dầu Bóp Tay Thủ Công",16000,44000,28000,64
TIKI,nha-cua-doi-song,101948734,"Hạt Giống Cải Bẹ Mào Gà 20 Gam",9900,9900,0,0
TIKI,nha-cua-doi-song,20557823,"Bộ dây 20 kẹp ảnh có đèn led trang trí sinh nhât, nhà cửa, sự kiện chụp ảnh MT-203 (dùng pin AA)",68000,68000,0,0
TIKI,nha-cua-doi-song,16211222,"Combo Thiếc Hàn Solder-OK 0.8mm-100g và Nhựa Thông Hộp Loại Tốt",34500,34500,0,0
TIKI,nha-cua-doi-song,169534430,"Cưa Cây Cưa Gỗ Cưa Xếp Lưỡi Thép Hợp Kim SK5 - Cưa Cầm Tay Gấp Gọn",60000,60000,0,0
TIKI,nha-cua-doi-song,120470954,"Bình Nước Thuỷ Tinh Luminarc Flame 1.3L -  LUBIJ8535 ",136000,136000,0,0
TIKI,nha-cua-doi-song,126865171,"Vỏ gối ôm lụa cao cấp A 35 x 100 cm - mát mẻ, mềm mịn, không kích ứng da",100000,150000,50000,33
TIKI,nha-cua-doi-song,7625922,"Đồng hồ báo thức inox kim trôi",109000,109000,0,0
TIKI,nha-cua-doi-song,55670724,"Combo 2 Chốt Chặn Cửa - Miếng Cao Su Chặn Cửa",24000,24000,0,0
TIKI,nha-cua-doi-song,72487651,"BÀN ĐỂ ỦI DẠNG NGỒI 30x80cm CHÂN XẾP NGUYỄN TRƯỜNG THẮNG",185000,185000,0,0
TIKI,nha-cua-doi-song,24888275,"Nhang Nụ Trầm Hương tự nhiên khói chảy ngược - Trầm Hương 12 năm - Thơm dịu nhẹ, không cay mắt, không kích mũi - Hộp 40 nụ - Thiên Mộc Hương",290000,350000,60000,17
TIKI,nha-cua-doi-song,77747671,"Miếng lau nhà thay thế Cây lau nhà KITIMOP-XPRO, WHITE ( 42 x 12cm)",19000,19000,0,0
TIKI,nha-cua-doi-song,138911086,"Bình nước bình giữ nhiệt, bình giữ nhiệt cute có ống hút, inox 304 không rỉ an toàn",78370,78370,0,0
TIKI,nha-cua-doi-song,372846,"Bình Ngâm Rượu, Nước Hoa Quả Kova BNR1.8 1.8 Lít",137000,179000,42000,23
TIKI,nha-cua-doi-song,196889763,"Bình tưới cây 5 lít Monrovia, phun hai chế độ, áp suất lớn tiêu chuẩn Châu Âu",399000,399000,0,0
TIKI,nha-cua-doi-song,10685676,"Ghế văn phòng chân xoay E0 - Normaline TH01",335750,395000,59250,15
TIKI,nha-cua-doi-song,149658407,"Khăn treo lau tay san hô tròn nhà bếp bông lau khô dày thấm nước nhanh",22900,22900,0,0
TIKI,nha-cua-doi-song,176750496,"VUA Nấm Bệnh Thán thư thối nhũn vàng lá Đốm lá ghẻ sẹo phấn trắng rỉ sắt sương mai gói 26g",20000,20000,0,0
TIKI,nha-cua-doi-song,153665555,"Hũ Đựng Cà Phê Có Van Hút Chân Không",239000,239000,0,0
TIKI,nha-cua-doi-song,26062785,"Combo 50 Đinh 3 Chân Treo Ảnh Không Cần Khoan Milliken",39000,39000,0,0
TIKI,nha-cua-doi-song,130369125,"Cây Treo Quần Áo, Túi Xách, Mũ Thông Minh Phong Cách VINTAG Gọn Gàng Tiết Kiệm Diện Tích Nhà Cửa- Hàng Chính Hãng MINIIN",149000,219000,70000,32
TIKI,nha-cua-doi-song,70191598,"Combo 8 Viên Pin AA đỏ Chính Hãng Maxell",25000,25000,0,0
TIKI,nha-cua-doi-song,112606822,"Bộ 8 Móc treo Quần áo gấp gọn tiện dụng Có 2 nấc cho trẻ em và người lớn Mang theo du lịch - Nhựa",55000,55000,0,0
TIKI,nha-cua-doi-song,186351890,"Đệm ngồi chống trĩ, đau xương cụt Ema cho dân văn phòng, lái xe, phụ nữ sau sinh",325000,650000,325000,50
TIKI,nha-cua-doi-song,77990689,"[MẪU MỚI 2020] Bộ công tắc điều khiển từ xa rf 100m/30A/220V xuyên tường công suất lớn",83000,83000,0,0
TIKI,nha-cua-doi-song,187184291,"Băng Dính Silicol 2 Mặt Siêu Dính Siêu Tiện Lợi Ứng Dụng Vào Mọi Công Việc Vị Trí Trong Gia Đình",35000,35000,0,0
TIKI,nha-cua-doi-song,184518592,"Gối Kê Cổ Chữ U Giúp Giảm Đau Cổ, Biến Hình 2 Trong 1, Phù Hợp Cho Văn Phòng Và Du Lịch",290000,290000,0,0
TIKI,nha-cua-doi-song,43878049,"Ổ cắm chia 3 ngả đa năng MPE TA4 - Tích hợp 2 cổng USB sạc nhanh 2.4A",195000,195000,0,0
TIKI,nha-cua-doi-song,171196878,"Bộ Nam Châm Vuông 90 Độ KUNBE Gắn Dán Cửa Tủ, Lực Hút Mạnh, Chắc Chắn",24000,24000,0,0
TIKI,nha-cua-doi-song,46235645,"Bộ nội quy tiêu lệnh Phòng cháy chữa cháy chất liệu tôn cao cấp",125000,175000,50000,29
TIKI,nha-cua-doi-song,117717315,"Tủ điện nhựa ngoài trời - Hộp kỹ thuật LiOA JL-00C & JL-00C",100000,100000,0,0
TIKI,nha-cua-doi-song,103711453,"Máy Pha Trà Bear SUBE011",1190000,1190000,0,0
TIKI,nha-cua-doi-song,109351669,"Kệ Sách Đứng Để Sàn FIVO Mã FB70 Chất Liệu Gỗ MDF Chống Thấm Bề Mặt Cực Tốt, Chia Ngăn Tiện Lợi, Kiểu Dáng Hiện Đại (Kích thước 80x24x178cm)",1319000,1867000,548000,29
TIKI,nha-cua-doi-song,186816987,"Dụng Cụ Mài Dao, Kéo 3 Rãnh Inox Jodily Đa Năng Dễ Sử Dụng",135000,135000,0,0
TIKI,nha-cua-doi-song,68391408,"Combo 10 ĐÈN LED CHỚP 7 MÀU DÙNG PIN 3AAA SỬ DỤNG CHO ĐÈN LỒNG, ĐÈN TRUNG THU VÀ CÁC ĐỒ CHƠI TRẺ EM.",99000,99000,0,0
TIKI,nha-cua-doi-song,144505446,"[Gói 4 miếng] Cước Rửa Chén Siêu Mạnh Scotch Brite - Cọ rửa mọi vết bẩn cứng đầu, an toàn cho vỉ nướng, nồi inox, gang, thép",46000,51000,5000,10
TIKI,nha-cua-doi-song,33337588,"Áo Bọc Nệm Hai Mặt Có Khóa Đủ Kích Thước 10cm - Màu Ngẫu Nhiên",85000,85000,0,0
TIKI,nha-cua-doi-song,139815701,"Sào phơi đôi inox cao cấp có 2 thanh để đồ",180000,180000,0,0
TIKI,nha-cua-doi-song,162743067,"Bộ 1 Viên Pin Cell Panasonic NCR18650GA 3500 mAh , Pin 18650 dung lượng cao , Xả cao",129000,150000,21000,14
TIKI,nha-cua-doi-song,17491418,"Đầu vòi xịt vệ sinh (toilet) inox SUS 304",65000,70000,5000,7
TIKI,nha-cua-doi-song,192833044,"Ghế Gỗ Kê Chân Văn Phòng Thoải Mái, Ghế Gác Chân Dễ Chịu",118750,125000,6250,5
TIKI,nha-cua-doi-song,176728501,"Bàn trang điểm gương viền LED phong cách Nordic thương hiệu IGA- GP196",608000,660000,52000,8
TIKI,nha-cua-doi-song,135391727,"Lô 4 cuộn túi rác tiện dụng Inochi Soji (10L-25L-50L)",38000,59000,21000,36
TIKI,nha-cua-doi-song,108430436,"Nhiệt ẩm kế Tanaka Th337 - Đo nhiệt độ, độ ẩm trong nhà và ngoài trời",119000,165000,46000,28
TIKI,nha-cua-doi-song,164433381,"Bộ Đèn PHILIPS LED Âm Trần MESON IO Thế Hệ Mới - 5W 7W 9W 13W",100100,103200,3100,3
TIKI,nha-cua-doi-song,135450957,"Set 10 Móc Treo Dán Tường Mini, Móc Treo Đồ Nhỏ Gắn Hình Cute - Giao Màu Hình Ngẫu Nhiên",22000,22000,0,0
TIKI,nha-cua-doi-song,24189275,"Cân điện tử mini nhà bếp ",64600,68000,3400,5
TIKI,nha-cua-doi-song,101587122,"Áo Mưa, Áo Mưa Trong Suốt Chống Thấm Thời Trang Hàn Quốc",38000,38000,0,0
TIKI,nha-cua-doi-song,52254939,"Dụng cụ gọt nạo vỏ trái cây, củ quả inox",9890,9890,0,0
TIKI,nha-cua-doi-song,185409647,"Hũ Nhựa Pet Vuông Kín Hơi, Lọ, Hộp Nhựa Vuông Kín Hơi Đựng Sữa, Bột, Trà, Cà Phê, Thực Phẩm Đồ Khô Chống Ẩm, Côn Trùng",50000,50000,0,0
TIKI,nha-cua-doi-song,79323086,"Đèn Ngủ kiêm Đèn Chiếu Ngàn Sao 6 phong cách xoay tự động, tích hợp phát nhạc bằng Bluetooth nhiều hiệu ứng, sạc bằng USB",380000,380000,0,0
TIKI,nha-cua-doi-song,115334461,"Combo 2 Lõi cây lăn bụi ,Lông Động Vật, Sợi Vải, Đồ Da, Chăn Nệm, Ghế Salon",10000,16000,6000,38
TIKI,nha-cua-doi-song,136605740,"Áo Bọc Bàn Để Ủi Nguyễn Trường Thắng - Ironing Board Cover",70000,70000,0,0
TIKI,nha-cua-doi-song,76403675,"(Chống Cắt) Ổ Khóa Ngăn Ngừa Trộm 60mm KhoNCC-Padlock Hàng Chính Hãng Cho Gia Đình - Kho Xưởng Cực Kỳ An Toàn - KPD-Padlock-6PCC (Bạc, Đồng)",189000,248000,59000,24
TIKI,nha-cua-doi-song,146249285,"Cốc Gấu Cute Đựng Bàn Chải Kem Đánh Răng Dán Tường Đa Năng",4500,4500,0,0
TIKI,nha-cua-doi-song,59471210,"Bộ 3 Túi Đựng Chăn Màn Khung Sắt Gấp Gọn miDoctor (CÓ CHỌN MÀU)",249000,249000,0,0
TIKI,nha-cua-doi-song,105310094,"Cell Pin 18650 LS Xanh  2000mAh  - Pin LS Sử Dụng Cho Máy Khoan,Pin Sạc Dự Phòng",25000,25000,0,0
TIKI,nha-cua-doi-song,68447740,"Bộ cấp nước bồn cầu - Bộ cấp nước két nước vệ sinh sử dụng phao cơ thông minh",155000,180000,25000,14
TIKI,nha-cua-doi-song,191911126,"Kệ giày thông minh, tủ giày gỗ đa năng 4 tầng cánh tủ trắng, hai bên kèm kệ phong cách hiện đại 78x30x78 TAGO ND22",270749,284999,14250,5
TIKI,nha-cua-doi-song,193615690,"Bàn Làm Việc Học Tập Thông Minh Gấp Gọn Tùy Chỉnh Độ Cao Mặt Bàn Nghiêng 90 Độ Thích Hợp Nhiều Không Gian - Hàng Chính Hãng",620000,899000,279000,31
TIKI,nha-cua-doi-song,83927715,"Bịt Mắt Ngủ Che Mắt Ngủ Có Túi Gel Massage - Giảm Thâm Quầng Mắt - Mẫu Hoạt Hình Mới - XÁM",35000,35000,0,0
TIKI,nha-cua-doi-song,2395003,"Khăn lau đa năng cao cấp 3M xanh dương 36cm",39000,39000,0,0
TIKI,nha-cua-doi-song,130829751,"Combo 12 Hũ Thủy Tinh PEAFLO Làm Caramen, Sữa Chua, Đựng Gia Vị Đa Năng - Giao Ngẫu Nhiên",62000,85000,23000,27
TIKI,nha-cua-doi-song,192523772,"Tấm Lót Tủ Lạnh, Tủ Bếp, Tủ Quần Áo Nhựa EVA Dễ Dàng Vệ Sinh (Đủ màu, đủ size)",49000,49000,0,0
TIKI,nha-cua-doi-song,128792084,"Bình xịt chống thấm đa năng chai xịt ngăn dột nước trần sàn mái tôn, chân tường nhà (màu trắng) - Hàng Chất Lượng",35150,37000,1850,5
TIKI,nha-cua-doi-song,71518871,"Nồi Decor Lock&Lock LDE1244IH Hai Tay Cầm (24cm) - Màu Mint",703000,1171000,468000,40
TIKI,nha-cua-doi-song,74651405,"Chai rót dầu ăn, nước tương thủy tinh bọc Inox 304 cao cấp 300ml bằng thủy tinh chai hũ lọ gia vị dụng cụ nhà bếp tiện ích VANDO",35000,50000,15000,30
TIKI,nha-cua-doi-song,137730095,"Vá hớt bọt Lọc váng dầu Muỗng canh có lỗ Vớt thức ăn INOX 304 cao cấp",115000,115000,0,0
TIKI,nha-cua-doi-song,9970789,"Bộ 5 hộp đựng giày dép thông minh, tiện lợi GS0023",206999,206999,0,0
TIKI,nha-cua-doi-song,165085520,"Bộ Thìa Đũa  Cá Nhân Văn Phòng  3 Món Lúa Mạch Chất Liệu Inox 304 Không Rỉ Kèm Hộp- Hàng Loại 1 - Chính Hãng MINIIN",28000,43000,15000,35
TIKI,nha-cua-doi-song,984242,"Kèn Melodion - Melodica Suzuki MX-32D 32 Phím",600000,600000,0,0
TIKI,nha-cua-doi-song,58469517,"Dây đèn nháy Led đom đóm trang trí pin dây bóng đèn nháy cao cấp decor nhà cửa, lễ tết, lều trại du lịch, fairy light cao cấp (Tùy chọn màu và chiều dài dây)",68000,113000,45000,40
TIKI,nha-cua-doi-song,72804257,"Pin AA Energizer Ultimate Lithium L91 - Vỉ 2 viên",131000,139000,8000,6
TIKI,nha-cua-doi-song,102445108,"Ô Dù Mở Ngược Chuyên Dùng Cho Ô Tô Thiết Kế Thông Minh",78000,78000,0,0
TIKI,nha-cua-doi-song,126730148,"Hộp cơm thủy tinh 2,3 ngăn, hộp thủy tinh đựng thức ăn NIKKO INOCHI chính hãng",81600,81600,0,0
TIKI,nha-cua-doi-song,97454973,"Giá kệ để đồ rửa chén bếp treo khăn lau siêu tiện lợi, kệ thép không gỉ khay hứng nước khô ráo VANDO",175000,330000,155000,47
TIKI,nha-cua-doi-song,177971994,"[GDSG147] Muỗng Múc Xới Cơm Có Đế Đứng Hình Chú Thỏ Chất Liệu Nhựa Lúa Mì Thiên Nhiên [Tiện lợi]",9000,9000,0,0
TIKI,nha-cua-doi-song,55994496,"Combo 2 Khăn Lau Xe Ô Tô Siêu Thấm, Khăn Lau Đa Năng Chất Liệu Microfiber 2 Chiếc - Hàng Chính Hãng",69000,100000,31000,31
TIKI,nha-cua-doi-song,172527718,"Set 50 Giấy Nến Lót Nồi Chiên Không Dầu Siêu Tiện Dụng (Tặng 1 Cọ Quét Silicone)",17999,17999,0,0
TIKI,nha-cua-doi-song,138173087,"Cuộn Decal Dán Bếp Chọn Chiều Dài Giấy Decal Dán Tường Tráng Nhôm Cách Nhiệt Cao Cấp Chính Hãng",35000,50000,15000,30
TIKI,nha-cua-doi-song,101893893,"Giỏ Đựng Đồ Rửa Chén Bát Silicon Treo Bồn Rửa Bát cao cấp",9999,9999,0,0
TIKI,nha-cua-doi-song,53954421,"Pin D Energizer Max E95 BP2",117000,150000,33000,22
TIKI,nha-cua-doi-song,142312235,"Nệm PE Hàn Quốc cao cấp gấp 3 ( 1m2 x 2m x 3cm)  tặng 1 cặp áo gối nằm màu ngẫu nhiên",222000,270000,48000,18
TIKI,nha-cua-doi-song,48287959,"KỆ LÒ VI SÓNG 2 TẦNG GỖ THÔNG - Dài 60cm x Cao 46cm",169000,190000,21000,11
TIKI,nha-cua-doi-song,78964736,"Chốt Khóa Cài Cửa Có Lỗ Cài KUNBE, Chốt Cửa Khóa Gài Cây Gạt, An Toàn Cao Cấp Tiện Dụng",32000,32000,0,0
TIKI,nha-cua-doi-song,32476504,"Công tắc hẹn giờ Kg316T-ii 17 chương trình công suất lớn 25A/220V",67500,67500,0,0
TIKI,nha-cua-doi-song,67303104,"Đồng Hồ Treo Tường Kim Trôi Họa Tiết Sang Trọng Cao Cấp",107000,107000,0,0
TIKI,nha-cua-doi-song,4166657,"Máy sạc Pin  ENERGIZER CHVC4 (kèm 4 viên pin sạc AA 1300 mAh)",327000,330000,3000,1
TIKI,nha-cua-doi-song,117207768,"Biến Áp Đổi Nguồn Hạ Áp LiOA - Biến Áp Đổi Nguồn LiOA 1000/1200/1500/2000VA( Điện Vào 220V- Điện Ra 100/120V) - MITA",495000,495000,0,0
TIKI,nha-cua-doi-song,91443194,"Dụng cụ Mở Rượu Vang Chuyên Dụng bằng Thép không gỉ Đẳng Cấp và Sang Trọng",89000,150000,61000,41
TIKI,nha-cua-doi-song,75707305,"Bộ May Vá Quần Áo Đa Năng Cho Gia Đình KUNBE Kèm Hộp Đựng Kim Chỉ",53000,53000,0,0
TIKI,nha-cua-doi-song,31976047,"Màn cuốn văn phòng cao cố định 1m4 - MC-02",363999,363999,0,0
TIKI,nha-cua-doi-song,205495107,"Hộp 24 Quả Châu 4CM Nhũ Kim Tuyến Lấp Lánh Trang Trí Noel, Giáng Sinh 4CM",98700,98700,0,0
TIKI,nha-cua-doi-song,130470014,"Vỏ trứng gà Sfarm đã qua xử lý",35000,35000,0,0
TIKI,nha-cua-doi-song,253081471,"Miếng rửa chén đa năng sợi tre MyJae, miếng rửa chén chống xước 2 mặt, siêu bền đánh bay dầu bẩn",35000,69000,34000,49
TIKI,nha-cua-doi-song,112532029,"Khay đựng túi rác dành cho thùng rác thông minh TOWNEW T1, T1S, T Air X, T Air Lite_Hàng chính hãng",70000,70000,0,0
TIKI,nha-cua-doi-song,274121892,"Vỏ Áo gối nằm Thuần Việt - Lụa Tencel Thoáng Mát, Thấm Hút Mồ Hôi Tốt - Họa Tiết Hoa Văn - Đa Dạng Họa Tiết",130000,220000,90000,41
TIKI,do-choi-me-be,273532024,"[Combo 3 lon còn 1tr440] Sữa Bột Nutifood GrowPLUS+ Suy Dinh Dưỡng 1.5kg - Tăng Cân, Tăng Chiều Cao (Lon 1.5kg)",568000,884000,316000,36
TIKI,do-choi-me-be,116407260,"Combo 2 túi nước giặt OMO Matic chuyên dụng Cửa Trước Lavender Khử Mùi Thư Thái 3.6kg",350000,454000,104000,23
TIKI,do-choi-me-be,116407426,"Combo 2 Túi Nước Giặt Omo Matic Máy Giặt Cửa Trên Hương Comfort Tinh Dầu Thơm Xoáy Bay Vết Bẩn Thơm Bền Lâu 3.6Kg",350000,454000,104000,23
TIKI,do-choi-me-be,134516825,"Combo 2 túi Nước Xả Vải Comfort Giữ Màu & Bền Vải Một Lần Xả Hương Ban Mai, túi 3.8L",427000,542000,115000,21
TIKI,do-choi-me-be,134516823,"Combo 2 túi nước xả vải em bé Comfort cho da nhạy cảm với công thức riêng dịu nhẹ 100% nguồn gốc thực vật, Túi 3.8L",452000,570000,118000,21
TIKI,do-choi-me-be,97551646,"Bộ 2 Lon Sữa Bột Friso Gold 4 1400g Dành Cho Trẻ Từ 2 - 6 Tuổi + Tặng Lon Sữa Friso Gold 4 380g",1260000,1770000,510000,29
TIKI,do-choi-me-be,1000534,"Sữa Bột Anlene Gold Movepro Hương Vanilla (Hộp Giấy 440g)",189000,204000,15000,7
TIKI,do-choi-me-be,116410119,"Túi Nước giặt Omo Nước giặt cửa trước hương Lavender Khử mùi thư thái 3.6KG",180000,227000,47000,21
TIKI,do-choi-me-be,59143353,"Combo Tiết Kiệm: 6 Gói Khăn Ướt Bobby Care Không Hương 100 Miếng/Gói",199000,279000,80000,29
TIKI,do-choi-me-be,20088686,"Sữa tắm gội toàn thân Johnson's Baby (500ml)",155000,155000,0,0
TIKI,do-choi-me-be,100989176,"Nước Xả Làm Mềm Vải Comfort Chăm Sóc Dịu Nhẹ Cho Da Nhạy Cảm 3.8L",285000,285000,0,0
TIKI,do-choi-me-be,68347468,"Nước xả làm mềm vải COMFORT Nước xả vải hương Bella Giữ màu, Bền Vải & Hương nước hoa thiên nhiên 3.8L",215000,271000,56000,21
TIKI,do-choi-me-be,68370674,"Nước Xả Làm Mềm Vải COMFORT Nước Xả Vải Hương Ban Mai Đậm Đặc 1 Lần Xả Giúp Giữ Màu & Bền Vải 3.8L",215000,271000,56000,21
TIKI,do-choi-me-be,160299786,"Nước Rửa Chén Bát Sunlight Chanh 100 Sạch Nhanh Xả Bọt Nhanh Rửa Sạch Dầu Mỡ 3.6kg",100000,104900,4900,5
TIKI,do-choi-me-be,41356464,"Nước Rửa Chén Bát Sunlight Thiên Nhiên Muối Khoáng & Lô Hội 3.6kg",118000,126500,8500,7
TIKI,do-choi-me-be,272847939,"Hạt nêm rau củ Massel Úc 100% từ rau củ thảo mộc bảo vệ sức khỏe, dành cho ăn chay, ăn mặn, ăn kiêng và cho bé ăn dặm - QuaTangMe Extaste",88400,180000,91600,51
TIKI,do-choi-me-be,116410107,"TúI Nước Giặt Omo Matic Comfort Cho Máy Giặt Cửa Trên Hương Tinh Dầu Thơm Xoáy Bay Vết Bẩn, Hương Thơm Bền Lâu 3.6Kg",180000,227000,47000,21
TIKI,do-choi-me-be,111304924,"Túi Nước Giặt Omo Matic Cho Quần Áo Bé Yêu Chiết Xuất Tràm Trà Và Nha Đam Dịu Nhẹ, Sạch Khuẩn 3.6Kg",180000,227000,47000,21
TIKI,do-choi-me-be,76404389,"Tã/ Bỉm Quần PAMPERS Giữ Dáng Gói Cực Đại Size M (74 miếng, 7-12kg), Chống Xệ",332000,528000,196000,37
TIKI,do-choi-me-be,116410159,"Túi Nước Giặt Omo Matic Cho Máy Giặt Cửa Trước Bền Đẹp Bền Màu Sau 100 Lần Giặt 3.6Kg",180000,227000,47000,21
TIKI,do-choi-me-be,59143353,"Combo Tiết Kiệm: 6 Gói Khăn Ướt Bobby Care Không Hương 100 Miếng/Gói",199000,279000,80000,29
TIKI,do-choi-me-be,23957552,"Combo 2 Tã Quần Người Lớn Sunmate Mềm Mại L8 (8 Miếng)",160000,199999,39999,20
TIKI,do-choi-me-be,498670,"Combo 2 Tã Dán Người Lớn SunMate G2 Size XL10 (10 Miếng)",202000,261163,59163,23
TIKI,do-choi-me-be,25027164,"Combo 2 Gói Tã Quần Người Lớn Sunmate Khô Thoáng L7 (7 Miếng/ Gói)",151000,199999,48999,24
TIKI,do-choi-me-be,206641076,"Combo phụ gia: Nước làm bóng 500ml + Dung dịch vệ sinh máy 250ml + Muối rửa chén bát 1kg",365000,489000,124000,25
TIKI,do-choi-me-be,100989176,"Nước Xả Làm Mềm Vải Comfort Chăm Sóc Dịu Nhẹ Cho Da Nhạy Cảm 3.8L",285000,285000,0,0
TIKI,do-choi-me-be,116410110,"TúI Nước Giặt Omo Matic Cho Máy Giặt Cửa Trên Xoáy Bay Vết Bẩn Sạch Bẩn Khử Mùi Toàn Diện 3.9Kg",180000,227000,47000,21
TIKI,do-choi-me-be,116407260,"Combo 2 túi nước giặt OMO Matic chuyên dụng Cửa Trước Lavender Khử Mùi Thư Thái 3.6kg",350000,454000,104000,23
TIKI,do-choi-me-be,116447512,"Sữa tắm Johnson's Baby chứa sữa và gạo (1000ml)",235000,235000,0,0
TIKI,do-choi-me-be,24028050,"Sữa bột Abbott Pediasure 1.6kg cho trẻ từ 1-10 tuổi",1039000,1240250,201250,16
TIKI,do-choi-me-be,114771868,"Nước giặt dưỡng vải Comfort Nước giặt xả đa chức năng hương Thời Thượng giúp quần áo sạch thơm & tươi màu Túi 3.8kg",167000,195000,28000,14
TIKI,do-choi-me-be,125240682,"Nước Xả Vải Downy Dạng Túi",275000,275000,0,0
TIKI,do-choi-me-be,498703,"Combo 6 Khăn Ướt Unifresh Aloevera 80M (80 Miếng)",140970,140970,0,0
TIKI,do-choi-me-be,41356464,"Nước Rửa Chén Bát Sunlight Thiên Nhiên Muối Khoáng & Lô Hội 3.6kg",118000,126500,8500,7
TIKI,do-choi-me-be,160299786,"Nước Rửa Chén Bát Sunlight Chanh 100 Sạch Nhanh Xả Bọt Nhanh Rửa Sạch Dầu Mỡ 3.6kg",100000,104900,4900,5
TIKI,do-choi-me-be,68347468,"Nước xả làm mềm vải COMFORT Nước xả vải hương Bella Giữ màu, Bền Vải & Hương nước hoa thiên nhiên 3.8L",215000,271000,56000,21
TIKI,do-choi-me-be,114771870,"Nước giặt dưỡng vải Comfort Nước giặt xả đa chức năng hương Thanh Lịch giúp quần áo sạch thơm & tươi màu Túi 3.8kg",163000,195000,32000,16
TIKI,do-choi-me-be,137337237,"Combo Mua 1 Tặng 1 - Giấy vệ sinh PREMIER Deluxe đóng cặp ",165000,200000,35000,18
TIKI,do-choi-me-be,116407426,"Combo 2 Túi Nước Giặt Omo Matic Máy Giặt Cửa Trên Hương Comfort Tinh Dầu Thơm Xoáy Bay Vết Bẩn Thơm Bền Lâu 3.6Kg",350000,454000,104000,23
TIKI,do-choi-me-be,1000540,"Sữa Bột Anlene Gold Movepro 3X Hương Vanilla (Hộp Thiếc 800g)",385000,410000,25000,6
TIKI,do-choi-me-be,68370674,"Nước Xả Làm Mềm Vải COMFORT Nước Xả Vải Hương Ban Mai Đậm Đặc 1 Lần Xả Giúp Giữ Màu & Bền Vải 3.8L",215000,271000,56000,21
TIKI,do-choi-me-be,115667006,"Khăn giấy lụa Premier VinaTissue 280 tờ - Combo lốc 6",120000,155000,35000,23
TIKI,do-choi-me-be,34537694,"Tã Dán Siêu Thấm Caryn Gói Siêu Tiết Kiệm M40 (40 Miếng)",334000,352300,18300,5
TIKI,do-choi-me-be,1745009,"Tấm Đệm Lót Siêu Thấm Caryn (20 Miếng)",105000,128700,23700,18
TIKI,do-choi-me-be,88924596,"Sữa Bột Frisolac Gold 2 850g Dành Cho Trẻ Từ 6 - 12 Tháng Tuổi",539000,539000,0,0
TIKI,do-choi-me-be,19944385,"Tấm Đệm Lót Caryn Mỏng Nhẹ (14 Miếng)",90000,102900,12900,13
TIKI,do-choi-me-be,134516823,"Combo 2 túi nước xả vải em bé Comfort cho da nhạy cảm với công thức riêng dịu nhẹ 100% nguồn gốc thực vật, Túi 3.8L",452000,570000,118000,21
TIKI,do-choi-me-be,68347466,"Nước Xả Làm Mềm Vải Comfort Giữ Màu & Bền Vải Sophia Hương Nước Hoa Thiên Nhiên 3.8L",215000,271000,56000,21
TIKI,do-choi-me-be,134516825,"Combo 2 túi Nước Xả Vải Comfort Giữ Màu & Bền Vải Một Lần Xả Hương Ban Mai, túi 3.8L",427000,542000,115000,21
TIKI,do-choi-me-be,25746246,"Combo 2 Chai Nước Tẩy Bồn Cầu Vim Trắng Sáng Hương Oải Hương 870 ML",78000,78000,0,0
TIKI,do-choi-me-be,88949154,"Sữa Bột Friso Gold 4 1400g (Dành Cho Trẻ Từ 2 - 6 Tuổi)",730000,885000,155000,18
TIKI,do-choi-me-be,38438031,"Combo Viên tẩy bồn cầu 55G x 3 VIM Power 5 hương Oải hương Sạch Khuẩn Thơm Mát suốt 30 ngày",75000,84000,9000,11
TIKI,do-choi-me-be,88784189,"Bột thông cống và khủ mùi hôi bồn cầu, lavabo, chậu rửa bát, đường ống cực  mạnh nắp xanh",10000,16139,6139,38
TIKI,do-choi-me-be,174865692,"Combo 5 Bộ Viên tẩy bồn cầu Vim Power 5 Hương Lavender 275G (5x55G)",112000,120000,8000,7
TIKI,do-choi-me-be,23957552,"Combo 2 Tã Quần Người Lớn Sunmate Mềm Mại L8 (8 Miếng)",160000,199999,39999,20
TIKI,do-choi-me-be,273532024,"[Combo 3 lon còn 1tr440] Sữa Bột Nutifood GrowPLUS+ Suy Dinh Dưỡng 1.5kg - Tăng Cân, Tăng Chiều Cao (Lon 1.5kg)",568000,884000,316000,36
TIKI,do-choi-me-be,116407424,"Combo 2 túi nước giặt OMO Matic cho máy giặt cửa trên giúp quần áo sạch bẩn khử mùi toàn diện, túi 3.9kg",350000,454000,104000,23
TIKI,do-choi-me-be,184101589,"Combo 2 TúI Nước Giặt Omo Matic Cho Quần Áo Bé Yêu Chiết Xuất Tràm Trà Và Nha Đam Dịu Nhẹ, Sạsh Khuẩn , túi 3.6Kg",350000,454000,104000,23
TIKI,do-choi-me-be,181452377,"Combo 2 túi Nước xả làm mềm vải Comfort chăm sóc chuyên sâu phơi trong nhà Hương nắng mới",422000,542000,120000,22
TIKI,do-choi-me-be,181426565,"Nước xả làm mềm vải Comfort chăm sóc chuyên sâu phơi trong nhà Hương nắng mới",215000,271000,56000,21
TIKI,do-choi-me-be,95269395,"Tã Quần Siêu Cao Cấp Huggies Platinum Nature Made L44 (44 Miếng)",329000,460000,131000,28
TIKI,do-choi-me-be,68612510,"Combo 2 Túi nước giặt xả Maxkleen Hương Huyền Diệu 3.8kg/túi ",369000,420000,51000,12
TIKI,do-choi-me-be,115483206," Sữa bột Enfagrow A+ NeuroPro 3 với 2’-FL HMO cho trẻ từ 1 – 3 Tuổi - Vị Nhạt Dễ Uống (2.2kg)",997000,997000,0,0
TIKI,do-choi-me-be,145976954,"[CỘNG 6 MIẾNG] Tã quần Moony cao cấp XL38+6 (Girl) - Nhập khẩu từ Nhật Bản",339000,475000,136000,29
TIKI,do-choi-me-be,57044932,"Thùng 48 Hộp Sữa Nước Abbott Pediasure Vani 180ml cho trẻ từ 1 - 10 tuổi",1470000,1633728,163728,10
TIKI,do-choi-me-be,6840059,"Combo 2 Tã Dán Người Lớn SunMate G2 Size M10 (10 Miếng)",146000,182620,36620,20
TIKI,do-choi-me-be,145976954,"[CỘNG 6 MIẾNG] Tã quần Moony cao cấp XL38+6 (Girl) - Nhập khẩu từ Nhật Bản",339000,475000,136000,29
TIKI,do-choi-me-be,175953067,"Combo 4 Tã Quần Người Lớn SunMate Mềm Mại",293000,399997,106997,27
TIKI,do-choi-me-be,23957447,"Combo 2 Tã Quần Người Lớn Sunmate Mềm Mại M9 (9 Miếng)",166000,203702,37702,19
TIKI,do-choi-me-be,23957552,"Combo 2 Tã Quần Người Lớn Sunmate Mềm Mại L8 (8 Miếng)",160000,199999,39999,20
TIKI,do-choi-me-be,124708784,"Nước Giặt Ariel Hương Downy Túi 3.2Kg",236500,236500,0,0
TIKI,do-choi-me-be,6840059,"Combo 2 Tã Dán Người Lớn SunMate G2 Size M10 (10 Miếng)",146000,182620,36620,20
TIKI,do-choi-me-be,126022163,"Bột thông tắc cống, bồn cầu, bồn rửa bát, đường ống cực mạnh HGO Super 250g",49000,75000,26000,35
TIKI,do-choi-me-be,213586945,"Combo 4 Tấm lót SunMate cải tiến mới 14 miếng/gói size L (60 x 70cm)",292000,373092,81092,22
TIKI,do-choi-me-be,59143355,"Combo Tiết Kiệm: 6 Gói Khăn Ướt Bobby Care Bổ Sung 80 Miếng/Gói",159000,231000,72000,31
TIKI,do-choi-me-be,573673,"Thùng 48 Hộp Sữa Nước Abbott Grow Gold 180ml cho trẻ 1 tuổi trở lên",813000,904224,91224,10
TIKI,do-choi-me-be,175953079,"Combo 4 Gói Tã Quần Người Lớn SunMate Khô Thoáng",320000,399997,79997,20
TIKI,do-choi-me-be,175953065,"Combo 4 Tã Dán Người Lớn SunMate G2 size M10, M/L10, XL10, M/L18",267000,365234,98234,27
TIKI,do-choi-me-be,84304880,"Tẩy cặn canxi vách kính, vòi sen inox, bồn sứ, gạch men HGO Plus 500ml",95000,95000,0,0
TIKI,do-choi-me-be,199903947,"Combo 4 Tấm lót SunMate cải tiến mới (45 x 70cm)",197000,240451,43451,18
TIKI,do-choi-me-be,25099352,"Combo 02 Hộp Bột Tẩy Vệ Sinh Lồng Máy Giặt Ag+ Mao Bao 306g - Tặng 01 hộp Bột Tẩy Quần Áo Thiên Nhiên 12g x 2 gói",84000,110000,26000,24
TIKI,do-choi-me-be,181452377,"Combo 2 túi Nước xả làm mềm vải Comfort chăm sóc chuyên sâu phơi trong nhà Hương nắng mới",422000,542000,120000,22
TIKI,do-choi-me-be,117836946,"[Mới] Hộp giấy 2 Kg Frisolac Gold 3",939000,939000,0,0
TIKI,do-choi-me-be,498670,"Combo 2 Tã Dán Người Lớn SunMate G2 Size XL10 (10 Miếng)",202000,261163,59163,23
TIKI,do-choi-me-be,88949152,"Sữa Bột Frisolac Gold 3 1400g (Dành Cho Trẻ Từ 1 - 2 Tuổi)",735000,735000,0,0
TIKI,do-choi-me-be,32030382,"Combo 12 Gói Khăn Ướt Huggies Cacao và Bơ Hạt Mỡ (72 Miếng/ Gói)",369000,408000,39000,10
TIKI,do-choi-me-be,72924801,"Combo 3 Hộp 4 Viên Nén Vệ Sinh Lồng Giặt OMO Matic 80gr",227000,276000,49000,18
TIKI,do-choi-me-be,184101589,"Combo 2 TúI Nước Giặt Omo Matic Cho Quần Áo Bé Yêu Chiết Xuất Tràm Trà Và Nha Đam Dịu Nhẹ, Sạsh Khuẩn , túi 3.6Kg",350000,454000,104000,23
TIKI,do-choi-me-be,435762,"Sữa Bột Abbott Grow Gold 3+ cho trẻ từ 3 - 6 tuổi (1.7Kg)",674000,781380,107380,14
TIKI,do-choi-me-be,24026125,"Thùng 30 Chai Sữa Nước Abbott Glucerna Vani 220ml",1440000,1567500,127500,8
TIKI,do-choi-me-be,98276143,"Thùng 3 Gói Tã/ Bỉm Quần PAMPERS Nhật Thượng Hạng, Size M (144 miếng, 6-12kg), Siêu Mềm Mịn & Thoáng Khí",964000,1410000,446000,32
TIKI,do-choi-me-be,271961546,"Dung Dịch Diệt Khuẩn Đa Năng Dettol 500ml",159000,179000,20000,11
TIKI,do-choi-me-be,118123582,"Giấy vệ sinh PREMIER VinaRoll không lõi - Combo 3 lốc",225000,225000,0,0
TIKI,do-choi-me-be,88924594,"Sữa Bột Frisolac Gold 1 850g Dành Cho Trẻ Từ 0 - 6 Tháng Tuổi",531000,531000,0,0
TIKI,do-choi-me-be,130997754,"Combo 2 túi nước giặt dưỡng vải Comfort 3.8kg",390000,390000,0,0
TIKI,do-choi-me-be,159387940,"Đai đi xe máy cho bé phản quang, thoáng khí sử dụng khóa 2 cấp bền chắc, chống bui bẩn",129000,179000,50000,28
TIKI,do-choi-me-be,116407424,"Combo 2 túi nước giặt OMO Matic cho máy giặt cửa trên giúp quần áo sạch bẩn khử mùi toàn diện, túi 3.9kg",350000,454000,104000,23
TIKI,do-choi-me-be,24030105,"Sữa bột Abbott Pediasure 850g cho trẻ từ 1 - 10 tuổi",665000,755948,90948,12
TIKI,do-choi-me-be,24028484,"Sữa bột Abbott Pediasure cho trẻ từ 1 - 10 tuổi (400g)",321000,346500,25500,7
TIKI,do-choi-me-be,7178671,"Bột Tẩy Quần Áo Thiên Nhiên Baking Soda Mao Bao (12 g x 5 gói)",43000,55000,12000,22
TIKI,do-choi-me-be,181426565,"Nước xả làm mềm vải Comfort chăm sóc chuyên sâu phơi trong nhà Hương nắng mới",215000,271000,56000,21
TIKI,do-choi-me-be,130461479,"Sữa Bột Similac Einstein 4 cho trẻ từ 2 - 6 tuổi",499000,547560,48560,9
TIKI,do-choi-me-be,10054452,"Thùng 48 Hộp Sữa Bột Pha Sẵn Friso Gold Rtd Vani (48 Hộp X 110ml)",438000,505000,67000,13
TIKI,do-choi-me-be,23957447,"Combo 2 Tã Quần Người Lớn Sunmate Mềm Mại M9 (9 Miếng)",166000,203702,37702,19
TIKI,do-choi-me-be,57044926,"Thùng 48 Hộp Sữa Nước Abbott Pediasure Vani 110ml cho trẻ từ 1 - 10 tuổi",1009000,1111824,102824,9
TIKI,do-choi-me-be,145974290,"[CỘNG 4 MIẾNG] Tã dán Moony cao cấp L54+4 - Nhập khẩu từ Nhật Bản",339000,475000,136000,29
TIKI,do-choi-me-be,413088,"Miếng Lót Sơ Sinh Bobby Fresh Newborn 2 - 40 (40 Miếng)",79000,98000,19000,19
TIKI,do-choi-me-be,35043572,"Thùng 48 Hộp Sữa Nước Abbott Similac 110ml cho trẻ từ 1 tuổi",605000,699600,94600,14
TIKI,do-choi-me-be,160299782,"Nước Lau Sàn Sunlight Tinh Dầu Thảo Mộc Hương Hoa Hạ & Bạc Hà 3,6 Kg - Sạch Thơm Thư Thái - Nhà Thêm Trong Lành",92900,93000,100,0
TIKI,do-choi-me-be,175953067,"Combo 4 Tã Quần Người Lớn SunMate Mềm Mại",293000,399997,106997,27
TIKI,nha-cua-doi-song,74383210,"Kệ úp ly chén HOBBY KUL41 Inox 304 kèm khay hứng nước không rỉ sét - ngang 41cm",336000,499000,163000,33
TIKI,nha-cua-doi-song,529402,"Chất Bôi Trơn Chống Gỉ Sét Selleys RP7 150g",69000,79000,10000,13
TIKI,nha-cua-doi-song,142117009," Khay Làm Đá Silicol Có Nắp Đậy Dễ Dàng Lấy Đá, An Toàn Tiện Lợi",28000,28000,0,0
TIKI,nha-cua-doi-song,174618568,"Thùng rác cảm ứng thông minh 18 lít ML B-JA-18",859000,859000,0,0
TIKI,nha-cua-doi-song,195852180,"Ly nhựa 2 lớp có ống hút LocknLock Bucket Cold Cup with Straw HAP520BLU 580ml",145000,241000,96000,40
TIKI,nha-cua-doi-song,182814301,"Miếng Dán Chống Ngáy Khi Ngủ Nhật Bản, Chống Há Miệng Khi Ngủ Cho Người Lớn Và Trẻ Em",75000,90000,15000,17
TIKI,nha-cua-doi-song,6137123,"Phân Bón Npk 20-20-15 đa năng 3 màu  (1Kg)- bón cây, rau, cây ăn trái, hoa kiểng - bón gốc dễ sử dụng, kích thích ra lá, ra hoa, đậu trái",49000,49000,0,0
TIKI,nha-cua-doi-song,155420461,"Combo 2 hộp chia ngăn sắp xếp quần áo Mai Anh House - hộp đựng đồ chất liệu cao cấp, phong cách Nhật Bản sang trọng",210000,210000,0,0
TIKI,nha-cua-doi-song,77662747,"Bình giữ nhiệt Nhật Bản inox Thermos nút bấm 500ml JNL 502 SBR (JNL - 500/2) - Hàng chính hãng",745000,950000,205000,22
TIKI,nha-cua-doi-song,106809822,"Đèn laser 60 trong 1 pin sạc đèn trang trí sân khấu vũ trường phòng karaoke",319000,319000,0,0
TIKI,nha-cua-doi-song,134360700,"Vỉ 10 Viên Pin LR44 , Pin A76 , Pin AG13 1,5V Energizer - Hàng Chính Hãng",65000,80000,15000,19
TIKI,nha-cua-doi-song,76103827,"Móc Treo Quần Áo Inox 304 Dán Tường Không Cần Khoan Đục - Tặng Kèm keo và Đinh Vít",110000,165000,55000,33
TIKI,nha-cua-doi-song,92507688,"Combo 50 Viên Khăn Nén Du Lịch Cao Cấp Đa Năng Tiện Lợi, Viên Khăn Uớt Nén Hình Viên Kẹo (Nhỏ Gọn, Tiện Lợi, Dùng Để Tẩy Trang, Lau Mặt, ...), KHĂN NÉN GẶP NƯỚC NỞ RA",24579,24579,0,0
TIKI,nha-cua-doi-song,129145019,"bình pha trà,ấm lọc trà thủy tinh có lõi lọc inox 304 chịu nhiệt",129000,129000,0,0
TIKI,nha-cua-doi-song,183038438,"Bình xịt tưới cây MONROVIA 2 lít, bán tự động, phun sương tưới cây cảnh, vòi dài, tặng vòi ngắn, màu xanh, tiêu chuẩn Châu Âu",169000,169000,0,0
TIKI,nha-cua-doi-song,126151275,"Gối Hơi Ngủ Trưa Văn Phòng 42cm x 26cm",27000,27000,0,0
TIKI,nha-cua-doi-song,55126177,"[Xuất Nhật] Kệ Để Đồ Đa Năng 3 Tầng Tokyo - Nhựa Cao Cấp Rất Chắc Chắn Dùng Để Đựng Đồ Nhà Bếp  Hoặc Làm Giá Để Đồ Nhà Tắm Phòng Ngủ",109000,109000,0,0
TIKI,nha-cua-doi-song,186554008,"Khăn Tắm Nén Du Lịch 70 x 140cm Dạng Viên Nén Làm Từ Cotton Tự Nhiên, Sử Dụng Nhiều Lần",17994,17994,0,0
TIKI,nha-cua-doi-song,115824604,"Bộ dây đàn Guitar Classic/ Classical Guitar String Set - D'Addario EJ49 - Pro-Arte Nylon Core, Normal Tension, Silverplated Wound, Black Nylon - Hàng chính hãng",392000,392000,0,0
TIKI,nha-cua-doi-song,74380878," CHỔI LÔNG QUÉT BỤI CÁN INOX RÚT GỌN TẶNG KÈM MÓC TREO 3D",78000,78000,0,0
TIKI,nha-cua-doi-song,113330027,"Đàn Piano Đàn Điện Tử 61 Phím Kèm mic Cho Bé Đàn Organ thương hiêu DORON",259000,259000,0,0
TIKI,nha-cua-doi-song,137672977,"Viên khử mùi tẩy bồn cầu toilet siêu sạch bóng (1 viên), sáp chống ố vàng mùi hôi, diệt sạch vi khuẩn gây hại",1000,6000,5000,83
TIKI,nha-cua-doi-song,186619847,"Chậu cây để bàn MONROVIA cho hoa, cây cảnh, ban công, bonsai",34000,34000,0,0
TIKI,nha-cua-doi-song,56388392,"Set 100s Dây rút nhựa có bảng tên dùng để đánh dấu dây cáp - tặng kèm bút viết chống xóa",155000,155000,0,0
TIKI,nha-cua-doi-song,68135337,"Kệ nhà tắm dán tường HT SYS-ECOCO-E1923-chất liệu ABS cao cấp kèm thanh treo khăn SUS 304",155000,155000,0,0
TIKI,nha-cua-doi-song,21576181,"Công Tắc Thông Minh SONOFF Điều Khiển Qua Wifi, Mạng 3G, 4G",105000,105000,0,0
TIKI,nha-cua-doi-song,167429965,"LY GIỮ NHIỆT ELEMENTAL ARTISAN MÀU TRƠN (360ML)",664050,699000,34950,5
TIKI,nha-cua-doi-song,150171465,"Đèn năng lượng mặt trời 60W,45W,80W,100W,180W Solar light - D1082",422000,422000,0,0
TIKI,nha-cua-doi-song,68460154,"ỐNG LÕI THÉP BỌC NHỰA PHI 11, COMBO 10 ỐNG",169750,175000,5250,3
TIKI,nha-cua-doi-song,196946521,"Combo Bình giữ nhiệt + Hộp đựng thức ăn cho bé Lock&Lock LHC3283YEL + LLG510S3",411000,919000,508000,55
TIKI,nha-cua-doi-song,103094362,"Kệ Nhà Tắm Để Đồ Dùng Thông Minh, Kèm Cốc Hút Từ Tính Có Nhả Kem Đánh Răng Tự Động",93599,119999,26400,22
TIKI,nha-cua-doi-song,116813584,"Set 4 Kệ Gỗ Treo Tường Thanh Ngang SIB Decor Trang Trí Phòng Khách Góc Làm Việc, Tặng Kèm Phụ Kiện Giấu Chân",338000,350000,12000,3
TIKI,nha-cua-doi-song,177017969,"[SGFS53] Túi đựng đồ dây rút chống thấm hình gấu broun [TIỆN LỢI] Túi dây rút tiện dụng",5000,5000,0,0
TIKI,nha-cua-doi-song,108591833,"Thùng đựng gạo thông minh hàng cao cấp dung tích 12kg- Thương hiệu DORON",198000,198000,0,0
TIKI,nha-cua-doi-song,158973350,"Lư Đốt Trầm Hương, Lư Xông Trầm Bằng Gốm Sứ - Hàng Chính Hãng",45080,49000,3920,8
TIKI,nha-cua-doi-song,183335881,"RÈM VẢI MÀU XANH DƯƠNG TRƠN CHỐNG NẮNG, NHIỀU KÍCH THƯỚC LỰA CHỌN",75000,75000,0,0
TIKI,nha-cua-doi-song,25557453,"Đèn pin mini chiếu sáng dùng pin",47000,47000,0,0
TIKI,nha-cua-doi-song,194125023,"Khăn tắm sợi tre MORI xuất Nhật cao cấp 60x120cm",99160,148000,48840,33
TIKI,nha-cua-doi-song,174812493,"3500W-Phích cắm ổ cắm chuyển 3 chấu sang 2 chấu,Công suất lớn Toshino EA-ES",150000,150000,0,0
TIKI,nha-cua-doi-song,52731281,"Kéo Thép Đa Năng Nhật Bản, Size Lớn, Chất Liệu Thép Cao Cấp Không Gỉ",26000,35000,9000,26
TIKI,nha-cua-doi-song,98678358,"MC2 - 25x9x9 cm - 20 Thùng hộp carton",37800,37800,0,0
TIKI,nha-cua-doi-song,70192533,"Bộ dụng cụ nhả kem đánh răng tự động 4 cốc và giá treo bàn chải đa năng HT SYS-COCO-E1922-chất liệu ABS cao cấp",295000,295000,0,0
TIKI,nha-cua-doi-song,139979908,"Thác khói trầm hương - tặng nụ trầm Cao Cấp - Trầm hương khói ngược - Xông nhà, văn phòng, mùi dễ chịu, không kích mũi - Thiên Mộc Hương",52000,80000,28000,35
TIKI,nha-cua-doi-song,50393230,"Nhang Sạch Phòng Máy Lạnh - Ít khói - Hương trầm dịu nhẹ - Chân tăm mộc - Nhang Xanh",27000,27000,0,0
TIKI,nha-cua-doi-song,173394319,"Đèn cầy nến -cháy 4h 100 viên , 8h 50 viên nhiều màu",118000,118000,0,0
TIKI,nha-cua-doi-song,151861264,"Kệ đựng mỹ phẩm, tủ mỹ phẩm, kệ trang điểm để bàn VHM7-9 bằng gỗ Smartboard màu trắng phong cách trẻ trung sang trọng - Tặng kèm 1 băng đô cài tóc vải lụa màu ngẫu nhiên",99000,99000,0,0
TIKI,nha-cua-doi-song,106699435,"Bàn làm việc, bàn học ngồi bệt gaming - Chân gấp gọn - Lắp sẵn - Chính Hãng TIDO",449000,449000,0,0
TIKI,nha-cua-doi-song,83480720,"Combo 2 Túi Bạt Đựng Quần Áo, Chăn Mền (Giao Ngẫu Nhiên) Chống Thấm Nước, Bộ 2 Giỏ Sọt Đựng Đồ Dơ Họa Tiết Vintage miDoctor",129000,200000,71000,36
TIKI,nha-cua-doi-song,132944792,"3 Cuộn Túi Đựng Rác Tự Phân Hủy Sinh Học (1kg) Bảo Vệ Môi Trường - Size Tiểu, Size Trung, Size Đại, Size Cực Đại",34000,34000,0,0
TIKI,nha-cua-doi-song,115986994,"Miếng Dán Tường Treo Ổ Cắm Điện Treo Wifi Móc Treo Đa Năng Tiện Lợi",16000,39000,23000,59
TIKI,nha-cua-doi-song,110024738,"PHÍCH CẮM CHUYỂN ĐỔI 3 CHẤU SANG 2 CHẤU VÀ CHIA 2 Ổ MPE  2000W - HÀNG CHÍNH HÃNG",22000,22000,0,0
TIKI,nha-cua-doi-song,186501762,"Kệ Nhà Tăm Dán Tường INOX 304 Treo Dầu Gội Mỹ Phẩm Sữa Tắm Thiết Kế 6 Móc Treo Đồ Thông Minh - KT40CM",95000,180000,85000,47
TIKI,nha-cua-doi-song,91547318,"SET 6 khăn gội quấn đầu cotton 85x35ccm",115000,115000,0,0
TIKI,nha-cua-doi-song,41332433,"Tinh dầu xua đuổi chuột",75000,75000,0,0
TIKI,nha-cua-doi-song,123455475,"Combo 10 Khăn Lau Đa Năng Cỡ Lớn Siêu Mịn Bám Bụi Thấm Nước Jodily. KT:26x26cm",65000,65000,0,0
TIKI,nha-cua-doi-song,269023740,"50 Ly Nhựa HỮU PHONG Cao Cấp 700ml Kèm Nắp Cầu Dùng 1 Lần, An Toàn, Đựng Nước ép, Trà sữa (Tặng Móc khóa KETILO)",65000,73000,8000,11
TIKI,nha-cua-doi-song,147763329,"Bộ 8 Túi Hút Chân Không Đựng Quần Áo, Chăn Màn Kèm Bơm Cao Cấp - Chính Hãng dododios",170000,170000,0,0
TIKI,nha-cua-doi-song,23264614,"Bộ Tua Vít Đa Năng 31 Đầu",19094,19094,0,0
TIKI,nha-cua-doi-song,108243370,"Đèn Pin Laze miDoctor Cao Cấp SD Lazer 303 Full Hộp - Chính Hãng",115000,115000,0,0
TIKI,nha-cua-doi-song,579790,"Chảo Đá Chống Dính Siêu Bền Sunhouse SBD30 30cm",246000,480000,234000,49
TIKI,nha-cua-doi-song,69228398,"Ổ khóa Toplex hợp kim thép, lõi đồng, càng dài",90000,90000,0,0
TIKI,nha-cua-doi-song,154566300,"Hộp đựng trứng 24 quả - Khay nhựa đựng trứng gà, vịt để tủ lạnh có nắp đậy tiện dụng  - Hàng loại 1 chính hãng",37000,47000,10000,21
TIKI,nha-cua-doi-song,58021652,"Băng keo chống thấm dột mái tôn đa năng siêu dính khổ 10cm dài 5 mét",28400,28400,0,0
TIKI,nha-cua-doi-song,133888517,"Tô Giấy Dùng 1 Lần KETILO Trắng Trơn 500ml Cao Cấp, Chất Liệu An Toàn Thân Thiện Môi Trường, Tiện Lợi - HÀNG CHÍNH HÃNG TG002",135000,175000,40000,23
TIKI,nha-cua-doi-song,21391325,"Combo 2 Ống Hút Thủy Tinh Trong Suốt Dài 20cm Kèm Cọ Rửa và Túi Vải Bố Màu Tùy Chọn",49000,49000,0,0
TIKI,nha-cua-doi-song,34623289,"Bộ 10 Túi Chân Không Đựng Chăn Màn, Quần Áo - Gọn Gàng, Tiện Lợi + Tặng bơm hút chân không",138000,138000,0,0
TIKI,nha-cua-doi-song,112052096,"Bộ 2 ly uống rượu vang đỏ pha lê 650 ml trong xuốt !",314000,314000,0,0
TIKI,nha-cua-doi-song,13238747,"Đệm ngồi lót ghế cao su thoáng khí tuần hoàn êm ái E3-L206",169000,169000,0,0
TIKI,nha-cua-doi-song,12329959,"Combo 30 miếng lót chân bàn ghế chống trơn trượt và trầy xước - Giao mẫu ngẫu nhiên",24999,24999,0,0
TIKI,nha-cua-doi-song,141472707,"Keo dán chuột keo dính chuột keo bẫy chuột (Dài 1.2M)",79000,84000,5000,6
TIKI,nha-cua-doi-song,195462469,"Miếng Lót Ly, Đế Lót Đá Xốp Diatomite Siêu Thấm Hút",55000,55000,0,0
TIKI,nha-cua-doi-song,95004284,"Bịt mắt ngủ 3 con gấu vui nhộn có túi nước giải nhiệt tặng kèm bịt tai chống ồn",65000,65000,0,0
TIKI,nha-cua-doi-song,67831978,"Thanh Kẹp Miệng Túi Trà K10 – Kẹp tốt mọi loại túi đựng trà, bảo quản trà lâu hơn (giao màu ngẫu nhiên)",4500,4500,0,0
TIKI,nha-cua-doi-song,100048105,"Đồng hồ đo 7 chỉ số xe đạp thể thao",189000,189000,0,0
TIKI,nha-cua-doi-song,51288340,"Combo 2 cuôn khăn lau đa năng có thể tái sử dụng họa tiết hoạt hình",55000,55000,0,0
TIKI,nha-cua-doi-song,109026622,"Thước Dây, Thước Thợ may, Thước đo vòng eo 150cm Đầu bọc thép",4500,4500,0,0
TIKI,nha-cua-doi-song,22605669,"Bàn Làm Việc Lắp Ghép Tiện Lợi",670000,729000,59000,8
TIKI,nha-cua-doi-song,35928141,"Combo 40 móc nhôm treo quần áo chắc chắn, tiện lợi, đa năng và cao cấp tiết kiệm không gian",72000,100000,28000,28
TIKI,nha-cua-doi-song,49129618,"Topper- Tấm Làm Mềm Nệm Tiêu Chuẩn 5 Sao - Xám Nhạt",255000,255000,0,0
TIKI,nha-cua-doi-song,4939061,"Cuộn dây buộc bằng thép bọc nhựa 50m",29000,29000,0,0
TIKI,do-choi-me-be,25096869,"Bột Tẩy Quần Áo Thiên Nhiên Mao Bao chứa Baking Soda (12g x 2 gói)",22000,32000,10000,31
TIKI,do-choi-me-be,453774,"Kem Dưỡng Da Chứa Sữa Và Gạo Johnson’s Baby 20309343 (50g)",66000,66000,0,0
TIKI,do-choi-me-be,92496752,"Combo tẩy cặn canxi nhà tắm HGO Plus + tẩy dầu mỡ nhà bếp HGO bình xịt 500ml, sử dụng tiện lợi hiệu quả tiết kiệm",179000,265000,86000,32
TIKI,do-choi-me-be,249054309,"Sữa Ensure Vanila Úc cho người già, người suy dinh dưỡng, cấp đầy đủ dinh dưỡng giúp hồi phục sức khỏe - Massel Official (850g/lon)",1039000,2078000,1039000,50
TIKI,do-choi-me-be,75435459,"Tã Quần Caryn Loại Mỏng Nhẹ M32",315000,350400,35400,10
TIKI,do-choi-me-be,47961612,"Combo 2 Que Thử Thai QuickStick",40000,40000,0,0
TIKI,do-choi-me-be,576239,"Nước Tẩy Đa Năng Kháng Khuẩn Mao Bao 600ml",43000,50000,7000,14
TIKI,do-choi-me-be,1744989,"Tã Quần Mỏng Nhẹ Caryn Gói Siêu Lớn L14 (14 Miếng)",180000,181600,1600,1
TIKI,do-choi-me-be,543122,"Nước Giặt Quần Áo Em Bé D-nee Hương Lavender 3L - [8851989061535]",202000,245000,43000,18
TIKI,do-choi-me-be,68088749,"Combo 2 Túi Nước Giặt Xả Maxkleen Hương Hoa Nắng (3.8kg/túi)",369000,420000,51000,12
TIKI,do-choi-me-be,124722427,"Xịt đuổi chuột  200ml Thái Lan",48500,48500,0,0
TIKI,do-choi-me-be,34402891,"Viên Thả Làm Sạch Bồn Cầu (1 Gói 10 Viên)",8000,8899,899,10
TIKI,do-choi-me-be,135325550,"Combo 2 Nước Tẩy Bồn Cầu Vim 880ml Diệt 99,9% Vi Khuẩn",67100,76000,8900,12
TIKI,do-choi-me-be,52293405,"Khăn Giấy Rút See-U, 2 Lớp 250 Tờ/gói",27000,27000,0,0
TIKI,do-choi-me-be,133040504,"Combo 3 viên giặt xả MaxKleen hương ngày thư thái (34 viên/túi)",374000,420000,46000,11
TIKI,do-choi-me-be,75435457,"Tã Quần Caryn Loại Mỏng Nhẹ L28",315000,391200,76200,19
TIKI,do-choi-me-be,68268748,"Viên sắt, acid folic, DHA, vitamin & khoáng chất Fe-NANA - Hộp 20 viên",84000,110000,26000,24
TIKI,do-choi-me-be,1744997,"Tã Dán Siêu Thấm Caryn Gói Siêu Lớn M20 (20 Miếng)",180000,201800,21800,11
TIKI,do-choi-me-be,17888580,"Cờ Vua Cao Cấp miDoctor (Chính Hãng) - NHỎ 3810A:  25 x 25 x 2 cm - Hàng chính hãng",92000,92000,0,0
TIKI,do-choi-me-be,168662602,"Sữa bột NAN INFINIPRO A2 Thụy Sĩ 3 800g với đạm quý A2 tiêu hóa tốt sau 7 ngày và 5HMO tăng cường đề kháng (2 - 6 tuổi)",559000,600000,41000,7
TIKI,do-choi-me-be,182709739,"Combo 2 Sữa tắm gội dịu lành cho bé Cetaphil Baby Gentle Wash & Shampoo 400ml/chai",490000,490000,0,0
TIKI,do-choi-me-be,142115663,"Tranh Cát Cho Bé Tập Làm Họa Sỹ",5000,5000,0,0
TIKI,do-choi-me-be,77858363,"Nước Súc Miệng Listerine Kids dành riêng cho trẻ trên 6 tuổi 250ml - ",49000,55000,6000,11
TIKI,do-choi-me-be,48964146,"Set 2 Khăn Tắm Em Bé Sợi Tre Bonny Siêu Mềm Và Thấm Hút (KT: 1m2x1m2) - Giao họa tiết ngẫu nhiên",190000,190000,0,0
TIKI,do-choi-me-be,88949156,"Sữa Bột Friso Gold 4 850g (Dành Cho Trẻ Từ 2 - 6 Tuổi)",495000,600000,105000,18
TIKI,do-choi-me-be,730944,"Sữa Tắm Gội Trẻ Em Lactacyd Milky BẢO VỆ, NUÔI DƯỠNG DA và TÓC BÉ VƯỢT TRỘI 500ml",192000,192000,0,0
TIKI,do-choi-me-be,76099465,"Chế phẩm diệt kiến gián sinh học Anbio - lọ 10ml",16800,16800,0,0
TIKI,do-choi-me-be,106307519,"1 VIÊN TẨY BỒN CẦU",2299,2299,0,0
TIKI,do-choi-me-be,135328955,"Sữa Bột Nestlé NAN SupremePro 1 lon 400g với 5HMO & đạm Gentle Optipro nhập khẩu nguyên lon từ Đức",299000,299000,0,0
TIKI,do-choi-me-be,7827140,"Chất thông tắc bồn cầu toilet chống hôi Siêu tốc 5 phút Sifa (1400g)",53000,53000,0,0
TIKI,do-choi-me-be,25027164,"Combo 2 Gói Tã Quần Người Lớn Sunmate Khô Thoáng L7 (7 Miếng/ Gói)",151000,199999,48999,24
TIKI,do-choi-me-be,35043549,"Thùng 48 Hộp Sữa Nước Abbott Similac 180ml cho trẻ từ 1 tuổi",875000,1003200,128200,13
TIKI,do-choi-me-be,175953079,"Combo 4 Gói Tã Quần Người Lớn SunMate Khô Thoáng",299000,399997,100997,25
TIKI,do-choi-me-be,146556777,"Cờ Vua Gỗ - Cờ Vua Cao Cấp - Đồ Chơi Bằng Gỗ Tự Nhiên - Chính hãng dododios",138000,138000,0,0
TIKI,do-choi-me-be,61292593,"Combo 4 Gói Khăn Ướt Yuniku 90 Tờ Hương Lài ( 90 tờ x 4 )",99000,167200,68200,41
TIKI,do-choi-me-be,53135547,"Lọ Tẩy Vệ Sinh Bồn Cầu Nhật Bản SPEVI - Khử Mùi Nhà Vệ Sinh, Diệt Sạch 99,9% Vi Khuẩn Thiết Kế Thông Minh Giúp Dễ Dàng Sử Dụng, Lọ Thả Bồn Cầu Hiệu Quả Rất Nhiều So Với Viên Thả Bồn Câ·",19000,19000,0,0
TIKI,do-choi-me-be,95269446,"Tã Dán Siêu Cao Cấp Huggies Platinum Naturemade L54 (54 Miếng)",329000,460000,131000,28
TIKI,do-choi-me-be,274034133,"Bộ Bài Drink Game Say sưa 84 lá đầy đủ thử thách vui nhộn",90000,165000,75000,45
TIKI,do-choi-me-be,145677986,"Bộ cờ vua tiêu chuẩn thi đấu, quân cờ nhựa đặc ruột cao cấp (tặng thêm 2 Hậu thuận tiện phong cấp)",250000,250000,0,0
TIKI,do-choi-me-be,82525136,"Combo 3 lon Sữa Morinaga số 2 Chilmil 850g và 1 lon sữa Morinaga số 2 320gr dành cho bé từ 6-36 tháng tuổi",1450000,1734000,284000,16
TIKI,do-choi-me-be,173164598,"Sữa Bột Anlene Gold 5X Hương Vanilla (Hộp Thiếc 800g)",469000,508000,39000,8
TIKI,do-choi-me-be,147246867,"Sữa Bột Anlene Gold 5X Hương Vanilla (Hộp Thiếc 400g)",249000,268000,19000,7
TIKI,do-choi-me-be,435855,"Sữa Bột Abbott Grow Gold 6+cho trẻ từ 6 tuổi trở lên (900g)",464000,472500,8500,2
TIKI,do-choi-me-be,175953065,"Combo 4 Tã Dán Người Lớn SunMate G2 size M10, M/L10, XL10, M/L18",267000,365234,98234,27
TIKI,do-choi-me-be,967305,"Sữa Bột Abbott Similac Mom Vani 900g",465000,493020,28020,6
TIKI,do-choi-me-be,115483434,"Sữa bột Enfamil A+ NeuroPro 2 với 2’-FL HMO cho trẻ từ 6 –12  tháng tuổi– 1.7kg",979000,979000,0,0
TIKI,do-choi-me-be,52774130,"Bộ 2 chai chất thông tắc Cầu, Cống Sifa chống hôi Siêu nhanh Siêu mạnh 5 phút",110000,110000,0,0
TIKI,do-choi-me-be,88949150,"Sữa Bột Frisolac Gold 3 850g (Dành Cho Trẻ Từ 1 - 2 Tuổi)",484000,484000,0,0
TIKI,do-choi-me-be,105901380,"Vitamin k2 d3 hỗ trợ tăng chiều cao, hết còi xương cho trẻ sơ sinh - LINEABON K2D3 - Sản phẩm từ Châu Âu - Công nghệ mới giúp hấp thu tối đa canxi tự nhiên",271000,369000,98000,27
TIKI,do-choi-me-be,84705786,"Gạc Rơ Lưỡi, Vệ Sinh Răng Miệng Cho Bé Dr Papie (1 hộp 30 gói)",102000,102000,0,0
TIKI,do-choi-me-be,146555381,"Đồ Chơi Rút Gỗ Trẻ Em - 2 Cỡ (Lớn và Nhỏ) - 54 Thanh Rút Gỗ Kèm 4 Con Súc Sắc Cho Bé – Bộ Đồ Chơi Rút Gỗ Cao Cấp Chính Hãng dododios",49000,49000,0,0
TIKI,do-choi-me-be,114958267,"Bộ Bài Tình Yêu Game Card Lovetouch - Love card game, board games, bài cho cặp đôi, bài thấu hiểu [Kim Ngọc Thuỷ]",155000,300000,145000,48
TIKI,do-choi-me-be,75357776,"Hộp quà cặp tóc dây buộc tóc công chúa bé gái nhiêu màu cực xinh",69000,69000,0,0
TIKI,do-choi-me-be,177436965,"Đồ bơi trẻ em, đồ bơi bé trai chất vải chống nắng size lớn 45kg cho bé trai đến 10 tuổi",199000,224130,25130,11
TIKI,do-choi-me-be,68925517,"Cháo Tươi Tôm Rau Ngót Cây Thị",21600,25000,3400,14
TIKI,do-choi-me-be,158887692,"Đồ chơi lắp ráp, xếp hình Qman 1801 - Trực thăng chiến đấu - 381 mảnh ghép",199000,269000,70000,26
TIKI,do-choi-me-be,49884598,"Sữa Morinaga Số 2 - Chilmil (850g) dành cho bé từ 6 đến 36 tháng tuổi",495000,578000,83000,14
TIKI,do-choi-me-be,2173355,"Combo 5 Bịch Khăn Vải Khô Likado (300g)",169000,169000,0,0
TIKI,do-choi-me-be,6632811,"Cháo Tươi Thịt Heo Bí Đỏ Cây Thị",18000,21000,3000,14
TIKI,do-choi-me-be,75521920,"Combo 10 cuộn giấy vệ sinh lớn An Khang AKC500 hai lớp loại 500gr",320000,480000,160000,33
TIKI,do-choi-me-be,76372614,"Đồ chơi trí tuệ Smart Games Thử thách IQ hạt tròn",279000,279000,0,0
TIKI,do-choi-me-be,57302858,"Bột Thông Cống, Thông Tắc Bồn Cầu Hàn Quốc Cao Cấp combo ( Hộp 5 Gói )",35192,35192,0,0
TIKI,do-choi-me-be,61290431,"Combo 4 Gói Khăn Ướt Yuniku 90 Tờ Hương Phấn ( 90 tờ x 4 )",99000,167200,68200,41
TIKI,do-choi-me-be,185262304,"Kem đánh răng Colgate Batman 40g dành cho bé",23000,23000,0,0
TIKI,do-choi-me-be,88928340,"Combo 10 khăn ướt Mamamy ( 80 tờ )",285000,300000,15000,5
TIKI,do-choi-me-be,12425736,"Lốc 4 Gói Khăn Giấy Cao Cấp Tempo Softpack Mùi Bạc Hà, 4 Lớp, Không Gây Kích Ứng Da (90 Tờ/ Gói) - Thương Hiệu Đức",105000,105000,0,0
TIKI,do-choi-me-be,54619802,"Chai Thả Bồn Cầu Nhật bản, Vệ Sinh Bồn Cầu, Giúp Hỗ Trợ Giảm Thông Tắc Bồn Cầu Và Khử Mùi, Diệt Sạch 99% Vi Khuẩn (Combo 02 Lọ) - Hàng Chính Hãng",53000,58000,5000,9
TIKI,do-choi-me-be,89261232,"Combo 20 gói khăn giấy lau tay An Khang AK20-2 loại hai lớp dài 20cm - 102 tờ/gói",308000,440000,132000,30
TIKI,do-choi-me-be,7459815," Thuốc diệt gián hộp 12 viên - Nội địa Nhật",55000,55000,0,0
TIKI,do-choi-me-be,19944439,"Tã Dán Moony Natural Bông Organic M46 (46 Miếng)",379000,569400,190400,33
TIKI,do-choi-me-be,270229665,"Sách nói điện tử song ngữ trẻ em (Bản nâng cấp 1+) - Sách quý điện tử song ngữ Anh – Việt cho bé - Có lựa chọn lấy thêm pin",122000,140000,18000,13
TIKI,do-choi-me-be,6464021,"Cháo Tươi Cá Lóc Đậu Xanh Cây Thị",21600,25000,3400,14
TIKI,do-choi-me-be,86155733,"Bộ đồ chơi nhập vai BOWA – Bộ Trang điểm ( BOWA 8252 / BOWA 8255P )",259000,259000,0,0
TIKI,do-choi-me-be,61285745,"Combo 4 Gói Khăn Ướt Yuniku 90 Tờ Không Hương ( 90 tờ x 4 )",99000,167200,68200,41
TIKI,do-choi-me-be,152469540,"Ghép Hình Lực Lượng Cảnh Sát - Xe Tuần Tra 158 Chi Tiết DK81063",81000,108000,27000,25
TIKI,do-choi-me-be,85239904,"Cuộn Xốp Bọc Cạnh Bàn 2M - Dây Cao Su Che Bịt Cạnh Bàn, Ghế An Toàn Cho Bé",25000,25000,0,0
TIKI,do-choi-me-be,50131768,"Set 12 miếng silicon bọc cạnh, góc bàn bảo vệ bé không bị thương khi va đập",19000,19000,0,0
TIKI,do-choi-me-be,435891,"Sữa Bột Abbott Glucerna Vani 850g",890000,890000,0,0
TIKI,do-choi-me-be,20088701,"Dầu gội Johnson's Baby dịu nhẹ (800ml)",159000,192000,33000,17
TIKI,do-choi-me-be,79672168,"Sữa Bột Enfagrow Premium Toddler Hương Sữa Tự Nhiên cho trẻ 1-3 tuổi (907g)",691000,691000,0,0
TIKI,nha-cua-doi-song,182131031,"Ghế Hộp Đựng Đồ Đa Năng, Thùng Đựng Đồ Kiêm Ghế Ngồi - chất liệu khung gỗ nhân tạo Chịu Lực 150kg made in Việt Nam",190000,299000,109000,36
TIKI,nha-cua-doi-song,217145037,"Giỏ Nhựa Đựng Đồ Đa Năng Có Nắp Đậy Cao Cấp Deli - Đựng Sách Vở Đồ Cá Nhân Mỹ Phẩm Quần Áo Chăn Gối Ga Mền - Nhiều Size, Kích Cỡ Lớn Nhỏ , Có Tay Cầm, Phong Cách Nhật Bản Đơn Giản, Tiện Dụng, Vật Liệu An Toàn",63000,100800,37800,38
TIKI,nha-cua-doi-song,129379800,"Giường Ngủ Gấp Gọn Văn Phòng Và Gia Đình Thông Minh Đa Năng 1 Tầng, Giường Xếp Có Thể Làm Giường Trong Bệnh Viện Dành Cho Bệnh Nhân - Hàng Chính Hãng",1755000,2145000,390000,18
TIKI,nha-cua-doi-song,163543251,"Nệm Bông Gòn Xuất Nhật, Nệm Trải Sàn Tiện Lợi, Đệm Văn Phòng Size 1m x 2m; 1m2 x 2m; 1m4 x 2m; 1m6 x2m và 1m8 x2m",240000,240000,0,0
TIKI,nha-cua-doi-song,161455624,"bóng đèn led 50W siêu sáng có ",39000,39000,0,0
TIKI,nha-cua-doi-song,88785294,"Đèn bàn Bảo vệ Thị lực       Model: RD-RL-24.V2 5W",225720,250800,25080,10
TIKI,nha-cua-doi-song,54778238,"Combo 10 móc nhựa đen treo quần áo tiện dụng bền đẹp",80000,80000,0,0
TIKI,nha-cua-doi-song,189491948,"Kệ gia vị, Kệ đựng gia vị nhà bếp, Kệ gia vị đa năng",250000,250000,0,0
TIKI,nha-cua-doi-song,119363942,"Ấm pha trà thủy tinh chịu nhiệt lõi lọc inox 304 cao cấp",94000,94000,0,0
TIKI,nha-cua-doi-song,163645078,"Hộp Nhựa Đựng Thực Phẩm Tủ Lạnh 2 Lớp Có Khóa Thoát Khí, Dễ Dàng Bảo Quản Rau Củ, Siêu Tiện Dụng",65000,65000,0,0
TIKI,nha-cua-doi-song,171590605,"Tủ nhựa TABI-L cao cấp size lớn mặt ốp mica chính hãng Nhựa Duy Tân",1410000,1600000,190000,12
TIKI,nha-cua-doi-song,144450194,"Bộ Tua Vít Đa Năng 24 Chi Tiết Chất Liệu Thép Từ Tính Cao Cấp Dùng Để Sửa Chữa Máy Mọc, Điện Tử Cỡ Nhỏ",37800,37800,0,0
TIKI,nha-cua-doi-song,10604175,"Ổ cắm Điện Quang ĐQ ESK 2W.SM750SL (5 lỗ 3 chấu dây 2 mét màu Trắng Đỏ)",190960,238700,47740,20
TIKI,nha-cua-doi-song,13571023,"Bộ Sạc Pin DP-B02 Kèm 4 Pin Tiểu Sạc AA 1200mAh AZONE",78900,78900,0,0
TIKI,nha-cua-doi-song,69500507,"Áo mưa cánh bướm trẻ em Rando Pocho dành cho các bé có độ tuổi từ (2 tuổi đến 12 tuổi) tương đương với các size từ số 1 đến số 5",54000,54000,0,0
TIKI,nha-cua-doi-song,57763337,"BÌNH ĐỰNG NƯỚC VỎ LÚA MẠNH AN TOÀN, CAO CẤP IN HÌNH XƯƠNG RỒNG, TOTORO (Giao Hàng Theo Mẫu Ngẫu Nhiên)",10000,12999,2999,23
TIKI,nha-cua-doi-song,15703213,"Bộ 16 món bát đĩa bằng thủy tinh ngọc Royal Stuart OPAL-C/T Hoa văn CITRON WEAVE / TWILIGHT BOUQUET (Giao màu ngẫu nhiên)",387000,979000,592000,60
TIKI,nha-cua-doi-song,158743936,"Combo 10 gói hạt giống rau ăn lá phổ biến trồng thủy canh - 10 loại khác nhau như hình (chat với shop nếu muốn chọn)",72000,72000,0,0
TIKI,nha-cua-doi-song,135442312,"Keo Siêu Dính Đa Năng Deli - 7ml/ 20ml - Có Thể Dán Trên Mọi Bề Mặt - Phù Hợp Sửa Chữa, Ghép Nối - 7140 / 7149",8700,16200,7500,46
TIKI,nha-cua-doi-song,2909831,"Máy khoan động lực Bosch GSB 550 550W - Tặng bộ phụ kiện FREEDOM 90 chi tiết",1438000,1617000,179000,11
TIKI,nha-cua-doi-song,52599291,"Đèn năng lượng mặt trời cảm biến chuyển động 100 LED siêu sáng pin tách rời chống nước đèn led đèn cảm ứng chuyển động đèn treo tường đèn ngoài trời",94000,139000,45000,32
TIKI,nha-cua-doi-song,169514577,"Dụng Cụ Xay Tiêu Thuỷ Tinh Benchusch",99000,190000,91000,48
TIKI,nha-cua-doi-song,137753122,"Công tắc thông minh ĐIỀU KHIỂN TỪ XA qua wifi HUNONIC DATIC 1 Kênh 500W - Cơ Điện Shop",99000,99000,0,0
TIKI,nha-cua-doi-song,87628025,"Dây Đèn LED Bóng Tròn Năng Lượng Mặt Trời Chống Nước Trang Trí Sân Vườn",260000,260000,0,0
TIKI,nha-cua-doi-song,66647096,"Nệm đa năng Everon New ( màu ngẫu nhiên )",1790000,1790000,0,0
TIKI,nha-cua-doi-song,192688324,"Dụng Cụ Xay Tiêu 2 trong 1 Benchusch",180000,245000,65000,27
TIKI,nha-cua-doi-song,100623179,"Combo 2 Kệ Góc Để Đồ Nhà Tắm INOX SUS304 Dán Tường Gạch Men kèm bộ đinh vít khoan tường - OENON",285000,500000,215000,43
TIKI,nha-cua-doi-song,194498783,"Khăn Tắm Viên Nén Du Lịch 70*140cm Nhỏ Gọn, Siêu Tiện Lợi... Làm Từ Cotton,  Sử Dụng Nhiều Lần",10000,10000,0,0
TIKI,nha-cua-doi-song,125673210," Thớt Inox 2 Mặt Cao Cấp - 01 Mặt Inox 304 01 Mặt Nhựa PP Sử Dụng Đa Năng Cho Nhà Bếp",305000,305000,0,0
TIKI,nha-cua-doi-song,174032615,"Ô Dù Cán Thẳng 2 Tầng - Ô Golf 2 tầng chống tia UV đường kính 145cm - Nhiều Màu",259000,500000,241000,48
TIKI,nha-cua-doi-song,54398878,"Mền trơn du lịch tuyết nhung siêu mịn, chăn ngủ trưa văn phòng êm nhẹ, đắp cực ấm GD287-Menle - Xàm",79418,79418,0,0
TIKI,nha-cua-doi-song,117597640,"Đầu vòi nước tăng áp, vòi rửa chén thông minh chứa hạt lọc bẩn, xoay 360 độ.",9100,9100,0,0
TIKI,nha-cua-doi-song,181361773,"Bàn học gấp gọn, bàn laptop đa năng tùy chỉnh được góc nghiêng giảm đau lưng mỏi mắt - GM55",181000,199000,18000,9
TIKI,nha-cua-doi-song,75131601,"(Loại Tốt) Áo Mưa Cánh Dơi (xẻ tà) KhoNCC - Vải Dù Cao Cấp Loại Lớn 1m4 - Che Kín 2 Người Mùa Mưa - NQL-AoMuaDu (Xanh lá, Xanh Đen, Xanh Dương, Đỏ Đô, Cỏ Úa) - Hàng Chính Hãng",109000,158000,49000,31
TIKI,nha-cua-doi-song,127649036,"Keo Kẻ Mạch Gạch Chà Ron Gạch Cao Cấp Keo Dán Mạch Gạch Siêu Bám Dính Chống Thấm Nước Dung Tích 180ml",69000,75000,6000,8
TIKI,nha-cua-doi-song,127964805,"Máy Đuổi Chuột Gián Muỗi 3in1 Dùng Sóng Siêu Âm Cho Hộ Gia Đình 30-50m2",349000,349000,0,0
TIKI,nha-cua-doi-song,146363272,"Giấy Dán Bếp Decal Giả Vân Đá 3D, Hoa Văn Xinh Xắn Chịu Nhiệt Chống Nước, Chống Dầu Mỡ, Dễ Dàng Lau Chùi",45000,45000,0,0
TIKI,nha-cua-doi-song,49127906,"Bao Da Đựng Đàn Guitar 3 Lớp Yamaha Bag YAB (Túi đựng Acoustic và Classic Ghi-ta, Có 2 quai đeo, Ngăn đựng đồ ) - Bao Acoustic Guitar",149000,149000,0,0
TIKI,nha-cua-doi-song,696894,"Bộ Dây Đàn Guitar Acoustic Alice AW436",74000,74000,0,0
TIKI,nha-cua-doi-song,163582596,"Bút khò bật lửa khò honest thân dài, vi trí hiển thị gas, có chế độ giữ gas và điều chỉnh gas lớn nhỏ tùy ý",153000,170000,17000,10
TIKI,thiet-bi-kts-phu-kien-so,195916596,"Thẻ Nhớ MicroSDXC SanDisk Extreme Pro V30 A2 1TB 200MB/s SDSQXCD-1T00 (New 2022) - Hàng Nhập Khẩu",2990000,2990000,0,0
TIKI,thiet-bi-kts-phu-kien-so,3494769,"Miếng dán màn hình cường lực chống nhìn trộm full màn hình 3D Baseus cho iPhone 7 Plus/ iPhone 8 Plus - Đen - Hàng chính hãng",129999,259998,129999,50
TIKI,thiet-bi-kts-phu-kien-so,11772926,"Cáp chuyển OTG TYPE-C ra USB 3.1 mở rộng kết nối cho điện thoại với USB, chuột, bàn phím, ổ cứng cắm ngoài",10400,10400,0,0
TIKI,thiet-bi-kts-phu-kien-so,81926706,"Bộ Găng tay chơi game cảm ứng bao ngón tay chống mồ hôi chống trượt",4800,4800,0,0
TIKI,thiet-bi-kts-phu-kien-so,45586976,"Đế tản nhiệt COOLING PAD cho laptop - Hàng nhập khẩu",117850,117850,0,0
TIKI,thiet-bi-kts-phu-kien-so,178523954,"Pin dành cho tay cầm chơi game Xbox/ Xbox One S/ Xbox Series X",209000,209000,0,0
TIKI,thiet-bi-kts-phu-kien-so,16117576,"Pin điện thoại  BL-5C dành cho điện thoại 1202;1280;2255;1110;205;C2-00;6630;6681;2700c; ....",49000,49000,0,0
TIKI,thiet-bi-kts-phu-kien-so,108633882,"Củ sạc nhanh Baseus 30W, Củ sạc Baseus Si 30W, Củ sạc Baseus Super Si Quick Charger 30W dùng cho iPhone/ Samsung/ OPPO... (30W, Type C, PD/ QC3.0 Quick charger)",295000,319000,24000,8
TIKI,thiet-bi-kts-phu-kien-so,125594820,"Ốp Lưng ESR CLOUD SOFT Dành Cho iPhone 13 Mini, Iphone 13/ 13 Pro, 13 Pro Max - Hàng Chính Hãng",427500,450000,22500,5
TIKI,thiet-bi-kts-phu-kien-so,161455925,"Ổ Cắm Điện Âm Bàn Tích Hợp Sạc Không Dây",1360000,1360000,0,0
TIKI,thiet-bi-kts-phu-kien-so,135716110,"Cường Lực Camera Dành Cho iPhone - Bảo Vệ Full Cụm Camera",44999,64000,19001,30
TIKI,thiet-bi-kts-phu-kien-so,4594727,"Bộ Chuyển Tín Hiệu 2 CPU Dùng 1 Màn Hình KVM Switch USB Ugreen 30357 - Hàng Chính Hãng",345000,345000,0,0
TIKI,thiet-bi-kts-phu-kien-so,13626136,"Bàn phím số không dây Mini Number Keyboard AZONE",75000,75000,0,0
TIKI,thiet-bi-kts-phu-kien-so,21163509,"Ốp lưng viền dẻo trong sần nhám trắng dành cho iPhone 6 vs iPhone 6s",29000,36990,7990,22
TIKI,thiet-bi-kts-phu-kien-so,141050950,"Hộp Đựng Dành Cho Chuột Logitech MX Master/ Master 2S/ Master 3/ MX Lucas - Hàng Chính Hãng",98000,98000,0,0
TIKI,thiet-bi-kts-phu-kien-so,21078084,"Miếng Lót Chuột, Bàn Di Chuột, mouse pad cỡ lớn (80x30x0.3)",90000,90000,0,0
TIKI,thiet-bi-kts-phu-kien-so,2010041,"Máy Nghe Nhạc Lossless Bluetooth Ruizu D02 8GB (2018)",550000,550000,0,0
TIKI,thiet-bi-kts-phu-kien-so,34495897,"Máy Trợ Giảng 4 IN 1 ROLTON K300 TẶNG Kèm Micro Không Dây Gài Tai AZONE - Hàng Nhập Khẩu",319000,379000,60000,16
TIKI,thiet-bi-kts-phu-kien-so,104069956,"Lót chuột bàn di chuột siêu mềm mịn",5955,5955,0,0
TIKI,thiet-bi-kts-phu-kien-so,178102405,"Bao Da Dạng Ví Dành Cho Samsung  A73, A53, A33, A23, A13 4G Hiệu Hanman Có Ngăn Thẻ- Hàng Chính hãng",115000,115000,0,0
TIKI,thiet-bi-kts-phu-kien-so,147800518,"Gậy chụp ảnh tự sướng Mawa K07 - Tích hợp 3 chân tripod và remote bluetooth chụp từ xa - Hàng chính hãng",98993,138000,39007,28
TIKI,thiet-bi-kts-phu-kien-so,135715950,"Bộ 3 Vòng Bảo vệ Camera iPhone 13Pro, iPhone 13Pro Max - Chống Bụi, Hạn chế vân tay & Mờ Camera - Bảo Vệ Toàn Diện Cho Cụm Camera - Cực Phẩm 2021",66590,94000,27410,29
TIKI,thiet-bi-kts-phu-kien-so,109947285,"Giá đỡ điện thoại để bàn, Máy tính bảng đa năng Hợp Kim Nhôm dành cho tất cả điện thoại thông minh - Hàng Chính Hãng PKCB",82000,179000,97000,54
TIKI,thiet-bi-kts-phu-kien-so,185409734,"Tai nghe Bluetooth Lenovo HQ08 TWS chống nước HiFi Âm nhạc ,chơi game Tai nghe thể thao Bluetooth không dây-Hàng Chính Hãng",272000,289000,17000,6
TIKI,thiet-bi-kts-phu-kien-so,70771922,"Bao da chống sốc cho Samsung Galaxy Tab S7 T870/ T875 thương hiệu DUX DUCIS Domo Series cao cấp - Hàng nhập khẩu",277000,277000,0,0
TIKI,thiet-bi-kts-phu-kien-so,74555237,"Túi Đựng Phụ Kiện 1 Ngăn Chống Nước, Chống Sốc Cao Cấp – Túi Để Phụ Kiện Điện Thoại – Hàng Chính Hãng miDoctor",119000,119000,0,0
TIKI,thiet-bi-kts-phu-kien-so,9678974,"Bộ USB thu Bluetooth 5 in 1 cho dàn amply và loa",58400,58400,0,0
TIKI,thiet-bi-kts-phu-kien-so,49559133,"Miếng Lót Chuột, Bàn Di Chuột, mouse pad anime Kimetsu no Yaiba - Diệt Qủy Cứu Nhân cỡ lớn (80x30x0.3)",90000,90000,0,0
TIKI,thiet-bi-kts-phu-kien-so,72573302,"Ốp lưng dẻo mỏng màu xanh dương dành cho iPhone X / XS  - Hàng chính hãng",39000,45000,6000,13
TIKI,thiet-bi-kts-phu-kien-so,22380700,"Dây 2 Đầu HDMI 3m Unitek - Cáp HDMI 3m Unitek Full HD 4K - Hàng nhập khẩu ",86000,91900,5900,6
TIKI,thiet-bi-kts-phu-kien-so,190707857,"Miếng dán kính cường lực full 3D cho Samsung Galaxy S22 Ultra hiệu Nillkin CP+ Max (Mỏng 0.3mm, Kính ACC Japan, Chống Lóa, Hạn Chế Vân Tay) - Hàng nhập khẩu",232990,232990,0,0
TIKI,thiet-bi-kts-phu-kien-so,160843325,"Ghế game, ghế gaming phiên bản giới hạn, ghế xoay văn phòng mẫu mới nhất năm 2022 có kèm video và ảnh thật",1179000,1179000,0,0
TIKI,thiet-bi-kts-phu-kien-so,100910755,"Đôi loa bass 30 cho loa karaoke và nghe nhạc Hải Triều (hàng chính hãng) 1 cặp ",649000,649000,0,0
TIKI,thiet-bi-kts-phu-kien-so,550407,"Bộ Chuyển Đổi Bluetooth Logitech Receiver - Hàng Chính Hãng",669000,669000,0,0
TIKI,lam-dep-suc-khoe,56018126,"Combo Dầu gội & Dầu xả TRESEMME Salon Rebond dưỡng tóc hư tổn Với Công nghệ Tái kết nối Keratin ngăn gãy rụng đến 98% 640g + 620g",321000,462000,141000,31
TIKI,thiet-bi-kts-phu-kien-so,188543326,"Case Ốp Vỏ Hình Gương sóng Gradient dành cho Airpods 1/2/ Airpods 3/ Airpods Pro- Hàng chính hãng",94050,99000,4950,5
TIKI,lam-dep-suc-khoe,121485349,"[Nhập Coupon giảm ngay 50K]Bàn Chải Điện P/S S100 PRO - Công Nghệ Sóng Âm, Chải Sạch Mảng Bám Tới 10X - Trắng Sáng",852000,1276370,424370,33
TIKI,lam-dep-suc-khoe,66640235,"Combo Dove Phục Hồi Hư Tổn Dầu Gội 640g + Kem Xả 610g",242000,310000,68000,22
TIKI,thiet-bi-kts-phu-kien-so,24633902,"Đầu chuyển Type-C 3.1 ra cổng LAN RJ45 hiệu CHOETECH HUB-R01 cho điện thoại Macbook (Kết nối mạng có dây, thiết kế nhỏ gọn, tốc độ cao) - Hàng chính hãng",329000,329000,0,0
TIKI,thiet-bi-kts-phu-kien-so,99618665,"Đế Sạc Dành Cho Tay Cầm PS5/Playstation 5",248000,248000,0,0
TIKI,thiet-bi-kts-phu-kien-so,51341102,"Bao da kèm bàn phím Bluetooth dành cho iPad Air 2 / iPad 6 Smart Keyboard",338999,338999,0,0
TIKI,thiet-bi-kts-phu-kien-so,15184032,"Bao Da Smart Case Gen2 TPU Dành Cho iPad 9.7 2018 - Hàng nhập khẩu",104999,209998,104999,50
TIKI,lam-dep-suc-khoe,274152730,"Viên uống Canxi Sinh Hoc CAX - Nhập Khẩu Mỹ - BỔ SUNG CANXI GIÚP XƯƠNG CHẮC KHỎE, Chai 30 viên",298000,298000,0,0
TIKI,lam-dep-suc-khoe,22254660,"Combo Dầu Gội, Dầu Xả TRESEMME Keratin Smooth Dưỡng tóc khô xơ rối Công thức chuẩn salon Hydrolyzed Keratin trong Dầu Gội và dầu Xả dưỡng Tóc Vào Nếp Suôn Mượt 640g, 620g",321000,462000,141000,31
TIKI,thiet-bi-kts-phu-kien-so,77403120,"Micro karaoke kèm loa bluetooth Mini, AUX, USB, microSD, FM, TWS - Hàng Chính Hãng",390000,799000,409000,51
TIKI,lam-dep-suc-khoe,632680,"Dầu gội Selsun chống gàu, sạch gàu & hết ngứa da đầu Selsun Anti-Dandruff Shampoo 100ml",84000,99000,15000,15
TIKI,lam-dep-suc-khoe,1634981,"Giấy thấm dầu kiểm soát nhờn, ngừa mụn Acnes Oil Remover Paper 100 tờ",32000,33000,1000,3
TIKI,lam-dep-suc-khoe,99110647,"Bộ Đôi TSUBAKI Sạch Dầu Mát Lạnh (490ml/chai)",299000,418000,119000,28
TIKI,lam-dep-suc-khoe,6874429,"Miếng dán mụn giúp giảm mụn sưng viêm Acnes Clear Patch (24 Miếng)",57000,60000,3000,5
TIKI,lam-dep-suc-khoe,151519665,"Bao cao su cao cấp OZO Feelex Invisible Cool - Hộp 10 bcs",89000,89000,0,0
TIKI,lam-dep-suc-khoe,273879837,"Viên uống Bổ Thận, Giảm Tiểu Đêm KEN (Hộp 60v) - NHẬP KHẨU MỸ - DÙNG ĐƯỢC CHO CẢ NAM, NỮ, NGƯỜI BỊ TIỂU ĐƯỜNG",720000,720000,0,0
TIKI,lam-dep-suc-khoe,121485346,"Bàn Chải Điện P/S S100 PRO Trắng Răng Công Nghệ Sóng Âm Đen Nhám Chải Sạch Mảng Bám Tới 10X 1 Bộ",829000,1276370,447370,35
TIKI,lam-dep-suc-khoe,273879908,"Viên uống Cân Bằng Nội Tiết Tố Nữ CER - NHẬP KHẨU MỸ - CẢI THIỆN DA KHÔ NHĂN, RỤNG TÓC, KHÔ HẠN (Chai 30v)",398000,398000,0,0
TIKI,lam-dep-suc-khoe,273598230,"Máy Tăm Nước Không Dây LocknLock Cordless Oral Irrigator",774000,1263000,489000,39
TIKI,lam-dep-suc-khoe,210966405,"Combo 2 Sữa dưỡng thể Vaseline Gluta-Hya Dưỡng Da Sáng Mịn Sau 7 Ngày Dưỡng sáng chuyên sâu 330 ML",235000,300000,65000,22
TIKI,lam-dep-suc-khoe,2738475,"Bộ 3 Hộp Silcot Bông Trang Điểm (bông tẩy trang) Nhật Bản (82 Miếng/Hộp)",99000,126000,27000,21
TIKI,lam-dep-suc-khoe,22254660,"Combo Dầu Gội, Dầu Xả TRESEMME Keratin Smooth Dưỡng tóc khô xơ rối Công thức chuẩn salon Hydrolyzed Keratin trong Dầu Gội và dầu Xả dưỡng Tóc Vào Nếp Suôn Mượt 640g, 620g",321000,462000,141000,31
TIKI,lam-dep-suc-khoe,25108217,"Sữa rửa mặt ngăn ngừa mụn Acnes Creamy Wash 100g",55400,70000,14600,21
TIKI,lam-dep-suc-khoe,116438272,"Kem Dưỡng Cấp Nước Cho Da Hỗn Hợp Neutrogena Hydro Boost Water Gel",93000,110000,17000,15
TIKI,lam-dep-suc-khoe,68421547,"Combo 2 Dầu gội Romano hương nước hoa 650g/chai",289000,382000,93000,24
TIKI,lam-dep-suc-khoe,274152803,"Viên uống Tăng Đề Kháng MUN – NHẬP KHẨU MỸ (Hộp 30 Viên). TĂNG CƯỜNG ĐỀ KHÁNG - GIẢM NGUY CƠ MẮC BỆNH ĐƯỜNG HÔ HẤP",298000,298000,0,0
TIKI,lam-dep-suc-khoe,212036624,"[CHÍNH HÃNG] Smoothie Tẩy Da Chết Dưỡng Ẩm Toàn Thân Dove đường nâu & hương dừa 298g",169000,199000,30000,15
TIKI,lam-dep-suc-khoe,181097568,"Dầu Tẩy Trang Dưỡng Ẩm Laneige Water Bank Blue HA Cleansing Oil 250ml",850000,850000,0,0
TIKI,lam-dep-suc-khoe,272359857,"Combo Sữa rửa mặt Simple sạch thoáng không chứa xà phòng 150ml+ Nước hoa hồng Simple 200ML  [Chính Hãng Độc Quyền]",263000,292500,29500,10
TIKI,lam-dep-suc-khoe,82721609,"Máy Tăm Nước Không Dây LocknLock Cordless Oral Irrigator ENR156BLU - Màu Xanh Da Trời",749000,1400000,651000,47
TIKI,lam-dep-suc-khoe,158399593,"[CHÍNH HÃNG] Một thùng 300 CÁI khẩu trang 4 lớp KF94 kháng khuẩn, chống bụi mịn, công nghệ 4D Hàn Quốc",210000,320000,110000,34
TIKI,lam-dep-suc-khoe,30689058,"Tinh chất dưỡng trắng da Dermaceutic Pháp - Tri Vita C30",2000000,2000000,0,0
TIKI,lam-dep-suc-khoe,121485346,"Bàn Chải Điện P/S S100 PRO Trắng Răng Công Nghệ Sóng Âm Đen Nhám Chải Sạch Mảng Bám Tới 10X 1 Bộ",829000,1276370,447370,35
TIKI,lam-dep-suc-khoe,87913382,"Tinh Dầu Xông Phòng Nguyên Chất, Tự Chọn Mùi | Chính Hãng, Có Kiểm Định Chất Lượng | Tinh Dầu TIDAMO Xông Thơm Phòng, Khử Khuẩn, Bảo Vệ Sức Khỏe và Đuổi Muỗi",38000,148000,110000,74
TIKI,lam-dep-suc-khoe,1672157,"Bao cao su Durex Invisible Extra Thin Extra Sensitive 1 Hộp 10 Bao",215000,317000,102000,32
TIKI,lam-dep-suc-khoe,193879341,"Gel bôi trơn Feelex Lubricant Cool mát lạnh, gấp đôi độ trơn - Lọ 250ml",82000,150000,68000,45
TIKI,lam-dep-suc-khoe,66640235,"Combo Dove Phục Hồi Hư Tổn Dầu Gội 640g + Kem Xả 610g",242000,310000,68000,22
TIKI,lam-dep-suc-khoe,460943,"Bộ Đôi Nước Súc Miệng Hương Bạc Hà Listerine Cool Mint (750ml/ Chai) - 8850007800071",215000,326000,111000,34
TIKI,lam-dep-suc-khoe,46179013,"Máy Massage Cầm Tay KINGTECH KH-320 - 6 Cấp Độ, Hỗ Trợ Mát Xa Chuyên Sâu, Giảm Đau Cơ, Cứng Khớp - Quà Tặng Cho Sức Khỏe",550000,950000,400000,42
TIKI,lam-dep-suc-khoe,767101,"Bao cao su Durex Kingtex 12 bao",118000,196000,78000,40
TIKI,lam-dep-suc-khoe,35761444,"Hộp Khẩu Trang 3D Mask Unicharm Nhật Bản Ngăn Ngừa Khói Bụi Chống Ô Nhiễm (100 miếng)",260000,315000,55000,17
TIKI,lam-dep-suc-khoe,1672153,"Bao cao su Durex Performa 12 bao",219000,308000,89000,29
TIKI,lam-dep-suc-khoe,1313871,"Kem chống nắng Sunplay cực mạnh dạng sữa Sunplay Super Block SPF 81, PA++++ 30g",83500,103000,19500,19
TIKI,lam-dep-suc-khoe,10071383,"Sữa Tắm Lifebuoy Detox Và Sạch Sâu Khỏi Bụi Mịn Pm2.5 Detox Bảo Vệ Khỏi Vi Khuẩn Gây Mụn Cơ Thể Matcha & Khổ Qua Chai 800G",149000,195000,46000,24
TIKI,lam-dep-suc-khoe,93078800,"Combo 2 Nước rửa tay Lifebuoy bạc bảo vệ túi 400g",108000,118000,10000,8
TIKI,lam-dep-suc-khoe,169246554,"(Vải tốt) Thùng 300 cái Khẩu Trang KF94 4D SKY MASK Hàn Quốc - Chống Bụi Mịn Và Kháng Khuẩn (Chọn màu)",199000,199000,0,0
TIKI,lam-dep-suc-khoe,111292323,"Sữa Tắm Lifebuoy Detox Và Sạch Sâu Khỏi Bụi Mịn Pm2.5 Và Vi Khuẩn Tràm Trà Muối Hồng 100% Từ Thiên Nhiên Chai 800G",156000,195000,39000,20
TIKI,lam-dep-suc-khoe,190489303,"Khẩu trang KF94 - 4D trẻ em, từ 3 đến 11 tuổi, nhiều họa tiết, kháng virus dễ thở, không đau tai",8000,8000,0,0
TIKI,lam-dep-suc-khoe,74450527,"Máy Xông Tinh Dầu Cao Cấp Tặng 3 Chai Tinh Dầu Sả Chanh + Bạc Hà + Quế. Máy Khuếch Tán Tinh Dầu Có Remote Điều Khiển Từ Xa Chuyên Dụng Xông Tinh Dầu",269000,596000,327000,55
TIKI,lam-dep-suc-khoe,121485349,"[Nhập Coupon giảm ngay 50K]Bàn Chải Điện P/S S100 PRO - Công Nghệ Sóng Âm, Chải Sạch Mảng Bám Tới 10X - Trắng Sáng",852000,1276370,424370,33
TIKI,lam-dep-suc-khoe,796867,"Bao cao su Durex Invisible Extra Thin Extra Sensitive 1 Hộp 3 Bao",80000,95000,15000,16
TIKI,lam-dep-suc-khoe,15795542,"Sữa Tắm Trắng Da Giữ Ẩm Hatomugi Nhật Bản 800ml",95200,119700,24500,20
TIKI,lam-dep-suc-khoe,171564906,"Dầu gội Selsun chống gàu, sạch gàu & hết ngứa da đầu Selsun Anti-Dandruff Shampoo 250ml",175000,223000,48000,22
TIKI,lam-dep-suc-khoe,632681,"Dầu xả Selsun dưỡng tóc dành cho tóc gàu Selsun Anti-Dandruff Conditioner 100ml",52100,58000,5900,10
TIKI,lam-dep-suc-khoe,78280482,"Bộ 2 Chai Nước Súc Miệng Listerine Giúp Hơi Thở Thơm Mát Cool Mint Zero Alcohol 750mlx2",252000,326000,74000,23
TIKI,lam-dep-suc-khoe,57243183,"Máy Tăm Nước Vệ Sinh Răng Miệng Xiaomi Mijia MEO701 - Hàng Nhập Khẩu",559000,889000,330000,37
TIKI,lam-dep-suc-khoe,55915384,"Nước hoa hồng không chứa cồn Neutrogena Alcohol Free Toner 150ml ",128000,133000,5000,4
TIKI,lam-dep-suc-khoe,56018126,"Combo Dầu gội & Dầu xả TRESEMME Salon Rebond dưỡng tóc hư tổn Với Công nghệ Tái kết nối Keratin ngăn gãy rụng đến 98% 640g + 620g",321000,462000,141000,31
TIKI,lam-dep-suc-khoe,135077306,"khẩu trang KF94",1000,1000,0,0
TIKI,lam-dep-suc-khoe,2042227,"Bao cao su Durex Invisible Extra Thin Extra Lubricated 1 Hộp 10 Bao",215000,317000,102000,32
TIKI,do-choi-me-be,42802929,"Combo 3 bộ quần áo Bé Gái Nơ Xòe chất vải Tole, lanh 2 da loại 1, mềm, mịn, thoải mái, thoáng mát, nhiều size từ 5-30kg, hàng Việt Nam chất lượng, chính hãng",123000,123000,0,0
TIKI,do-choi-me-be,187618596,"Đồ chơi trẻ em: Xe vệ sinh môi trường điều khiển từ xa DK81091. Màu ngẫu nhiên",225000,300000,75000,25
TIKI,do-choi-me-be,42253094,"Combo 7 món đồ chơi cho bé phát triển trí tuệ",141000,141000,0,0
TIKI,do-choi-me-be,74769720,"Kutieskin 30gr giành cho da bé bị chàm sữa",225000,225000,0,0
TIKI,do-choi-me-be,142339285,"Hộp 50 túi trữ sữa Sunmum Thái Lan 250ml",74000,74000,0,0
TIKI,do-choi-me-be,104850838,"Váy đầm bé gái xanh nhí nhún viền tay - Từ 11kg-45kg - K141",499000,499000,0,0
TIKI,do-choi-me-be,167420710,"Mẫu mới - Balo họa tiết hoạt hình, thời trang, xinh xắn Hàn Quốc cho bé mẫu giáo, nhà trẻ",110000,110000,0,0
TIKI,do-choi-me-be,106006188,"Đồ Chơi Tranh Ghép Hình 3D Bằng Gỗ Nhiều Hình Ngộ Nghĩnh - Phát Triển Trí Tuệ Cho Bé",7500,7500,0,0
TIKI,do-choi-me-be,141905850,"Đồ chơi trẻ em xe đổ rác chạy bằng dây cót - Xe mô hình gôm hốt rác - Quà Tặng Sinh Nhật Cho Bé",149000,149000,0,0
TIKI,do-choi-me-be,94060606,"Quần dài xanh đen học sinh Amazing, lưng thun, xếp 2 ly, dây kéo, form rộng, size từ 20 đến 95kg",101000,160000,59000,37
TIKI,do-choi-me-be,71344672,"Bộ 2 tấm tranh xếp hình 48 mảnh: Baby bus và Heo Pepa. Sản xuất tại Việt Nam.",69000,69000,0,0
TIKI,do-choi-me-be,179805280,"Đồ bơi size đại cho bé trai, cỡ lớn đến 63kg, mẫu cao cấp chất đẹp dày dặn, dáng đẹp phom xịn | BT47",410000,410000,0,0
TIKI,do-choi-me-be,84709888,"Gạc Rơ Lưỡi, Vệ Sinh Răng Miệng Cho Bé Dr Papie (Tách lẻ 10 gói)",33000,33000,0,0
TIKI,do-choi-me-be,161618806,"Ba lô học sinh cấp 1&2 siêu nhẹ chống gù chống nước cao cấp phong cách châu âu",449000,498000,49000,10
TIKI,do-choi-me-be,76198177," Bộ Bài Ma Sõi Ultimate Deluxe Edition 64 Lá Đầy Đủ Chức Năng",60000,100000,40000,40
TIKI,do-choi-me-be,68936268,"Cháo Tươi Ếch Đậu Hà Lan Cây Thị",21600,25000,3400,14
TIKI,do-choi-me-be,80981497,"Bộ bài tây mạ vàng cao cấp, chống nước - Bài lá bằng nhựa PVC - Hàng chính hãng",39000,39000,0,0
TIKI,do-choi-me-be,129584815,"Thảm xốp ghép EVA trải sàn cho bé chất lượng Châu Âu EN71 - Toys House",319000,479000,160000,33
TIKI,do-choi-me-be,41343230,"Vitamin tổng hợp Wellbaby cho bé từ 6 tháng đến 4 tuổi 150ml",230000,335000,105000,31
TIKI,do-choi-me-be,187610227,"Đồ chơi trẻ em: Máy xúc lật điều khiển từ xa  DK81094, Màu ngẫu nhiên",224000,320000,96000,30
TIKI,do-choi-me-be,74922383,"NORIKID PLUS – GIẢI PHÁP HỖ TRỢ CẢI THIỆN BIẾNG ĂN, TÁO BÓN, TĂNG SỨC ĐỀ KHÁNG Ở TRẺ 06 THÁNG -12 TUỔI (HỘP 20 ỐNG)",245000,245000,0,0
TIKI,do-choi-me-be,53989978,"Mô hình nhà DIY Doll House A Cozy Little Courtyard Kèm Hộp nhạc và Mica Chống bụi",799000,999000,200000,20
TIKI,do-choi-me-be,59131835,"Bảng Viết Điện Tử Thông Minh Tự Xóa VNBoard Đa Sắc 12 inch",280000,280000,0,0
TIKI,do-choi-me-be,14330183,"Đồ chơi gỗ giáo cụ Montessori combo 3 bảng lắp ghép hình khôi - TotdepreHH1042",28900,28900,0,0
TIKI,do-choi-me-be,140363010,"Tháp Hà Nội, tháp dời 8 vòng đồ chơi gỗ tự nhiên siêu đẹp ",77000,77000,0,0
TIKI,do-choi-me-be,190541850,"Ghế hơi tập ngồi cho bé chống ngã cao cấp Baby-S, Ghế phao tập ngồi cho bé phong cách Hàn Quốc – SSS031",219000,248999,29999,12
TIKI,do-choi-me-be,52178168,"Gối cho bé bú kê tay Rototo Bebe - Gối bú sữa giúp bố, mẹ đỡ mỏi tay",395000,520000,125000,24
TIKI,do-choi-me-be,122948984,"Đồ chơi Trung Thu - Gậy phát sáng quả cầu pha lê nhiều màu - Đèn Trung Thu cho bé",39000,39000,0,0
TIKI,do-choi-me-be,127585838,"Đồ chơi xúc cát, đi biển - vận động ngoài trời cho bé - Toys House 035",89000,140000,51000,36
TIKI,do-choi-me-be,184603015,"(8-20kg) Váy maxi dây điều chỉnh bé gái TB19 Váy Maxi Đi Biển Cho Bé Váy 2 Dây Đũi Siêu Mềm",95000,95000,0,0
TIKI,do-choi-me-be,131421772,"Nón tai bèo tạo hình dễ thương gồm miếng chắn bụi, miếng chắn có thể tháo rời và điều chỉnh",162500,250000,87500,35
TIKI,do-choi-me-be,180236417,"Cháo Tươi Cá Chẽm Khoai Môn Cây Thị Mở Gói Ăn Ngay 240G",24300,28000,3700,13
TIKI,do-choi-me-be,170494744,"Sữa Bột Hoàng Gia Úc GROW UP MILK POWDER Hỗ Trợ Phát Triển Chiều Cao Cho Trẻ Từ 3-14 Tuổi 500g",890000,890000,0,0
TIKI,do-choi-me-be,194445768,"Dụng cụ lấy ráy tai nhiều đầu sử dụng cổng sạc USB Có Đèn Cho Bé Cao Cấp ",79000,89000,10000,11
TIKI,do-choi-me-be,190726246,"Áo thun ngắn tay, áo thun sát nách ba lỗ không tay, tanktop kiểu Hàn bé trai bé gái 10-38kg",84000,84000,0,0
TIKI,do-choi-me-be,17038421,"BÔNG CẮT 5X5CM - 1KG ",205200,216000,10800,5
TIKI,do-choi-me-be,183354010,"Combo 2 áo dây cho bé gái áo hai dây cho bé thun cotton SG loại đẹp co giãn mềm mịn 10-25kg",95000,95000,0,0
TIKI,do-choi-me-be,142310492,"Túi Dụng Cụ Sakos Poke Dành Cho Bé - Hàng Chính Hãng - Giao Màu Ngẫu Nhiên",46000,55000,9000,16
TIKI,do-choi-me-be,184817101,"Đai đi xe máy cho bé, Đai nịt an toàn cho bé khi ngồi xe máy với 2 tư thế ngồi",75000,75000,0,0
TIKI,do-choi-me-be,123248329,"ÁO DÀI CÁCH TÂN CHO BÉ TRAI - ÁO DÀI NHUNG ĐÁP RỒNG",265000,265000,0,0
TIKI,do-choi-me-be,249521726,"Áo thun bé trai BETOP 100% cotton mềm mại hàng xuất Âu",69000,69000,0,0
TIKI,do-choi-me-be,249272520,"Sách vải cho bé Tiếng anh, đa tương tác kích thích trí não, các giác quan cho bé, an toàn tuyệt đối",59000,59000,0,0
TIKI,do-choi-me-be,113245073,"Canxi cho bé Healthy Care Kids Milk Calcium Úc, Hỗ trợ tăng trưởng chiều cao, hệ thống xương, răng, bé ngủ ngon không trằn trọc đêm - OZ Slim Store",204000,484000,280000,58
TIKI,do-choi-me-be,75424691,"Dây thun cột tóc hình tai thỏ phong cách Hàn Quốc đáng yêu thun co giãn tốt không gây đau khi cột tóc – P147",5000,10000,5000,50
TIKI,do-choi-me-be,191689280,"Đồ chơi trống cho bé Jazz Drum Toyshouse - Đồ chơi âm nhạc cho bé trai và bé gái chính hãng",89000,160000,71000,44
TIKI,do-choi-me-be,38444012,"Bài Tarot Kèm Túi Đựng Bài – Bài Bói Tarot Chính Hãng Amalife - The Rider Waite Deck",69900,69900,0,0
TIKI,do-choi-me-be,100910712,"Bột ăn dặm dinh dưỡng Sữa, Hoa quả rừng HiPP Organic 250g",145000,145000,0,0
TIKI,do-choi-me-be,58804151,"Bột Giặt OMO Đỏ (6kg)",219000,219000,0,0
TIKI,do-choi-me-be,91613941,"Set 3 đồ chơi con quay spinner hình côn trùng vui nhộn cho bé",54400,54400,0,0
TIKI,do-choi-me-be,129710160,"Tắm gội dịu nhẹ 2 in 1 Sakura Pigeon 200ML/700ML",67000,89000,22000,25
TIKI,do-choi-me-be,58722050," Bộ 6 sách vải Song ngữ VIỆT - ANH kích thích thị giác cho bé (PiPô Việt Nam)",115000,115000,0,0
TIKI,do-choi-me-be,114117410,"Búp Bê 30cm 22 Khớp Tỉ Lệ 1/6 Đáng Yêu",88000,88000,0,0
TIKI,do-choi-me-be,180715051,"Combo 5 đồ bộ bé gái, quần áo Mimykid in 3D hoạt hình và trái cây dễ thương, đáng yêu chất liệu thun dày mịn mát, được các bé gái yêu thích, thời trang, set, đồ cho trẻ em, bé gái từ 8kg-28kg - Giao màu ngẫu nhiên",332000,332000,0,0
TIKI,do-choi-me-be,140930706,"Búp Bê Barbie Xinh Xắn Cao 30cm Với 21 Khớp Linh Hoạt - Đồ Chơi Búp Bê Công Chúa Cho Bé Gái",110000,110000,0,0
TIKI,do-choi-me-be,45086636,"Kem dưỡng Aveeno Baby cho da khô và nhạy cảm 227g - 101016747",289000,400000,111000,28
TIKI,do-choi-me-be,180715040,"Combo 3 quần áo bé gái, đồ bộ Mimykid in 3D hoạt hình và trái cây dễ thương, đáng yêu co giãn 4 chiều mềm mại, thấm hút mồ hôi tốt, thời trang, set, bộ đồ, đồ cho trẻ em, bé gái từ 8-28kg (Giao màu ngẫu nhiên)",199000,199000,0,0
TIKI,do-choi-me-be,191683194,"Túi đồ chơi xúc xắc lục lạc cho bé set 5 món Toys House 776-1  giúp bé sơ sinh kích thích phát triển giác quan",109000,170000,61000,36
TIKI,do-choi-me-be,272050409,"Sữa tăng chiều cao cho trẻ biếng ăn từ 1-10 tuổi Úc Pediasure Vanilla giúp phát triển cân đối chiều cao, cân nặng, trí não - QuaTangMe Extaste",859400,1720000,860600,50
TIKI,do-choi-me-be,109084626,"Núm ty ngậm thông khí Philips Avent hình thú (phiên bản Lime) cho trẻ từ 0-6 tháng tuổi _ vỉ đôi",245000,245000,0,0
TIKI,do-choi-me-be,124275111,"Hộp 50 Kẹp Tóc Và Dây Cột Tóc Cho Bé Gái Hình Mèo Kute",59000,63000,4000,6
TIKI,do-choi-me-be,140743265,"1 hộp 12 hủ slime chất nhờn ma quái",45000,45000,0,0
TIKI,do-choi-me-be,109229242,"Nệm cho bé sơ sinh mầm non tiểu học, nệm chống thấm, vải Tencel mềm mịn mát, nhiều họa tiết đáng yêu",199000,199000,0,0
TIKI,do-choi-me-be,44962467,"BỘT NGŨ CỐC 5 THỨ ĐẬU KHÔNG ĐƯỜNG VITAPRO (350 gr)",46000,46000,0,0
TIKI,do-choi-me-be,137119518,"Combo 10 Nút Bịt Ổ Điện An Toàn Cho Bé - Loại 2 Chạc Như Hình",30000,30000,0,0
TIKI,do-choi-me-be,88001896,"Bộ quây cũi nhựa TẶNG bóng, thảm ( GIAO 2H HCM)",1100000,1100000,0,0
TIKI,do-choi-me-be,15444884,"Thảm xốp lót sàn cho bé - chữ cái Pastel (26 miếng, diện tích 2.4m2) Smile Puzzle",344100,370000,25900,7
TIKI,do-choi-me-be,45207940,"Khăn ướt làm sạch tinh khiết dành cho bé Oma&Baby với công thức Chlorhexidine Digluconate kháng khuẩn an toàn, dịu nhẹ trong khăn ( 25 tờ ) - Oma&Baby premium baby wet wipes ( 25 sheets per package)",16150,19000,2850,15
TIKI,do-choi-me-be,55771564,"Viên dầu cá bổ sung DHA cho trẻ thông minh, mắt sáng tinh anh Bioisland DHA For Kids nhập khẩu Úc",371000,475000,104000,22
TIKI,do-choi-me-be,170753976,"[TẶNG QUÀ] Ti Ngậm, Ti Giả BIBS Chính Hãng Đan Mạch Cao Cấp, Chất Liệu Silicon An Toàn Cho Bé Từ 0-3 Tuổi, Tặng Kèm Hộp Đựng Ti",199000,199000,0,0
TIKI,do-choi-me-be,84667516,"Bộ Lấy Ráy Tai Có Đèn LED INOX Cao Cấp - Lấy Ráy Tai Trẻ Em An Toàn, Tiện Lợi, Vệ Sinh ,Tặng Kèm + 2 Pin AAA + 3 Pin Cúc Áo [ Video Sản Phẩm ]",39999,39999,0,0
TIKI,do-choi-me-be,2791837,"Cốt nghệ hạ thổ dưỡng trắng body, sạch thâm rạn, thơm tho body sau sinh Wonmom 200ml",225000,250000,25000,10
TIKI,do-choi-me-be,188128745,"Đồ chơi trẻ em: Xe ô tô mô hình hợp kim chống bạo động DK 81104. Kiểu dáng, mẫu xe, màu sắc ngẫu nhiên.",93750,125000,31250,25
TIKI,do-choi-me-be,50218043,"Đồ Chơi Siêu Xe Điều Khiển Từ Xa Veyron Sport DK81001 - Màu Xanh",225000,250000,25000,10
TIKI,do-choi-me-be,113234813,"DHA cho bé từ 4 tháng - 12 tuổi Healthy Care Kids High Strength  - Úc, Giúp trẻ phát triển trí tuệ, thông minh, mắt sáng khỏe - QuaTangMe Extaste",238400,482000,243600,51
TIKI,do-choi-me-be,249161079,"Núm ty Cổ Rộng Wesser S/M/L (2 cái/hộp)",100050,115000,14950,13
TIKI,do-choi-me-be,26274580,"Nước xông tắm sau sinh Dao'spa mama người Dao đỏ 750ml - DK Pharma",350000,350000,0,0
TIKI,do-choi-me-be,54619198,"Cũi em bé bằng gỗ đã qua hấp sấy, cũi gỗ với các nan bo tròn cạnh cùng với 4 bánh xe có khóa an toàn cho bé yêu - giá xưởng",655000,655000,0,0
TIKI,do-choi-me-be,147987171,"[HÀNG CAO CẤP - CÓ CHỌN SIZE] Cờ Cá Ngựa Nam Châm, Bộ Cờ Cá Ngựa Cao Cấp Kích Thước 28x28 và 38x38cm - Chính Hãng dododios",84000,84000,0,0
TIKI,do-choi-me-be,48490790,"Bộ xếp hình 2 tấm 48 mảnh ghép khổ A3, Xì trum và Doremon . Tia Sáng Việt Nam. Đồ chơi trí tuệ cho bé từ 3 tuổi. Ký hiệu: Xếp hình.",78000,78000,0,0
TIKI,do-choi-me-be,98631378,"Đồ chơi xếp hình, lắp ráp Qman 1928 - Truy bắt tội phạm trên biển (473 mảnh ghép)",279000,339000,60000,18
TIKI,thiet-bi-kts-phu-kien-so,77868208,"Webcam HXSJ S4 HD 1080P USB3.0 2.0 Có Thể Điều Chỉnh 360° Kèm Mic Cho Cuộc Gọi Video - Hàng Chính Hãng",399000,699000,300000,43
TIKI,thiet-bi-kts-phu-kien-so,52087768,"Sim 4G MAY V77 (Vinaphone-Itelecom) gói cước 90GB/ tháng tốc độ cao – Hàng chính hãng - Giao mẫu ngẫu nhiên",79000,79000,0,0
TIKI,thiet-bi-kts-phu-kien-so,193006708,"Định vị GPS không dây Thông minh FA81 Dành cho Trẻ em, Học sinh, Người già, Hàng hóa, Ô tô, Xe máy Hàng nhập khẩu",1255000,1255000,0,0
TIKI,thiet-bi-kts-phu-kien-so,15170396,"Máy Nghe Nhạc MP3 Ruizu X02 Bộ Nhớ Trong 8GB AZONE - Hàng Nhập Khẩu",445000,445000,0,0
TIKI,thiet-bi-kts-phu-kien-so,136096397,"Ốp lưng da cổ điển dành cho iPhone 11 / 12 / 13 / 11 Pro / 12 Pro / 13 Pro / 11 Pro Max / 12 Pro Max / 13 Pro Max / 12 Mini / 13 Mini - Hàng chính hãng",149000,250000,101000,40
TIKI,thiet-bi-kts-phu-kien-so,127202818,"Miếng Dán PPF Full viền dành cho iphone 13 pro max / 13 pro / 13 / 13 mini / 12 pro max/ 12 pro / 12 / 11pro max / 11 / 11pro max",27000,69986,42986,61
TIKI,thiet-bi-kts-phu-kien-so,59549110,"Cáp sạc nhanh hiển thị đèn LED dành cho iphone dây dù 1,2M siêu bền ( Màu ngẫu nhiên )",29000,50000,21000,42
TIKI,thiet-bi-kts-phu-kien-so,21572053,"THẢM DA TRẢI BÀN LÀM VIỆC, TẤM LÓT CHUỘT, MIẾNG DI CHUỘT KHỔ LỚN HAI MẶT 120 X 60 CM",279000,279000,0,0
TIKI,thiet-bi-kts-phu-kien-so,52049435,"Bút cảm ứng stylus thông minh hiệu WIWU Pencil Magic Gen 2 cho màn hình cảm ứng iPad / iPhone / Samsung Xiaomi Huawei Oppo Sony LG (cảm ứng siêu mượt mà, dung lượng pin cao, thiết kế thời trang) - Hàng nhập khẩu - Trắng",639000,639000,0,0
TIKI,thiet-bi-kts-phu-kien-so,75574549,"Tai nghe Bluetooth nhét tai không dây có hộp sạc - Tai nghe âm thanh nổi 3D có tính năng chống ồn - IPX5 - Chống nước - Hàng Chính Hãng PKCB",250000,500000,250000,50
TIKI,thiet-bi-kts-phu-kien-so,119404695,"Đồng Hồ Định Vị Trẻ Em Y92 ️️ Hỗ Trợ Tiếng Việt, Kháng Nước IP67 - Lắp Sim Nghe Gọi, Định Vị LPS, 4G/WIFI",399000,399000,0,0
TIKI,thiet-bi-kts-phu-kien-so,49060453,"Loa Bluetooth Bose Soundlink Mini II Special Edition - Hàng Chính Hãng",4290000,4990000,700000,14
TIKI,thiet-bi-kts-phu-kien-so,550418,"Loa Vi Tính Logitech Z333 2.1 80W - Hàng Chính Hãng",1890000,1890000,0,0
TIKI,thiet-bi-kts-phu-kien-so,73936929,"Bộ Củ Sạc Nhanh 30W PD 3.0, 2 Cổng Sạc Và Cáp Type-C To Light.ning Dài 1m Chứng Nhận MFI RAVPower RP-PC144 Dành Cho iPhone, Cho iPad - Hàng Chính Hãng",459000,459000,0,0
TIKI,thiet-bi-kts-phu-kien-so,58207084,"Tai nghe nhét tai Hoco M64 Melodious jack kết nối 3.5, âm thanh tuyệt vời - HÀNG NHẬP KHẨU",82500,82500,0,0
TIKI,thiet-bi-kts-phu-kien-so,59044202,"Thẻ nhớ MicroSD Kioxia 32GB Class 10 - Hàng Nhập Khẩu",99000,99000,0,0
TIKI,thiet-bi-kts-phu-kien-so,149437533,"Bao da Cover cho Kindle Paperwhite 5 - Họa tiết vải, ốp sau PVC, có kẹp tay giữ máy",160000,160000,0,0
TIKI,thiet-bi-kts-phu-kien-so,202465273,"Bàn Phím Gaming Cơ RAPOO V500Pro Thiết Kế Cá Tính ( Rapoo V500 Pro ) - Hàng Chính Hãng",699000,699000,0,0
TIKI,thiet-bi-kts-phu-kien-so,32399542,"Lót Chuột Tròn Có Kê Tay Chống Chai Họa Tiết Dễ Thương 18 x 23 cm",45220,45220,0,0
TIKI,thiet-bi-kts-phu-kien-so,54609191,"Túi Chống Sốc Dành Cho Ipad Pro 11 inch Chống Thấm Nước, Chống Xước, Bụi Bẩn Hàng Chính Hãng Helios",99000,99000,0,0
TIKI,thiet-bi-kts-phu-kien-so,15186378,"USB OTG SanDisk Ultra Dual 128GB Type-C USB 3.1 DDC2 SDDDC2-128G-G46 - Hàng Chính Hãng",369000,389000,20000,5
TIKI,thiet-bi-kts-phu-kien-so,127930319,"Ốp lưng dành cho iPhone 13 Pro Max Memumi mỏng trong suốt (không ố màu) - Hàng nhập khẩu",87990,167000,79010,47
TIKI,thiet-bi-kts-phu-kien-so,126075524,"Củ sạc nhanh 30W Remax RP-U82 chuẩn kép QC+PD - Hàng chính hãngg",316500,390000,73500,19
TIKI,thiet-bi-kts-phu-kien-so,140220861,"Tai nghe chụp tai bluetooth Cute Cat V2, tai nghe mèo không dây siêu dễ thương có đèn led đổi màu cực đẹp, tai mèo đáng yêu có mic đàm thoại cao cấp",369000,369000,0,0
TIKI,thiet-bi-kts-phu-kien-so,57656568,"Miếng Lót Chuột Da 2 mặt ( Mouse pad ) 270x210mm",42800,42800,0,0
TIKI,thiet-bi-kts-phu-kien-so,14096858,"Bút trình chiếu VP 101",90000,90000,0,0
TIKI,thiet-bi-kts-phu-kien-so,134522531,"Ốp Lưng dành cho Google Pixel 7a/7/7 Pro/6/6 Pro RINGKE Fusion - Hàng Chính Hãng",243000,243000,0,0
TIKI,thiet-bi-kts-phu-kien-so,140323745,"Tai Nghe Dây Nhét Tai Chống Ồn XSmart X6 Âm Thanh Siêu Bass Nghe Nhạc, Xem Phim, Chơi Game Cực Đã Tích Hợp Mic Lọc Âm, jack 3.5 - Hàng Chính Hãng",169000,169000,0,0
TIKI,thiet-bi-kts-phu-kien-so,138226190,"Cáp HDMI dài 3m cao cấp hỗ trợ Ethernet + 4k 2k chính hãng Ugreen 10108 10109 - Hàng chính hãng",95000,95000,0,0
TIKI,thiet-bi-kts-phu-kien-so,162144193,"Ốp lưng chống sốc trong suốt cho Samsung Galaxy Note 9 hiệu Likgus Crashproof giúp chống chịu mọi va đập - hàng nhập khẩu",93500,93500,0,0
TIKI,thiet-bi-kts-phu-kien-so,21325869,"Miếng Lót Chuột, Bàn Di Chuột, mouse pad anime One Piece cỡ lớn (80x30x0.3)",87000,87000,0,0
TIKI,thiet-bi-kts-phu-kien-so,97319439,"Ốp lưng da kính cao cấp dành cho iPhone 12 Mini / 12 / 12 Pro / 12 Pro Max - Hàng chính hãng",149000,199000,50000,25
TIKI,thiet-bi-kts-phu-kien-so,2462825,"Chuột game không dây Lightspeed Logitech G304 - Cảm biến Hero, 12k DPI, nhẹ, 6 nút lập trình, on-board memory, pin 250h - Hàng chính hãng",850000,850000,0,0
TIKI,thiet-bi-kts-phu-kien-so,138226961,"Giá đỡ điện thoại dán tường khi sạc MW5 kiêm khay đựng remote ( Màu ngẫu nhiên) Hàng chính hãng",7899,7899,0,0
TIKI,thiet-bi-kts-phu-kien-so,191757014,"Cáp sạc nhanh đa năng Remax RC-190 - Hỗ trợ sạc nhanh lên đến 60W - Hàng Chính Hãng",219000,219000,0,0
TIKI,thiet-bi-kts-phu-kien-so,184100707,"Ốp lưng chống sốc trong suốt cho Samsung Galaxy S21 FE hiệu Likgus Crashproof giúp chống chịu mọi va đập - hàng nhập khẩu",94049,94049,0,0
TIKI,thiet-bi-kts-phu-kien-so,190703528,"Dây đeo Magnetic Silicone Strap Dành Cho Apple Watch- Hàng chính hãng",180500,190000,9500,5
TIKI,thiet-bi-kts-phu-kien-so,183719378,"Kính cường lực 21D full màn hình dành cho Samsung A03 /A13 4g 5g / A23/ A33",25000,25000,0,0
TIKI,thiet-bi-kts-phu-kien-so,25325318,"Giá Đỡ Điện Thoại Để Bàn Hình Ghế Thời Trang - Giao Màu Ngẫu Nhiên",6761,6761,0,0
TIKI,thiet-bi-kts-phu-kien-so,6610413,"Đầu jack chuyển đổi âm thanh từ cổng 3.5mm cái sang cổng 6.5mm đực chính hãng UGREEN 20503 - Hàng chính hãng",56000,56000,0,0
TIKI,dien-gia-dung,31252978,"Lẩu Điện Nagakawa NAG1902 (4.0 Lít) - Hàng Chính Hãng",604000,1070000,466000,44
TIKI,dien-gia-dung,126979955,"Máy sấy tóc Philips BHD500/00 - Hàng Chính Hãng",890000,984000,94000,10
TIKI,dien-gia-dung,106740604,"Quạt Kẹp Tích Điện Yoobao F04 Mini Pin Siêu Khủng 6400mah Thoải Mái 2 Ngày Với 4 Tốc Độ - Hàng Chính Hãng",350000,350000,0,0
TIKI,dien-gia-dung,691584,"Lò Vi Sóng Tráng Men Có Nướng Samsung MG23K3515AS/SV (23 lít) - Hàng Chính Hãng",2090000,2890000,800000,28
TIKI,dien-gia-dung,57900412,"Nồi cơm cao tần Toshiba RC-10IP1PV (1 Lít) - Hàng Chính Hãng",3600500,3600500,0,0
TIKI,dien-gia-dung,186741174,"Máy Kẹp Sandwich Cao Cấp Nướng Siêu Nhanh Chỉ 3 Phút, Máy Nướng Bánh Mì Đa Năng Chống Dính Tuyệt Đối, Chiên Trứng, Nướng Thịt - Hàng Chính Hãng",495000,495000,0,0
TIKI,dien-gia-dung,81387722,"Cửa thông hơi gắn tường đôi 4513DP- Hàng nhập khẩu",180000,180000,0,0
TIKI,dien-gia-dung,70671961,"Tủ sấy quần áo chính hãng cao cấp ",795000,795000,0,0
TIKI,dien-gia-dung,20659766,"Bếp Gas Mini Cao Cấp NaMilux PL-1911PF-Hàng Chính Hãng (Giao Màu Ngẫu Nhiên)",259000,259000,0,0
TIKI,dien-gia-dung,108279986,"Máy hút bụi diệt khuẩn giường nệm Mamibot Uvlite100 - Hàng chính hãng",1980000,1980000,0,0
TIKI,dien-gia-dung,43547272,"Máy Cạo Râu Kemei KM-2801 Dùng Sạc Có Thể Cạo Râu Khô Và Nước và Kem Cạo Râu",199000,220000,21000,10
TIKI,thiet-bi-kts-phu-kien-so,53727656,"Micro karaoke không dây màn hình LCD Zansong V12 (hàng nhập khẩu)",220000,220000,0,0
TIKI,dien-gia-dung,124015743,"Nồi cơm điện TOSHIBA RC-18NMF-WT Thái Lan Hàng nhập khẩu",2150000,2150000,0,0
TIKI,dien-gia-dung,10005110,"Máy Hút Mùi Bếp Âm Tủ 7 Tấc KAFF KF-TL70H - Hàng Chính Hãng",2490000,2490000,0,0
TIKI,thiet-bi-kts-phu-kien-so,21154823,"Ốp lưng viền dẻo đen cao cấp giành cho iPhone XS Max",18000,18000,0,0
TIKI,thiet-bi-kts-phu-kien-so,197546361,"Bass loa 4 tấc từ 140 côn 51 Hải Triều (hàng chính hãng) 1 cặp ",800000,800000,0,0
TIKI,dien-gia-dung,119450056,"Tông đơ cắt tóc chấn viền DL 1069 nhỏ gọn.",144998,144998,0,0
TIKI,thiet-bi-kts-phu-kien-so,197668727,"Ốp lưng cho samsung Z flip 3 - Z Flip 4 - ZFlip3 - ZFlip4 - Z Flip3 - Z Flip4",284050,299000,14950,5
TIKI,dien-gia-dung,128817707,"Máy làm sữa hạt mini Snapbee SK-205VN- dung tích 300ml 5 chức năng tiện lợi - Hàng chính hãng",1150000,1150000,0,0
TIKI,dien-gia-dung,132847950,"Bếp Gas Dương Đôi Kangaroo KG8G1C - Hàng Chính Hãng",594000,1120000,526000,47
TIKI,thiet-bi-kts-phu-kien-so,128677420,"Bao Da dành cho iPad Pro 12.9 2021 M1 MUTURAL Y-Type With Pencil Holder - Hàng Nhập Khẩu",531000,590000,59000,10
TIKI,dien-gia-dung,74775657,"Nồi cơm điện mini 1.2L Mini RC nấu cơm làm bánh nấu cháo cho 1-2 người nấu cơm tại văn phòng bệnh viện",245000,338000,93000,28
TIKI,dien-gia-dung,37455760,"Máy Làm Sữa Hạt Đa Năng Bluestone SMB-7329 (1.3 Lít) - Hàng Chính Hãng",1999000,1999000,0,0
TIKI,dien-gia-dung,12878026,"Bộ điếu inox hồng ngoại fi90mm thay thế cho các dòng bếp cùng kích thước ( trắng ) - Hàng chính hãng",89000,89000,0,0
TIKI,thiet-bi-kts-phu-kien-so,8441779,"Ốp Lưng Blackberry Key2 / Key2 LE Siêu Mỏng",141000,149000,8000,5
TIKI,dien-gia-dung,154241416,"Máy hút bụi lau nhà airbot iClean Pro tích hợp tự động giặt Dẻ, 3 công việc trong 1, hút và lau chuyên sâu, hàng chính hãng",6290000,6290000,0,0
TIKI,thiet-bi-kts-phu-kien-so,13944218,"Micro Hội Nghị Cao Cấp",184000,217000,33000,15
TIKI,thiet-bi-kts-phu-kien-so,48056587,"Bao da iPad pro 10.5 2017/ ipad air 3 10.5 2019  KAKU_ hàng nhập khẩu",119000,119000,0,0
TIKI,thiet-bi-kts-phu-kien-so,143660812,"Ốp điện thoại chống sốc cho Samsung Galaxy S21 S20 FE Ultra S10 Lite S9 S8 Plus S10E S7 S20+ S10+ S9+ S8+_B020",30000,30000,0,0
TIKI,dien-gia-dung,3576359,"Cây Nước Nóng Lạnh Toshiba RWF-W1664TV(K1) 670W - Hàng chính hãng",2750000,3990000,1240000,31
TIKI,dien-gia-dung,21030759,"Máy hàn miệng túi nilon đường hàn rộng 5mm, dài 200mm",295000,295000,0,0
TIKI,thiet-bi-kts-phu-kien-so,91190426,"Cáp sạc Light/ning MFI UGREEN US155 US199 US291 cho iPhone / iPad / iPod dòng 2.4A dài 1m 2m - Hàng chính hãng",235000,305000,70000,23
TIKI,dien-gia-dung,133226104,"Máy Uốn Tóc Mini, Máy Duỗi Tóc Mini Tạo Kiểu Nhỏ Gọn Có Hộp Đựng Xinh Xắn",39000,39000,0,0
TIKI,thiet-bi-kts-phu-kien-so,10727171,"Cổng chuyển/Hub USB Type-C ra USB Type-A 2.0 Baseus - Hàng Chính Hãng",88499,88499,0,0
TIKI,dien-gia-dung,38546098,"Máy Xay Thịt Mini Bear - Hàng chính hãng",322600,322600,0,0
TIKI,thiet-bi-kts-phu-kien-so,33578970,"Găng Tay Họa Sĩ Dùng Với Bảng Vẽ Điện Tử, Tablet, Vẽ Tranh Giấy - Hàng nhập khẩu",120000,120000,0,0
TIKI,thiet-bi-kts-phu-kien-so,20600634,"Ốp lưng da cao cấp dành cho điện thoại iPhone 7 Plus",129000,149000,20000,13
TIKI,dien-gia-dung,3071301,"Đầu Lọc Nước Trực Tiếp Tại Vòi Eurolife EL-LS-D10 (Trắng) - Hàng Chính Hãng",561000,660000,99000,15
TIKI,dien-gia-dung,181981611,"Tăng Đơ Cắt Tóc Cho Bé Mini Và Cả Gia Đình Full Phụ Kiện 9 Món",269000,269000,0,0
TIKI,dien-gia-dung,38646906,"MÁY PHUN SƯƠNG VÂN GỖ MINI TẶNG KÈM LỌ TINH DẦU",79000,79000,0,0
TIKI,thiet-bi-kts-phu-kien-so,22269322,"1 Đôi loa rời vi tính",88000,88000,0,0
TIKI,dien-gia-dung,367565,"Bếp Gas Hồng Ngoại Soho 899HG - Hàng chính hãng",389000,389000,0,0
TIKI,thiet-bi-kts-phu-kien-so,138940950,"Ốp lưng dành cho Iphone 13 Mini - Iphone 13 - Iphone 13 Pro -  Iphone 13 Pro Max - Tranh Hoa Nền Trắng",45000,55000,10000,18
TIKI,thiet-bi-kts-phu-kien-so,48601451,"Nút tai nghe silicone",10000,10000,0,0
TIKI,dien-gia-dung,104952599,"Nồi Cơm Điện Tử Perfect PF-C308 (1.8 Lít) - Hàng Chính Hãng",595000,599000,4000,1
TIKI,thiet-bi-kts-phu-kien-so,74235841,"Bao Da Case Cover Dành Cho iPad Pro 11 inch (2020) / iPad Air 4 (10.9 inch) / iPad Pro 12.9 inch (2020) Có Khe Cắm Apple Pencil - Hàng Chính Hãng Meliya accessories",177362,300000,122638,41
TIKI,thiet-bi-kts-phu-kien-so,57956720,"Hub Type-c HDMI cho Samsung Dex hỗ trợ sạc và usb 3.0",91900,91900,0,0
TIKI,thiet-bi-kts-phu-kien-so,162371779,"Dây cáp sạc nhanh 25w Type C to Type C 2 đầu USB C độ dài 1m chuẩn PD Handtown - Hàng Chính Hãng",125000,125000,0,0
TIKI,thiet-bi-kts-phu-kien-so,32866408,"Đồng hồ thông minh định vị trẻ em Wonlex KT04 - Hàng Nhập Khẩu",890000,890000,0,0
TIKI,dien-gia-dung,52523664,"Ấm điện đun nước 5 lít ấm siêu tốc có còi báo khi sôi tiết kiệm điện",285000,285000,0,0
TIKI,dien-gia-dung,50392320,"Quạt không cánh siêu mát an toàn CR-305 để bàn hoặc treo tường",1480000,1480000,0,0
TIKI,dien-gia-dung,133914113,"Starter kit N2 Plus - Phụ kiện combo 4 túi rác và 2 khăn lau ",390000,390000,0,0
TIKI,thiet-bi-kts-phu-kien-so,152710164,"Ốp Case PC Color Mặt Kính Cường Lực cho Apple Watch Series 7 (Size 41mm/45mm)",159000,159000,0,0
TIKI,thiet-bi-kts-phu-kien-so,14615267,"Cáp USB 3.0 sang HDMI Hỗ Trợ Full HD 1080p dùng cho Windows và MacOS",163000,250000,87000,35
TIKI,thiet-bi-kts-phu-kien-so,191453994,"Dây đeo dành cho Huawei Band 7 bằng thép cao cấp",140000,140000,0,0
TIKI,thiet-bi-kts-phu-kien-so,90021971,"Hub chuyển đổi đa năng Baseus Type-C - HDMI, USB, RJ45, SD, TF,... dành cho Macbook, Notebook, Laptop,... - phân phối chính hãng tại Baseus Việt Nam",848499,848499,0,0
TIKI,thiet-bi-kts-phu-kien-so,10697310,"Kẹp Điện Thoại",10000,10000,0,0
TIKI,thiet-bi-kts-phu-kien-so,107780600,"Cáp sạc nhanh Baseus C to C 100W màn led, Cáp sạc nhanh 100W Baseus Display Fast Charging Data Cable Type C to C 100W (20V/5A) - Hàng chính hãng",160000,160000,0,0
TIKI,dien-gia-dung,548609,"Máy đánh trứng Tiross TS5400 - Đen - Hàng chính hãng",555000,790000,235000,30
TIKI,dien-gia-dung,1746051,"Quạt đứng 4 số Điện cơ 91 QRCO - Hàng Chính Hãng",440000,440000,0,0
TIKI,thiet-bi-kts-phu-kien-so,169558817,"Bàn phím máy tính không dây Ajazz 308i - Hàng chính hãng",432060,454800,22740,5
TIKI,dien-gia-dung,21072910,"Quạt Tích Điện Mini YooBao - 6400mAh - Sử Dụng Lên Đến 32h - Hàng Chính Hãng",332500,350000,17500,5
TIKI,thiet-bi-kts-phu-kien-so,34843660,"Kính cường lực Nillkin XD CP+ MAX",121000,259992,138992,53
TIKI,thiet-bi-kts-phu-kien-so,49501166,"Hộp đựng ổ cứng SATA cổng USB-C 3.1 cao cấp Ugreen 50743 - Hàng chính hãng",416000,416000,0,0
TIKI,thiet-bi-kts-phu-kien-so,161397481,"Dây Đeo Thay Thế Cho Galaxy Watch 4 / Galaxy Watch 4 Classic Size 40/42/44/46mm (Dây Size 20mm)",150000,150000,0,0
TIKI,dien-gia-dung,158897700,"Nồi cơm áp suất đa năng Elmich PCE-1806 (5 Lít) - Hàng chính hãng",1640000,2690000,1050000,39
TIKI,thiet-bi-kts-phu-kien-so,91833246,"Sound Card Thu Âm Behringer UFO202- Hàng chính hãng",600000,600000,0,0
TIKI,thiet-bi-kts-phu-kien-so,54139454,"Miếng Lót Chuột, Bàn Di Chuột, mouse pad cỡ lớn Kaws - Brearbrick (80x30x0.3)",90000,90000,0,0
TIKI,thiet-bi-kts-phu-kien-so,193156667,"Ốp lưng cho Xiaomi 11T - 11T Pro gương cứng 2 màu Gradient Ver 2 , viền TPU dẻo đen",80000,80000,0,0
TIKI,dien-gia-dung,148877075,"Nồi lẩu điện đa năng Bear DHG-B25B2 phiên bản 3 tầng, 4 trong 1, hàng chính hãng",1195000,1195000,0,0
TIKI,thiet-bi-kts-phu-kien-so,6213359,"Ốp lưng chống sốc Likgus cho Samsung Galaxy Note 8 (chuẩn quân đội, chống va đập, chống vân tay) - Hàng chính hãng",79000,79000,0,0
TIKI,thiet-bi-kts-phu-kien-so,98969544,"Trạm loa kép vuông",6500,6500,0,0
TIKI,thiet-bi-kts-phu-kien-so,34437149,"Dây cáp HDMI to Micro HDMI 50cm",95000,95000,0,0
TIKI,thiet-bi-kts-phu-kien-so,96615280,"Chuột Máy Tính XSmart Free Wolf V1 LED RGB Chơi Game Tự Động Đổi Màu Cực Đẹp - Hàng Chính Hãng",129000,129000,0,0
TIKI,dien-gia-dung,729875,"Quạt Gió Nhỏ Lifan GN-4 - Đen - Hàng Chính Hãng",155000,155000,0,0
TIKI,thiet-bi-kts-phu-kien-so,43384946,"Ốp lưng da kính cao cấp dành cho iPhone 7 Plus / iPhone 8 Plus - Màu đỏ - Hàng nhập khẩu - DELICATE",149000,150000,1000,1
TIKI,thiet-bi-kts-phu-kien-so,167441543,"Ốp Lưng Silicon Gor Cho Samsung Galaxy S22/ S22 Plus/ S22 Ultra Trong Suốt Có Gờ Bảo Vệ Camera, hãng GOR - Hàng nhập khẩu",36000,39999,3999,10
TIKI,dien-gia-dung,73330429,"Nồi cơm điện giảm tinh bột cao cấp La gourmet 5l - 363992 (chứng nhận bởi SGS tách giảm 37% tinh bột nhanh)",2299000,3499000,1200000,34
TIKI,thiet-bi-kts-phu-kien-so,141590236,"Bao da ipad 2017/2018/gen 5/gen 6/Air 1/2 hoạt hình siêu cute",115000,115000,0,0
TIKI,dien-gia-dung,368612,"Lò Vi Sóng Có Nướng Sharp R-G222VN-S- 20 Lít - Hàng chính hãng",1990000,2420000,430000,18
TIKI,dien-gia-dung,147903537,"Bếp Từ Đơn Sunhouse SHD6157 (1800W) - Kèm Nồi Lẩu - Hàng Chính Hãng",679000,1094000,415000,38
TIKI,dien-gia-dung,57456756,"Máy Lọc Nước RO Hydrogen Ion Kiềm Kangaroo KG100ES 7 Lõi - Hàng Chính Hãng",4000000,12790000,8790000,69
TIKI,dien-gia-dung,173550857,"Máy ép chậm Elmich JEE - 1855OL - Hàng chính hãng (New)",1850000,3890000,2040000,52
TIKI,dien-gia-dung,72543784,"Máy Sấy Tóc Damas JT3377 (Chính Hãng) - Tay cầm gấp gọn tiện dụng, chế độ bảo vệ nguồn điện, tự động ngắt nguồn chống cháy thiết bị",129000,280000,151000,54
TIKI,dien-gia-dung,143498816,"Combo Máy Lọc Không Khí U ULTTY SKJ CR021 Dạng Quạt Màu Trắng + Màng lọc HEPA H13 Nano Phân Tử Bạc - Hàng Chính Hãng",4850000,6250000,1400000,22
TIKI,dien-gia-dung,102432143,"Ấm Đun Siêu Tốc Inox 2 Lớp Sunhouse SHD1351 (1.8 Lít) - Hàng Chính Hãng",239000,422000,183000,43
TIKI,dien-gia-dung,52293499,"Máy Cạo Râu Xiaomi Enchen BlackStone 3 - Hàng Nhập Khẩu",250000,500000,250000,50
TIKI,dien-gia-dung,91565152,"Máy Lọc Không Khí ULTTY SKJ-CR021 Dạng Quạt, Chế Độ Làm Mát 9 Cấp, Bộ Lọc HEPA H13 Loại Bỏ 99,97% Bụi Mịn, Vi Khuẩn, Virut - Màu Đen - Hàng Chính Hãng",4580000,5850000,1270000,22
TIKI,dien-gia-dung,72825272,"Máy Hút Bụi Cầm Tay Không Dây Damas XC628 - Chính Hãng",439000,850000,411000,48
TIKI,dien-gia-dung,273310816,"Máy Vắt Cam Lock&Lock EJJ231 (40W) - Hàng chính hãng",223000,452000,229000,51
TIKI,dien-gia-dung,3140341,"Máy Lọc Nước RO Kangaroo VTU KG108A 8 Lõi - Hàng Chính Hãng",3240000,7570000,4330000,57
TIKI,dien-gia-dung,55442805,"Máy Lọc Nước Pureit Casa G2 Công Suất Lớn Lọc Nguyên Khối Tích Hợp Công Nghệ RO+MF - Hàng chính hãng",5625000,7500000,1875000,25
TIKI,dien-gia-dung,48537880,"Ấm Siêu Tốc Inox SUNHOUSE HAPPY TIME HTD1055 (1.5L) - Hàng Chính Hãng",145000,190000,45000,24
TIKI,dien-gia-dung,31252905,"Ấm Siêu Tốc Nagakawa NAG0308 (1.8 Lít) - Hàng Chính Hãng",159000,240000,81000,34
TIKI,dien-gia-dung,147903536,"Bếp Từ Đơn Sunhouse SHD6803 (1800W) - Kèm Nồi Lẩu - Hàng Chính Hãng",894000,1187000,293000,25
TIKI,dien-gia-dung,186708921,"Máy pha cà phê espresso CF07-PLUS tích hợp xay hạt cà phê 20 mức, đánh bọt sữa, pha espresso 20 bar mạnh mẽ, 4 trong 1 tiện lợi, 2 boilers và DIY kiểm soát nhiệt độ 3 cấp, họng pha chuyên nghiệp 58mm",9790000,9790000,0,0
TIKI,dien-gia-dung,3480333,"Bình Đun Siêu Tốc 2 lớp Lock&Lock EJK738WHT (1.7 Lít) - Trắng - Hàng chính hãng",391000,797000,406000,51
TIKI,dien-gia-dung,414764,"Lò Vi Sóng Sharp R-205VN(S) - 20L - Hàng chính hãng",1349000,1690000,341000,20
TIKI,dien-gia-dung,167433084,"Máy Nấu Chậm Sous Vide SVM11. Kiểm Soát Thời Gian Và Nhiệt Độ Chuẩn Xác. Hàng Nhập Khẩu Chính Hãng SGE Thái Lan",1750000,2900000,1150000,40
TIKI,dien-gia-dung,4701559,"Ấm Điện Thủy Tinh Siêu Tốc Có Điều Chỉnh Nhiệt Độ Lock&Lock EJK341 (1.8L) - Hàng chính hãng",562000,1145000,583000,51
TIKI,dien-gia-dung,71159450,"Máy Lọc Không Khí ULTTY SKJ-CR021 Dạng Quạt, Chế Độ Làm Mát 9 Cấp, Bộ Lọc HEPA H13 Loại Bỏ 99,97% Bụi Mịn, Vi Khuẩn, Virut - Màu Trắng - Hàng Chính Hãng",4550000,5850000,1300000,22
TIKI,dien-gia-dung,31252905,"Ấm Siêu Tốc Nagakawa NAG0308 (1.8 Lít) - Hàng Chính Hãng",159000,240000,81000,34
TIKI,dien-gia-dung,36626940,"Nồi Chiên Không Dầu Điện Tử Lock&Lock EJF357BLK (5.2 Lít) - Hàng Chính Hãng",1899000,5215000,3316000,64
TIKI,dien-gia-dung,885374,"Bàn Ủi Hơi Nước Đứng Philips GC518 (1600W) - Xanh Ngọc - Hàng chính hãng",1399000,2159000,760000,35
TIKI,dien-gia-dung,20366631,"Bàn Ủi Hơi Nước Sunhouse SHD2063P (1600W) – Hàng Chính Hãng",230000,332000,102000,31
TIKI,dien-gia-dung,73955526,"Máy Lọc Nước Pureit Lavita - CR5240 Chức Năng Làm Nóng Nhiều Cấp Độ Tích Hợp Công Nghệ RO+UV - Hàng Chính Hãng",8125000,12500000,4375000,35
TIKI,dien-gia-dung,22095571,"Bàn Ủi Khô Nagakawa NAG1502 (1200W) - Màu Ghi - Hàng Chính Hãng",151000,255000,104000,41
TIKI,dien-gia-dung,72286199,"Máy UỐN, ÉP, LÀ Tóc Đa Năng 3 Trong 1 Cao Cấp Sang Trọng Kiểu Hàn Quốc - Kết Hợp Duỗi, Uốn, Tạo Kiểu Tóc Thông Minh – Dùng Cho Salon Tóc & Tại Nhà – Chính Hãng VinBuy (Tùy Chọn 2 Màu Trắng Đen)",214000,400000,186000,47
TIKI,dien-gia-dung,185860447,"Nồi điện đa năng LocknLock 2 trong 1 nướng lẩu tối ưu 4 chế độ nhiệt (4 Lít)- EJP544WHT - Hàng chính hãng",1089000,2200000,1111000,51
TIKI,dien-gia-dung,33414955,"Tông đơ cắt tóc xiaomi Enchen Boost phiên bản mới 2020 hàng chính hãng",189000,198900,9900,5
TIKI,dien-gia-dung,36785535,"Bếp Từ Đơn Lock&Lock EJI411 (2000W) - Hàng Chính Hãng",1083000,2188000,1105000,51
TIKI,dien-gia-dung,186272720,"Quạt mini để bàn, quạt tích điện, quạt cầm tay chính hãng CWELL, động cơ không tiếng ồn, xoay 210 độ, pin khủng, bản mới",139000,199000,60000,30
TIKI,dien-gia-dung,252574230,"[TẶNG THÊM 6 THÁNG BẢO HÀNH - COMBO TIẾT KIỆM] Máy lọc nước Pureit Classic + Bộ lọc đầy đủ thay thế máy lọc nước 3000L và Màng lọc cặn - Hàng chính hãng",1793500,2900000,1106500,38
TIKI,dien-gia-dung,193916643,"Lõi Lọc RO Pureit Delica UR5840 Âm Tủ Bếp (DIY), Hàng Chính Hãng",2375000,2500000,125000,5
TIKI,dien-gia-dung,57588481,"Nồi Điện Đa Năng Lock&Lock EJP116BLK (0.8 Lít) - Hàng Chính Hãng",439000,888000,449000,51
TIKI,dien-gia-dung,8420020,"Nồi Cơm Điện Kangaroo KG822 (1.2L) - Hàng chính hãng",625000,1150000,525000,46
TIKI,dien-gia-dung,630207,"Bình Đun Siêu Tốc Sunhouse HTD1088 (1.8 lít) - Hàng chính hãng",150000,220000,70000,32
TIKI,dien-gia-dung,794609,"Máy Nướng Bánh Mì Lock& Lock EJB221BLU (730 - 870 W) - Hàng chính hãng",512000,1043000,531000,51
TIKI,dien-gia-dung,1644719,"Máy Lọc Nước Pureit Ultima Lọc Nguyên Khối Tích Hợp Công Nghệ RO + UV + MF - Hàng chính hãng",8379000,12400000,4021000,32
TIKI,dien-gia-dung,59479717,"Máy sấy tóc Philips BHC010/10 - Hàng Chính Hãng",289000,395000,106000,27
TIKI,dien-gia-dung,684651,"Ấm Siêu Tốc Inox Happy Time Sunhouse HTD1081 (1.8 lít)- Hàng chính hãng",141000,220000,79000,36
TIKI,dien-gia-dung,20882633,"Máy Hút Bụi Cầm Tay Deerma-Deerma Vacuum Cleaner DX700 - Hàng Chính Hãng",655000,666000,11000,2
TIKI,dien-gia-dung,68771348,"Nồi Cơm Điện Mini Lock&Lock EJR426 Dung Tích 0.8 lít (Hàng chính hãng)",569000,1000000,431000,43
TIKI,dien-gia-dung,66512832,"Máy Hút Bụi Lock&Lock ENV336BLK (400W) - Hàng Chính Hãng",1599000,3258000,1659000,51
TIKI,dien-gia-dung,31276266,"Máy Hút Bụi Mini Cầm Tay DEERMA - Hàng Chính Hãng",489000,699000,210000,30
TIKI,dien-gia-dung,79410098,"Nồi Cơm Điện Lock&Lock EJR716IVY 0.8L - Hàng Chính Hãng",842000,1703000,861000,51
TIKI,dien-gia-dung,48025254,"Máy Xay Sinh Tố Lock&Lock EJM436MIT (250W - 600ml) - Hàng chính hãng",457000,920000,463000,50
TIKI,dien-gia-dung,48962414,"Lò Vi Sóng Sharp R-208VN-WS (20L) - Hàng Chính Hãng",1250000,1560000,310000,20
TIKI,dien-gia-dung,104850983,"Quạt mini để bàn, quạt USB tích điện cầm tay CTFAST - M109 : Thiết kế thông minh 3 tốc độ làm mát, chất liệu cao cấp bền bỉ, điều chỉnh 360 độ, không gây ồn, pin sạc 1200mah, dễ dàng mang theo sử dụng - hàng chính hãng",140000,199000,59000,30
TIKI,dien-gia-dung,10597625,"Máy Xay Thịt 2 Lưỡi Dao Kép Lock&Lock EJM171 (2 Lít - 300W) - Hàng Chính Hãng",706000,1434000,728000,51
TIKI,dien-gia-dung,392067,"Bàn Ủi Khô Philips HD1172/01 (1000W) - Hàng chính hãng",299000,369000,70000,19
TIKI,dien-gia-dung,35216213,"Máy cạo râu Xiaomi Enchen BlackStone - Hàng Nhập Khẩu",189000,214500,25500,12
TIKI,dien-gia-dung,33494720,"Máy Sấy Tóc Nagakawa NAG1606 (2000W) - Hàng Chính Hãng",295000,590000,295000,50
TIKI,dien-gia-dung,71159586,"Nồi Chiên Không Dầu Điện Tử Lock&Lock EJF296BLK (7.2 Lít) - Kèm Chảo Nướng - Hàng Chính Hãng",2089000,5625000,3536000,63
TIKI,dien-gia-dung,272895791,"Nồi cơm điện thông minh GAABOR dung tích lớn lòng nồi 1.2L - 1.8L - Hàng chính hãng",459000,879000,420000,48
TIKI,thiet-bi-kts-phu-kien-so,176213226,"Micro Karaoke kèm loa Bluetooth iCore YM99 - Hàng chính hãng",990000,1290000,300000,23
TIKI,thiet-bi-kts-phu-kien-so,21297952,"Tai nghe nhét tai không dây cao cấp bluetooth v 4.1 Roman z6000,  hỗ trợ rung khi có cuộc gọi - Hàng Nhập Khẩu",550000,700000,150000,21
TIKI,thiet-bi-kts-phu-kien-so,35951535,"Tay Cầm Chơi Game Không Dây Cho PC / Xbox360 / Android TV / Smartphone/ Laptop 850M - cổng OTG Type-C",177555,186900,9345,5
TIKI,thiet-bi-kts-phu-kien-so,51640190,"Bàn Phím Bluetooth có mặt di chuột cho Laptop tablet điện thoại AB033",488000,488000,0,0
TIKI,thiet-bi-kts-phu-kien-so,15280632,"Giá đỡ điện thoại, máy tính bảng có chân kẹp đầu giường, cạnh bàn",78890,78890,0,0
TIKI,thiet-bi-kts-phu-kien-so,33360472,"Đầu Chuyển Đổi USB 3.0 Sang USB Type C",19000,25000,6000,24
TIKI,thiet-bi-kts-phu-kien-so,170105386,"Thẻ Nhớ Micro SDXC Samsung Evo Plus 130MB/s 64GB New - Hàng Nhập Khẩu",155000,155000,0,0
TIKI,thiet-bi-kts-phu-kien-so,139462714,"Tai Nghe Bluetooth Tai Mèo Phát Sáng VinBuy, Tai Nghe Không Dây, Tai Nghe Chụp Tai, Tai Nghe Mèo Có Mic, Đèn LED Và Âm Bass Mạnh Mẽ - Chính Hãng",133000,300000,167000,56
TIKI,thiet-bi-kts-phu-kien-so,271419201,"Giá đỡ, chân đế kẹp giữ cho Macbook có thể điều chỉnh",250000,250000,0,0
TIKI,thiet-bi-kts-phu-kien-so,25106346,"Bút trình chiếu văn phòng powerpoint Vesine VP101  ",180405,189900,9495,5
TIKI,thiet-bi-kts-phu-kien-so,25749035,"Tai nghe chụp tai Bluetooth P47",69900,69900,0,0
TIKI,thiet-bi-kts-phu-kien-so,120782190,"Giá đỡ / Đế đỡ tản nhiệt dành cho laptop, macbook, máy tính bảng gấp gọn tiện dụng + tặng kèm túi đựng, ( Giao màu ngẫu nhiên )- Hàng chính hãng",67600,67600,0,0
TIKI,thiet-bi-kts-phu-kien-so,169809666,"Micro Karaoke Bluetooth kèm loa kết nối điện thoại, máy tính bảng Hát Không Dây, Nghe Nhạc, Hỗ Trợ Kết Nối Thẻ Nhớ, USB Pin sạc - Hàng Chính Hãng",410000,900000,490000,54
TIKI,thiet-bi-kts-phu-kien-so,181796865,"Tai nghe Bluetooth True Wireless Go Air Pop JLab màu xám xanh (slate) - Hàng chính hãng",890000,890000,0,0
TIKI,thiet-bi-kts-phu-kien-so,136032899,"Loa máy trợ giảng Aporo T18  2.4G công suất 30W Bluetooth 5.0 không dây cao cấp",950000,950000,0,0
TIKI,thiet-bi-kts-phu-kien-so,29655357,"Giá đỡ, Kẹp Ipad đầu giường - Điện thoại máy tính bảng",66900,66900,0,0
TIKI,thiet-bi-kts-phu-kien-so,72217122,"Ốp Lưng TPU Dẻo Viền Vuông Giả iPhone 12 Dành Cho iPhone 6,7,6 Plus,7Plus,X,Xr,Xs Max,11,11 Pro, 11 Pro Max- Hàng Chính Hãng",79000,79000,0,0
TIKI,thiet-bi-kts-phu-kien-so,54626520,"Giá Đỡ Để Bàn Điện Thoại Di Động, Máy Tính Bảng Hợp Kim Nhôm Cao Cấp - 02 Vị Trí Điều Chỉnh Góc Nhìn Hàng Chính Hãng Helios",39000,39000,0,0
TIKI,thiet-bi-kts-phu-kien-so,160566577,"Bao Da Dành Cho Ipad 2-3-4 / Air 1- 2 - 3 -4 / Mini 1- 2- 3 - 4 / New 2017-2018 / Air 3 / 10.5 / 10.9 Họa Tiết Deer - Da Lộn",180000,180000,0,0
TIKI,thiet-bi-kts-phu-kien-so,5050641,"Tay Cầm Chơi Game PC Đầu USB Có Rung, Joystick",71100,71100,0,0
TIKI,thiet-bi-kts-phu-kien-so,114629126,"Giá Đỡ Điện Thoại Trên Ô Tô - Kẹp Điện Thoại Ô Tô, Xe Máy Hít Nam Châm Cực Chắc",40000,40000,0,0
TIKI,thiet-bi-kts-phu-kien-so,212986152,"Dụng Cụ Silicon Cố Định Đầu Dây Sạc, Dùng Keo 3M Xịn Giúp Tăng Cường Độ Chắc Chắn Khi Cố Định - Funu Home",45000,45000,0,0
TIKI,thiet-bi-kts-phu-kien-so,165938610,"Miếng Dán Bảo Vệ Viền PDF Kai dành cho iPhone 13 / 13 Pro / 13 Pro Max Hình Animal - Hàng Chính Hãng",46550,49000,2450,5
TIKI,thiet-bi-kts-phu-kien-so,71986961,"Tai nghe KZ EDX - Bản nâng cấp mới, Bass tốt hơn, có micro - hàng chính hãng",178000,178000,0,0
TIKI,thiet-bi-kts-phu-kien-so,108207118,"Cáp mạng Cat6 hỗ trợ truyền dữ liệu lên đến 1000Mbps dài 1-5m UGREEN NW135 - Hàng chính hãng",100000,125000,25000,20
TIKI,thiet-bi-kts-phu-kien-so,14116368,"Dây Audio chuyển tai nghe 3.5mm đầu cái sang 2 đầu Mic và Tai nghe đầu đực",10900,10900,0,0
TIKI,thiet-bi-kts-phu-kien-so,20022917,"Bút Trình Chiếu Vesine VP-101 - Hàng Nhập Khẩu",91000,91000,0,0
TIKI,thiet-bi-kts-phu-kien-so,197574571,"Ốp Lưng Elago Clear Case Dành Cho iPhone 14 ProMax / 14 Pro / 14 Plus / 14 - Hàng Chính Hãng",330000,373000,43000,12
TIKI,thiet-bi-kts-phu-kien-so,25300596,"Sim Và Esim Du lịch 42 nước Châu Âu (10 ngày) - Mẫu ngẫu nhiên",350000,350000,0,0
TIKI,thiet-bi-kts-phu-kien-so,190336881,"Ốp lưng dành cho Xiaomi POCO C40 silicon dẻo trong suốt cao cấp A+",18000,18000,0,0
TIKI,thiet-bi-kts-phu-kien-so,181680005,"Bút cảm ứng điện dùng cho Smartphone, iPad 2 đầu cảm ứng nhỏ gọn",65000,88000,23000,26
TIKI,thiet-bi-kts-phu-kien-so,50295352,"Đầu chuyển đổi HDMI to VGA có hỗ trợ cổng audio 3.5mm VENTION AIDB0 - Hàng chính hãng",230500,230500,0,0
TIKI,thiet-bi-kts-phu-kien-so,7555917,"Bao Da Smart Case Gen2 TPU Dành Cho iPad Air / Air 2 / Pro 9.7inch / The New 2017 / 9.7 2018",116000,289986,173986,60
TIKI,thiet-bi-kts-phu-kien-so,115129397,"VINETTEAM Bộ Chuyển Đổi Âm Thanh Không Dây K16 Bluetooth 5.0 Thiết Bị Thu Phát Bluetooth Từ Tivi, Amply Ra RAC, AV3.5 Hỗ Trợ Ứng Dụng Đĩa TF/U Sạc Nhanh 220V/2A - Hàng Chính Hãng",399000,450000,51000,11
TIKI,thiet-bi-kts-phu-kien-so,56558512,"COMBO 5 Dây Quấn Tai Nghe-Cáp Xạc-  Nhiều Màu Đa năng-Chống rối",8996,8996,0,0
TIKI,thiet-bi-kts-phu-kien-so,49548834,"Tai Nghe Có Dây Nhét Tai Sennheiser CX 80S - Hàng Chính Hãng",490000,629000,139000,22
TIKI,thiet-bi-kts-phu-kien-so,162168764,"Bao Da Dành Cho iPad Pro 11 inch M1 2021/ Pro 11 inch M2 2022 ESR Rebound Pencil Case- Hàng Chính Hãng",750000,750000,0,0
TIKI,thiet-bi-kts-phu-kien-so,195915991,"Thẻ Nhớ MicroSDXC SanDisk Extreme Pro V30 A2 256GB 200MB/s SDSQXCD-256G (New 2022) - Hàng Nhập Khẩu",665000,665000,0,0
TIKI,thiet-bi-kts-phu-kien-so,35431989,"Loa Karaoke Bluetooth Xách Tay KMS-S1 (Đen) Tặng Kèm 1 Mic Hát Có Dây Cắm Trực Tiếp, Bass Không Dây, Đèn Led Sống Động",298997,298997,0,0
TIKI,thiet-bi-kts-phu-kien-so,174211215,"Bộ Bàn phím chuột không dây K835 - pin sạc - đa kết nối bluetooth 5.0 + 3.0 + Usb wireless 2.4g",520000,520000,0,0
TIKI,do-choi-me-be,118586742,"GÀ CON LON TON CHẠY BẰNG DÂY CÓT CỰC VUI CHO BÉ",12000,12000,0,0
TIKI,do-choi-me-be,54028967,"Baby Rock Star - Đàn piano",59000,120000,61000,51
TIKI,do-choi-me-be,62829699,"Bộ tranh xếp hình cao cấp 500 mảnh ghép – Thái Dương Hệ (40x50cm)",115000,150000,35000,23
TIKI,do-choi-me-be,751831,"Trà vằng túi lọc lợi sữa, nhanh lấy lại vóc dáng sau sinh Wonmom 40gr ( 20 Túi/Hộp )",94050,99000,4950,5
TIKI,do-choi-me-be,140356421,"BỘ ĐỒ NOEL CHO BÉ TRAI VÀ BÉ GÁI MẶC ĐỀU ĐƯỢC QUẦN ÁO ÔNG GIÀ NOEL VẢI NỈ - TRANG PHỤC GIÁNG SINH CHO BÉ",9000,9000,0,0
TIKI,do-choi-me-be,755476,"Cờ Tỷ Phú Hộp Giấy Lớn 5 Trong 1 Liên Hiệp Thành KTP5T1",97000,97000,0,0
TIKI,do-choi-me-be,168791454,"Đồ chơi Lật đật mini squid game - đồ chơi con lật đật dễ thương 37*29mm",2000,2000,0,0
TIKI,do-choi-me-be,110001391,"Nhựa dán góc bàn Cao Cấp,Sản Phẩm Chống va đập an toàn cho bé",7400,7400,0,0
TIKI,do-choi-me-be,113272159,"Đánh bóng kim loại HGO Polish đánh bóng inox, thép không gỉ, đồng, nhôm, bạc an toàn hiệu quả bảo vệ bề mặt 500ml",99000,165000,66000,40
TIKI,do-choi-me-be,147721717,"Xe lắc trẻ em cỡ đại - có nhạc cho bé",239000,239000,0,0
TIKI,do-choi-me-be,117295102,"GÀ CON LON TON CHẠY BẰNG DÂY CÓT CỰC VUI CHO BÉ Hàng Loại giá tận xưởng",12400,12400,0,0
TIKI,do-choi-me-be,139539964,"Đồ Chơi Gỗ Cao Cấp BÀN TÍNH HỌC ĐẾM HẠT BẰNG GỖ - TẬP ĐẾM VÀ NHẬN BIẾT CON SỐ, MANG LẠI SỰ THÍCH THÚ CHO TRẺ - Hàng Chính Hãng",189090,191000,1910,1
TIKI,do-choi-me-be,57653558,"[Combo 10 gói] Tấm lót phân xu họa tiết vui nhộn sơ sinh cho bé Mama (30 tờ/túi x 10 )",219000,219000,0,0
TIKI,do-choi-me-be,58964368,"Combo 5 Bịch Tấm Lót Xu Sơ Sinh Aiko (Bịch 30 Miếng)",125000,125000,0,0
TIKI,do-choi-me-be,37750135,"Quần chip tam giác bé gái set 4 cái 4 màu",95000,95000,0,0
TIKI,do-choi-me-be,52588252,"Combo 2 lon Sữa Morinaga số 3 Hương vani (Kodomil) 850g",870000,1102000,232000,21
TIKI,do-choi-me-be,169278857,"Áo Thun Huggy Wuggy UNISEX cho bé",110000,110000,0,0
TIKI,do-choi-me-be,152517831,"Đồ chơi: Ghép hình lực lượng cảnh sát - Trực thăng tuần tra DK81062",80000,108000,28000,26
TIKI,do-choi-me-be,77035294,"Bộ 500 Chip Poker Không Số ( Phỉnh Poker ) Hàng Cao Cấp",1080000,1080000,0,0
TIKI,do-choi-me-be,37961447,"Đồ chơi lắp ráp Giấy 3D Mô hình Sân Vận Động Stamford Bridge Chelsea - Tặn kèm đèn LED",199000,349000,150000,43
TIKI,do-choi-me-be,197485001,"Bộ quần áo dài tay ngắn bé gái họa tiết Bé Gấu Hoa Tím xô muslin - AICDBGCB3EO2 - AIN Closet",155000,210000,55000,26
TIKI,thiet-bi-kts-phu-kien-so,195916600,"Thẻ Nhớ MicroSDXC SanDisk Extreme Pro V30 A2 64GB 200MB/s SDSQXCU-064G (New 2022) - Hàng Nhập Khẩu",260000,260000,0,0
TIKI,thiet-bi-kts-phu-kien-so,10881983,"Tai nghe Bluetooth V9 4.0",92780,92780,0,0
TIKI,thiet-bi-kts-phu-kien-so,14265753,"Bút trình chiếu Lazer - Bút thuyết trình- Bút trình chiếu slide, powerpoint tặng kèm bao da",112000,117000,5000,4
TIKI,do-choi-me-be,184846327,"Bộ Đồ Chơi Xúc Cát Đi Biển Cao Cấp Cho Bé - KUB",195000,195000,0,0
TIKI,thiet-bi-kts-phu-kien-so,7810517,"Cáp nối dài dây loa 2 đầu 3.5 dài 1m5 ( 1,5 mét ) - Hàng Nhập Khẩu",8950,8950,0,0
TIKI,thiet-bi-kts-phu-kien-so,75434583,"Túi đựng điện thoại chống nước hình thú - Chính hãng",23750,25000,1250,5
TIKI,thiet-bi-kts-phu-kien-so,174593834,"Chuột bluetooth PIXLINK P103BL 2 chế độ sạc pin siêu mỏng không gây tiếng ồn chuyên dùng cho Máy tính, pc, Laptop, Tivi Hàng Chính Hãng",131000,299000,168000,56
TIKI,do-choi-me-be,138076850,"[COMBO] Ngũ Cốc Dinh Dưỡng Bầu 29 hạt _ Lợi Sữa Cao Cấp Min Min _ Ngũ Cốc Lợi Sữa Min Min 29 Hạt và 30 Hạt",195000,195000,0,0
TIKI,do-choi-me-be,74815615,"Đồ chơi mô hình xe thang cứu hỏa thang nâng KAVY NO.8827 chất liệu hợp kim và nhựa nguyên sinh an toàn, chi tiết sắc sảo",89000,89000,0,0
TIKI,do-choi-me-be,103259221,"Bộ Bảng Số Thông Minh Bằng Gỗ , Bộ Đồ Chơi Câu Cá Và Ghép Số Học Đếm 63 Chi Tiết Cho Bé",88800,88800,0,0
TIKI,do-choi-me-be,56574824,"Combo 2 bộ bài tây nhựa PVC chống nước cao cấp",149000,149000,0,0
TIKI,do-choi-me-be,205293913,"Combo Muối rửa bát finish 1.5kg + Nước làm bóng finish 800ml dùng cho Máy rửa bát chén",235000,235000,0,0
TIKI,thiet-bi-kts-phu-kien-so,112056051,"Dây Cao Su Thay Thế Viền Color cho Samsung Galaxy Fit 2 (SM-R220)",79000,79000,0,0
TIKI,thiet-bi-kts-phu-kien-so,116754406,"Băng dính gai làm gọn dây điện, băng dán gai đa năng băng nhám làm gọn góc PC, dây cáp sạc, tai nghe - Hàng nhập khẩu",8000,8000,0,0
TIKI,do-choi-me-be,51133581,"Tấm Lót Cao Su KuKu KU2516A",363090,399000,35910,9
TIKI,do-choi-me-be,26141592,"Khăn vải khô đa năng StayDry (550 gram)",69300,77000,7700,10
TIKI,do-choi-me-be,54084852,"Combo 4 Đồ Chơi Lúc Lắc Cho Trẻ Happy Baby",112500,150000,37500,25
TIKI,do-choi-me-be,114841571,"Combo 3 Lọ Nước Tắm Thảo Dược Dr.Papie Cho Bé Giúp Ngăn Ngừa Và Giảm Các Vấn Đề Về Da",344000,344000,0,0
TIKI,thiet-bi-kts-phu-kien-so,95484013,"Bàn Phím gaming mini Led RGB V700 giả cơ nhỏ gọn - hàng nhập khẩu",521800,521800,0,0
TIKI,do-choi-me-be,15320636,"Đồ chơi Đập bóng",47250,47250,0,0
TIKI,do-choi-me-be,119218868,"Mũ Bảo hiểm cho bé",90000,90000,0,0
TIKI,thiet-bi-kts-phu-kien-so,151420174,"Loa Bluetooth JBL Go 3 JBLGO3 - Hàng chính hãng",1019000,1090000,71000,7
TIKI,thiet-bi-kts-phu-kien-so,176082185,"Ốp Lưng TPU trong suốt Siêu Mỏng Thinfit cho iPhone 13 / 13 Pro / 13 Pro Max - Hàng Chính Hãng",37990,37990,0,0
TIKI,thiet-bi-kts-phu-kien-so,76176924,"VINETTEAM Giá Đỡ Laptop Nhôm N8 Màu Bạc Thiết Kế Thông Minh 2 Tầng Điều Chỉnh Độ Cao, Gấp Gọn Và Tản Nhiệt Cho Laptop, Surface, Ipad, Macbook Cho Máy Từ 12~17inch - Hàng Chính Hãng",250067,263228,13161,5
TIKI,thiet-bi-kts-phu-kien-so,102050246,"GIÁ ĐỠ ĐIỆN THOẠI, ĐỂ ĐIỂU KHIỂN DÁN TƯỜNG CÓ KHE LUỒN DÂY SẠC TIỆN DỤNG",5200,5200,0,0
TIKI,do-choi-me-be,77736112,"Khăn sữa sợi tre Organic",99000,99000,0,0
TIKI,do-choi-me-be,71099268,"Cờ Domino A1",46000,46000,0,0
TIKI,thiet-bi-kts-phu-kien-so,122901569,"Bao da cao cấp dạng ví dành cho iPhone 13 Pro Max hàng chính hãng Caseme",120000,120000,0,0
TIKI,thiet-bi-kts-phu-kien-so,172341289,"Bao Da Dành Cho iPad Pro 11 inch 2021/ 2022 ESR Rebound Magnetic Slim Case - Hàng Chính Hãng",713450,751000,37550,5
TIKI,thiet-bi-kts-phu-kien-so,192445205,"Củ sạc nhanh GaN công suất 33W Remax RP-U25 chuẩn kép PD + QC 3.0 - Hàng chính hãng",334550,390000,55450,14
TIKI,thiet-bi-kts-phu-kien-so,72745925,"Bộ Bàn Phím Chuột không dây W201 white nhỏ gọn",236550,249000,12450,5
TIKI,thiet-bi-kts-phu-kien-so,114680946,"Bao da kèm bàn phím Logitech Combo Touch dành cho iPad Pro 12.9 inch (gen 5) - Bàn phím Backlit có thể tháo rời, Trackpad siêu nhạy - Hàng chính hãng",4227000,5400000,1173000,22
TIKI,thiet-bi-kts-phu-kien-so,48483174,"Dây cáp sạc 3 đầu đa năng Type C, Iphone, Android S04 - Hàng chính hãng",28384,28384,0,0
TIKI,thiet-bi-kts-phu-kien-so,11240845,"Dây cáp HDMI - Chuẩn 1.4 full HD (10m)",55880,55880,0,0
TIKI,thiet-bi-kts-phu-kien-so,128710027,"Giá Kẹp - Giá Đỡ Điện Thoại, Máy Tính Bảng Ipad Dài 1 Mét Kẹp Bàn, Kẹp Đầu Giường",95000,95000,0,0
TIKI,thiet-bi-kts-phu-kien-so,50604824,"Cáp sạc Type C dành cho Macbook",173995,347990,173995,50
TIKI,thiet-bi-kts-phu-kien-so,192986165,"Đồng hồ Thông minh SOS Gọi điện thoại Định vị GPS Chống nước IP67 AMA Watch D06S cho Trẻ con 4 tuổi 5 tuổi 6 tuổi 7 tuổi 8 tuổi 9 tuổi 10 tuổi 11 tuổi Hàng nhập khẩu",950000,950000,0,0
TIKI,thiet-bi-kts-phu-kien-so,20647351,"GIÁ ĐỠ ĐIỆN THOẠI + IPAD",8900,8900,0,0
TIKI,thiet-bi-kts-phu-kien-so,174511679,"Cổng chuyển đổi Ugreen USB 3.0 to USB-C Adapter US276 50533 - Hàng chính hãng",100000,130000,30000,23
TIKI,thiet-bi-kts-phu-kien-so,30744379,"Loa Nghe Nhạc Xách Tay DB16 Hỗ Trợ Bluetooth, USB, Thẻ Nhớ",86600,86600,0,0
TIKI,thiet-bi-kts-phu-kien-so,515550,"Bộ Bàn Phím Và Chuột Không Dây Logitech MK235 - Hàng chính hãng",480000,480000,0,0
TIKI,do-choi-me-be,77052438,"Tất vớ hình thú cho bé ( bảng màu số 2) T51",33000,33000,0,0
TIKI,thiet-bi-kts-phu-kien-so,5986499,"Cáp HDMI 2.0 hỗ trợ 3D , 4K dài 1.5m UGREEN HD118 40409 - Hàng Chính Hãng",100000,110000,10000,9
TIKI,thiet-bi-kts-phu-kien-so,21748106,"Ốp lưng cho Samsung Galaxy S9 Plus dẻo, trong suốt",12000,12000,0,0
TIKI,thiet-bi-kts-phu-kien-so,168869275,"Bao da dành cho iPad Gen 9 10.2 inch 2021 có nắp bảo vệ camera Nillkin Bumper Leather - Hàng chính hãng",331999,331999,0,0
TIKI,thiet-bi-kts-phu-kien-so,23013305,"Giá đỡ thông minh cho điện thoại, máy tính bảng có chân kẹp đầu giường, cạnh bàn - Tặng giá hình thú để điện thoại",78782,78782,0,0
TIKI,thiet-bi-kts-phu-kien-so,144465073,"Dây đeo điện thoại các hình (đeo cổ)",15000,15000,0,0
TIKI,do-choi-me-be,76047381,"Nước thông cống Hando 570ml hàng nội địa",28000,28000,0,0
TIKI,thiet-bi-kts-phu-kien-so,84340413,"Dây Đeo Thay Thế Dành Cho Vòng Đeo Tay Thông Minh Samsung Galaxy Fit 2 SM-R220 Dẻo TPU",59000,59000,0,0
TIKI,do-choi-me-be,57449684,"Mắt kính thời trang cho bé trai và bé gái- Kính mắt đi biển, du lịch cho trẻ em, giao màu ngẫu nhiên+ Tặng kèm miếng dán nam châm hình thú ngộ nghĩnh cho bé",42000,42000,0,0
TIKI,do-choi-me-be,161020504,"(Loại Chuẩn) Đai Địu 04 Tư Thế KhoNCC Hàng Chính Hãng - Tiện Lợi Cho Bé Sơ Sinh Đến 30 Tháng Tuổi - Đỡ Mỏi - Bảo Vệ Đầu Cổ - KPD-DAI4-545 (Nhiều màu)",129000,158000,29000,18
TIKI,do-choi-me-be,68258376,"Nước rửa chén hữu cơ Bồ hòn Ecocare tinh dầu Vỏ Cam 2000ml",215000,280000,65000,23
TIKI,thiet-bi-kts-phu-kien-so,41873601,"Cáp chuyển Thunderbolt 3 ra HDMI/USB/ PD cho Macbook TH0531",107000,112999,5999,5
TIKI,thiet-bi-kts-phu-kien-so,184076146,"Loa bluetooth mini Remax RB-M7 tích hợp FM Radio, MIcroSD- Hàng chính hãng",630000,700000,70000,10
TIKI,thiet-bi-kts-phu-kien-so,20201881,"Kính Cường Lực Full Màn Hình Cho Redmi Note 7 / Redmi Note 7 Pro",12000,12000,0,0
TIKI,thiet-bi-kts-phu-kien-so,22814377,"Hub USB 4 Port Hoco ( Hàng chính hãng )",120000,120000,0,0
TIKI,thiet-bi-kts-phu-kien-so,122755113,"Cây chọt sim điện thoại, que chọc sim để sau ốp lưng dành cho iphone 5/5s/6/6plus/6s/6s plus/6/7/7plus/8/8plus/x/xs/xs max",3990,3990,0,0
TIKI,thiet-bi-kts-phu-kien-so,192198514,"Pin sạc dự phòng không dây WEKOME tích hợp sạc nhanh PD20W + QC22.5W nhiều cổng 10000mAh 287 289 Hàng nhập khẩu",375000,375000,0,0
TIKI,thiet-bi-kts-phu-kien-so,144684441,"Ốp lưng kháng khuẩn Baseus Liquid Silica Gel Protective Case dành cho iPhone 13 Promax/ 13/ 13 Pro_ Hàng Chính Hãng",182000,274998,92998,34
TIKI,dien-gia-dung,147903537,"Bếp Từ Đơn Sunhouse SHD6157 (1800W) - Kèm Nồi Lẩu - Hàng Chính Hãng",679000,1094000,415000,38
TIKI,dien-gia-dung,3140341,"Máy Lọc Nước RO Kangaroo VTU KG108A 8 Lõi - Hàng Chính Hãng",3240000,7570000,4330000,57
TIKI,dien-gia-dung,57456756,"Máy Lọc Nước RO Hydrogen Ion Kiềm Kangaroo KG100ES 7 Lõi - Hàng Chính Hãng",4000000,12790000,8790000,69
TIKI,dien-gia-dung,173550857,"Máy ép chậm Elmich JEE - 1855OL - Hàng chính hãng (New)",1850000,3890000,2040000,52
TIKI,dien-gia-dung,52087357,"Bàn Ủi Hơi Nước Cầm Tay Gấp Gọn",259000,259000,0,0
TIKI,dien-gia-dung,167433084,"Máy Nấu Chậm Sous Vide SVM11. Kiểm Soát Thời Gian Và Nhiệt Độ Chuẩn Xác. Hàng Nhập Khẩu Chính Hãng SGE Thái Lan",1750000,2900000,1150000,40
TIKI,dien-gia-dung,1908441,"Bàn Ủi Khô Sunhouse SHD1072 - Hồng (1200W) - Hàng chính hãng",178000,247000,69000,28
TIKI,dien-gia-dung,166124677,"Máy sấy tóc công suất lớn tạo kiểu CWell, máy sấy tóc mini 2 chiều nóng lạnh C02HD 1200W, ánh sáng xanh bảo vệ tóc",109000,199000,90000,45
TIKI,dien-gia-dung,113271935,"Nồi Chiên Không Dầu Kết Hợp Chức Năng Hấp Lock&Lock EJF881BLK 7L",3019000,6490000,3471000,53
TIKI,dien-gia-dung,186708921,"Máy pha cà phê espresso CF07-PLUS tích hợp xay hạt cà phê 20 mức, đánh bọt sữa, pha espresso 20 bar mạnh mẽ, 4 trong 1 tiện lợi, 2 boilers và DIY kiểm soát nhiệt độ 3 cấp, họng pha chuyên nghiệp 58mm",9790000,9790000,0,0
TIKI,dien-gia-dung,91565152,"Máy Lọc Không Khí ULTTY SKJ-CR021 Dạng Quạt, Chế Độ Làm Mát 9 Cấp, Bộ Lọc HEPA H13 Loại Bỏ 99,97% Bụi Mịn, Vi Khuẩn, Virut - Màu Đen - Hàng Chính Hãng",4580000,5850000,1270000,22
TIKI,dien-gia-dung,143498816,"Combo Máy Lọc Không Khí U ULTTY SKJ CR021 Dạng Quạt Màu Trắng + Màng lọc HEPA H13 Nano Phân Tử Bạc - Hàng Chính Hãng",4850000,6250000,1400000,22
TIKI,dien-gia-dung,4534531,"Máy Làm Sữa Chua Lock&Lock EJY110SLV (1000ml) - Hàng chính hãng",325000,658000,333000,51
TIKI,dien-gia-dung,104908436,"Quạt mini để bàn, quạt tích điện usb CTFAST M102 - Quạt cầm tay 3 tốc độ, điều chỉnh hướng gió 360 độ, không gây ồn, pin sạc dung lượng cao - hàng chính hãng",205000,240000,35000,15
TIKI,dien-gia-dung,174186211,"Ấm Siêu Tốc Inox 2 Lớp DAMAS DK-6018B (1.8L) - Hàng Chính Hãng",439000,800000,361000,45
TIKI,dien-gia-dung,33494725,"Máy Sấy Tóc Nagakawa NAG1604 (1600W) - Hàng Chính Hãng",266000,420000,154000,37
TIKI,dien-gia-dung,66663092,"Nồi điện đa năng phủ chống dính cao cấp - Nồi lẩu điện gia đình Bcook 1.8L - Hàng nhập khẩu",279000,539000,260000,48
TIKI,dien-gia-dung,558109,"Bộ Lọc Thay Thế Pureit - Hàng chính hãng",470000,470000,0,0
TIKI,dien-gia-dung,71159450,"Máy Lọc Không Khí ULTTY SKJ-CR021 Dạng Quạt, Chế Độ Làm Mát 9 Cấp, Bộ Lọc HEPA H13 Loại Bỏ 99,97% Bụi Mịn, Vi Khuẩn, Virut - Màu Trắng - Hàng Chính Hãng",4550000,5850000,1300000,22
TIKI,dien-gia-dung,127046577,"Quạt bàn Senko sang trọng cao cấp B1216 màu ngẫu nhiên - Hàng Chính Hãng",290000,290000,0,0
TIKI,dien-gia-dung,11413192,"Quạt Đứng Thân Sắt Senko DTS1607 (Hàng Chính Hãng) - Giao màu ngẫu nhiên",398000,398000,0,0
TIKI,dien-gia-dung,273210667,"Nồi cơm điện Cuckoo 2.0L CR-1122 Màu đỏ - Giữ ấm tối đa, lòng nồi chống dính- Phiên bản Quốc tế - Hàng chính hãng Cuckoo Vina",1836000,2040000,204000,10
TIKI,dien-gia-dung,57921973,"Nồi Chiên Ngập Dầu Lock&Lock EJF716SLV (1.5 Lít) - Hàng chính hãng",682000,1385000,703000,51
TIKI,dien-gia-dung,31252925,"Bình Thủy Điện 3 Mức Nhiệt Nagakawa NAG0404 (4.0 Lít) - Hàng Chính Hãng",890000,1455000,565000,39
TIKI,dien-gia-dung,73955526,"Máy Lọc Nước Pureit Lavita - CR5240 Chức Năng Làm Nóng Nhiều Cấp Độ Tích Hợp Công Nghệ RO+UV - Hàng Chính Hãng",8125000,12500000,4375000,35
TIKI,dien-gia-dung,1644719,"Máy Lọc Nước Pureit Ultima Lọc Nguyên Khối Tích Hợp Công Nghệ RO + UV + MF - Hàng chính hãng",8379000,12400000,4021000,32
TIKI,dien-gia-dung,20831735,"Lõi lọc nước số 1 Kangaroo thay thế cho các loại máy lọc RO - Hàng chính hãng",29100,37500,8400,22
TIKI,dien-gia-dung,55442805,"Máy Lọc Nước Pureit Casa G2 Công Suất Lớn Lọc Nguyên Khối Tích Hợp Công Nghệ RO+MF - Hàng chính hãng",5625000,7500000,1875000,25
TIKI,dien-gia-dung,73325952,"Máy vắt cam Lock&Lock EJJ256BLK 85W - Hàng chính hãng",658000,1338000,680000,51
TIKI,dien-gia-dung,2138525,"Máy Lọc Không Khí Sharp FP-J30E-B - Hàng chính hãng",2090000,2400000,310000,13
TIKI,dien-gia-dung,77767851,"Máy lọc không khí SUNHOUSE SHD-15AP9715 (40W) - Hàng chính hãng",1220000,2030000,810000,40
TIKI,dien-gia-dung,114680033,"Nồi lẩu mini đa năng 2 tầng ca nấu mì điện hấp hàn quốc",76870,76870,0,0
TIKI,dien-gia-dung,174666584,"Máy Uốn Tóc, Máy Ép Tóc, Duỗi Tóc Đa Năng Kiểu Hàn Quốc DAMAS DH6120 - Thiết kế với 4 mức nhiệt tùy chỉnh phù hợp với nhiều loại tóc khác nhau giúp duỗi thẳng, làm xoăn tóc chuẩn Salon ngay tại nhà mà không cần phải ra cửa tiệm - Hàng Chính Hãng",245000,450000,205000,46
TIKI,dien-gia-dung,44996545,"Máy hấp thực phẩm đa năng 03 tầng Magic Korea A61 (10.5 lít) - Hàng Chính Hãng",469000,799000,330000,41
TIKI,dien-gia-dung,558109,"Bộ Lọc Thay Thế Pureit - Hàng chính hãng",470000,470000,0,0
TIKI,dien-gia-dung,216353939,"Máy Hút Bụi Cầm Tay Không Dây, Có Đèn Cao Cấp, Lực Hút Lớn 6000PA, Êm Ái Mạnh Mẽ, Sử Dụng Trong Nhà, Ngoài Trời Và Cho Ô Tô – Máy Hút Bụi Ô Tô Và Gia Đình Chính Hãng VinBuy",150000,300000,150000,50
TIKI,dien-gia-dung,22095575,"Bàn Ủi Khô Nagakawa NAG1502 (1200W) - Tím - Hàng Chính Hãng",151000,255000,104000,41
TIKI,dien-gia-dung,63564217,"Ấm sắc thuốc Trường An TA68 Vàng - Hàng chính hãng - Gốm sứ cao cấp - Điện gia dụng - Siêu thuốc - Siêu điện - Ấm sắc thuốc bằng điện - Dụng cụ nấu thuốc -Hàng Việt Nam chất lượng cao",545000,545000,0,0
TIKI,dien-gia-dung,2386315,"Bếp Nướng Điện Lock&Lock Electric Grill EJG231 (2000W) - Hàng Chính Hãng",754000,1529000,775000,51
TIKI,dien-gia-dung,79855873,"Bàn ủi cầm tay Tefal DT6130E0 - Công suất 1300W - Phun hơi 20g/phút - Chức năng chống cặn - Hàng chính hãng",675000,810000,135000,17
TIKI,dien-gia-dung,108020412,"Máy hút chân không thực phẩm Shineye W230 tự động, hút khô và hút ướt với 2 chế độ hàn, tích hợp hàn độc lập, kiểm soát lực hút, hàng chính hãng",600000,600000,0,0
TIKI,dien-gia-dung,99380493," Dụng cụ cắt tỉa lông mũi ES-108 bằng thép không gỉ cao cấp, máy cắt lông mũi an toàn tiện lợi",28000,29999,1999,7
TIKI,dien-gia-dung,36627517,"Bếp Hồng Ngoại Lock&Lock EJI421 (2000W) - Hàng Chính Hãng",1142000,2306000,1164000,50
TIKI,dien-gia-dung,273600804,"Quạt Kẹp Sạc Mini Tích Điện Comet CRF0705 (5W) - Hàng chính hãng",249000,249000,0,0
TIKI,dien-gia-dung,107223590,"Máy cắt tỉa lông mũi Xiaomi ShowSee C1-BK - Hàng Nhập Khẩu",153000,155000,2000,1
TIKI,dien-gia-dung,50722604,"Máy hút bụi cầm tay mini Deerma DX118C dung tích bình chứa bụi 1.2L - Hàng chính hãng",560000,560000,0,0
TIKI,dien-gia-dung,140950114,"Máy Xay Thịt ,Xay Đa Năng, máy xay sinh tố, máy xay ăn dặm cho bé BCOOK BC06 - HÀNG CHÍNH HÃNG",249000,319000,70000,22
TIKI,dien-gia-dung,174186211,"Ấm Siêu Tốc Inox 2 Lớp DAMAS DK-6018B (1.8L) - Hàng Chính Hãng",439000,800000,361000,45
TIKI,dien-gia-dung,187938785,"Máy sấy tóc Philips BHC010/10 - Dễ dàng chăm sóc tóc - An toàn",319000,395000,76000,19
TIKI,do-choi-me-be,51953436,"Combo Viên rửa bát Finish 110 viên+Nước làm bóng finish 800ml dùng cho máy rửa bát",468322,632000,163678,26
TIKI,do-choi-me-be,90143580,"Kem Bôi Da Chống Hăm Ngăn Ngừa Rôm Sảy Cho Bé Oribebe Giúp Dưỡng Ẩm Và Làm Mịn Da Bé - An Toàn Cho Da Nhạy Cảm",98000,109000,11000,10
TIKI,dien-gia-dung,78488079,"Quạt Điện Đứng Senko L1638 - Giao Màu Ngẫu Nhiên - Hàng Chính Hãng",360000,360000,0,0
TIKI,do-choi-me-be,66608827,"Bộ bé trai công tử, set sơmi quần âu kèm dây đai lịch lãm, dùng cho sinh nhật, sự kiện, dịp lễ tết | MB10",330000,330000,0,0
TIKI,dien-gia-dung,9483224,"Combo 3 lõi lọc nước Karofi 1,2,3 chính hãng",128000,128000,0,0
TIKI,do-choi-me-be,88001293,"Bóng nhựa mềm 5.5cm (100 bóng,50 bóng,20 bóng)",14000,14000,0,0
TIKI,do-choi-me-be,205293575,"Nước làm bóng Finish 750 ml+ muối rửa bát Finish 1200 g",129000,129000,0,0
TIKI,do-choi-me-be,158409197,"Xếp Hình Gỗ Khám Phá cho bé 2+ - 3+ Mideer & TOI",289000,289000,0,0
TIKI,do-choi-me-be,147920050,"Bộ Xếp Hình Lắp Ráp Qman 479 Mảnh Robot Người Máy Kĩ Thuật 1417 Cho Trẻ Từ 6 Tuổi",259000,259000,0,0
TIKI,do-choi-me-be,109955676,"Quây bóng lều chơi bóng cho bé, Nhà bóng cho bé khung inox chữ nhật tặng 100 quả bóng",140000,140000,0,0
TIKI,do-choi-me-be,180993333,"CẦU TRƯỢT TRẺ EM CÓ THÊM MÁNG NỐI DÀI TẶNG KÈM BÓNG RỔ",459000,459000,0,0
TIKI,do-choi-me-be,58719908,"Bộ 4 sách vải song ngữ ANH - VIỆT kích thích thị giác cho bé sơ sinh dưới 1 tuổi (PiPô Việt Nam)",80000,80000,0,0
TIKI,do-choi-me-be,116300265,"Gối ôm bà bầu chữ U vải nhung và cotton cao cấp",265000,265000,0,0
TIKI,do-choi-me-be,51110091,"Bộ 2 Khóa Cửa Tủ An Toàn Cho Bé - Nhiều Loại",50000,50000,0,0
TIKI,do-choi-me-be,145678780,"Bộ đồ ngủ cho bé trai bé gái mặc đều xinh, Đồ bộ Pijama in hình cute cho bé từ 9-28kg Moon House",119000,119000,0,0
TIKI,do-choi-me-be,48083480,"ĐỒ CHƠI LÒ XO CẦU VÒNG  (7cm x 7cm x 7cm)",15000,15000,0,0
TIKI,do-choi-me-be,152475770,"Ghép hình lực lượng cảnh sát - xe cứu hộ 146 chi tiết DK81064",81000,108000,27000,25
TIKI,dien-gia-dung,57790305,"Máy xay thịt, cá, xay đa năng B.COOK 2 lưỡi dao kép cối thủy tinh (350W) - Hàng chính hãng",289000,490000,201000,41
TIKI,do-choi-me-be,127527778,"Balo Mẫu Giáo Dành Cho Bé Trai Mr Vui 876",231000,265000,34000,13
TIKI,do-choi-me-be,145389002,"BỘ ĐỒ CHƠI NẤU ĂN 36 MÓN PLAY HOUSE CHO BÉ",129000,129000,0,0
TIKI,do-choi-me-be,19700480,"Bộ 12 ngựa Pony loại cao 6-7cm",115000,115000,0,0
TIKI,do-choi-me-be,246161713,"Tranh xếp hình bằng giấy, đồ chơi xếp hình 30 mảnh (A4) cho bé từ 3 tuổi - Chứng nhận hợp quy Tia Sáng thuộc loại sản phẩm: Xếp hình số mảnh ghép lên đến 250 mảnh. Số hiệu kiểu loại: Xếp hình",19000,19000,0,0
TIKI,do-choi-me-be,114783359,"Đồ chơi rút gỗ màu, xếp hình domino loại size to 48",68000,68000,0,0
TIKI,dien-gia-dung,68258241,"Máy hút bụi cầm tay Deerma DX115C (600W) - Hàng Chính Hãng",445000,498800,53800,11
TIKI,do-choi-me-be,168479576,"Bàn chải đánh răng Colgate họa tiết Batman dành cho trẻ",33000,36000,3000,8
TIKI,do-choi-me-be,94790055,"Áo khoác bé gái Cúc xanh kaki mềm - AICDBG6YZYSQ - AIN Closet",235000,260000,25000,10
TIKI,do-choi-me-be,88769864,"Bộ cờ vua nam chân loại 25*25*2cm - HENRYSA",125000,186000,61000,33
TIKI,do-choi-me-be,76472933,"Đồ chơi SLIMY Slime kỳ lân ánh kim-vàng hồng 33911/YE-PK",119000,119000,0,0
TIKI,do-choi-me-be,118989260,"BẢNG CHỮ CÁI TIẾNG VIỆT BẰNG GỖ CAO CẤP",119000,119000,0,0
TIKI,dien-gia-dung,242411227,"Máy Lọc Không Khí XIAOMI Mi Air Purifier 4 Lite Lọc Bụi Mịn Kết Nối App, Phù Hợp Không Gian 45 m2 - Hàng Chính Hãng",2649000,5199000,2550000,49
TIKI,do-choi-me-be,176146243,"Bộ đồ bé trai cộc tay vải đũi quần đũi in hình Suzuku Cực Mát Cho Bé Từ 7-26kg",111800,111800,0,0
TIKI,do-choi-me-be,4775257,"Sữa Nutricare Care 100 Gold cho trẻ biếng ăn suy dinh dưỡng 1-10 tuổi (900g)",340000,340000,0,0
TIKI,do-choi-me-be,16611348,"Bộ đồ chơi phát triển tư duy cho bé ",33600,33600,0,0
TIKI,do-choi-me-be,114260590,"Áo thun thể dục thương hiệu Amazing cho bé gái, cổ bẻ và cổ tròn, đồng phục thể thao cho học sinh nam nữ các cấp",59000,94000,35000,37
TIKI,do-choi-me-be,122910442,"Muối Rửa Bát Finish 4.0kg",105000,105000,0,0
TIKI,do-choi-me-be,103812916,"Yếm tròn xoay hình thú cho bé, cotton 100%, style Hàn quốc cho bé",109000,109000,0,0
TIKI,do-choi-me-be,85763973,"Nôi cũi trẻ em, nôi vải cho bé từ sơ sinh.  Có màn, có thể ghép cạnh giường cha mẹ, gấp gọn, giỏ đựng đồ tầng dưới",1599000,1599000,0,0
TIKI,do-choi-me-be,51599206,"Gối Ôm Chữ U Đa Năng cho Bà Bầu - Gối Ngủ cho Mẹ Bầu chính hãng Zcare - chứng nhận Độc Quyền bởi bộ Khoa học công nghệ; Gối bà bầu có hình chữ U nâng đỡ 6 điểm, giúp bà bầu thoải mái khi ngủ; Gối chuyên dụng cho bà bầu nên các nguyên vật liệu an toàn và c",619000,619000,0,0
TIKI,do-choi-me-be,13408700,"Mô Hình Xe Harley Davidson 2015 Street Glide Special Black 1:12 Maisto MH-32328",369000,369000,0,0
TIKI,do-choi-me-be,47153712,"Cờ Domino Gỗ Walnut Kết Hợp Da Bò Sáp Cao Cấp - The Craft House",962200,962200,0,0
TIKI,do-choi-me-be,43237770,"Bình sữa cổ rộng McGOLDSON Premium 180ml",185400,206000,20600,10
TIKI,do-choi-me-be,1473453,"Mô Hình Máy Bay Trưng Bày Boeing 747 Klm Airlines Everfly",169000,169000,0,0
TIKI,dien-gia-dung,157950027,"Máy lọc không khí nano và xông tinh dầu cho ô tô, văn phòng, phòng ngủ AirPOT - nhập khẩu trực tiếp từ Hàn Quốc",480000,960000,480000,50
TIKI,do-choi-me-be,132201095,"Rubik 2x2 Mã  DK81082",50000,68000,18000,26
TIKI,do-choi-me-be,100586366,"Tã Quần Siêu Mỏng UniDry Ultrathin Gói Cực Đại Size M74 (74 miếng)",298000,389000,91000,23
TIKI,do-choi-me-be,1715279,"Bình Xịt Côn Trùng Jumbo Vape Super A1 Hương Lavender 100712618 (600ml)",61000,61000,0,0
TIKI,lam-dep-suc-khoe,121485363,"[Coupon giảm 50K]Bàn Chải Điện P/S S100 PRO Trắng Răng Công Nghệ Sóng Âm Xanh Chải Sạch Mảng Bám Tới 10X 1 bộ",850000,1276370,426370,33
TIKI,lam-dep-suc-khoe,274152730,"Viên uống Canxi Sinh Hoc CAX - Nhập Khẩu Mỹ - BỔ SUNG CANXI GIÚP XƯƠNG CHẮC KHỎE, Chai 30 viên",298000,298000,0,0
TIKI,lam-dep-suc-khoe,151519665,"Bao cao su cao cấp OZO Feelex Invisible Cool - Hộp 10 bcs",89000,89000,0,0
TIKI,lam-dep-suc-khoe,273879837,"Viên uống Bổ Thận, Giảm Tiểu Đêm KEN (Hộp 60v) - NHẬP KHẨU MỸ - DÙNG ĐƯỢC CHO CẢ NAM, NỮ, NGƯỜI BỊ TIỂU ĐƯỜNG",720000,720000,0,0
TIKI,lam-dep-suc-khoe,273879908,"Viên uống Cân Bằng Nội Tiết Tố Nữ CER - NHẬP KHẨU MỸ - CẢI THIỆN DA KHÔ NHĂN, RỤNG TÓC, KHÔ HẠN (Chai 30v)",398000,398000,0,0
TIKI,lam-dep-suc-khoe,54640942,"Khẩu Trang Y Tế TDCare 4 Lớp-Màu Trắng-Hộp 50 Cái",48000,48000,0,0
TIKI,lam-dep-suc-khoe,73638938,"Tinh Dầu Xông Phòng Sả Chanh 100ML Nguyên Chất Nhập Khẩu - Tinh dầu Sả Chanh Giúp Bảo Vệ Sức Khỏe, Kháng Khuẩn, Đuổi Muỗi Và Thư Giãn Tinh Thần",198000,396000,198000,50
TIKI,lam-dep-suc-khoe,41228196,"Nhiệt Kế Điện Tử Hồng Ngoại Đo Trán, Đo cơ Thể Cho Bé loại Cao Cấp Có đèn",121000,298000,177000,59
TIKI,lam-dep-suc-khoe,212036624,"[CHÍNH HÃNG] Smoothie Tẩy Da Chết Dưỡng Ẩm Toàn Thân Dove đường nâu & hương dừa 298g",169000,199000,30000,15
TIKI,lam-dep-suc-khoe,154835088,"KF94-Thùng nguyên 300c Khẩu trang y tế 4D cao cấp - Kháng khuẩn, chống bụi siêu mịn - Tiêu chuẩn Hàn Quốc",165000,450000,285000,63
TIKI,lam-dep-suc-khoe,210966405,"Combo 2 Sữa dưỡng thể Vaseline Gluta-Hya Dưỡng Da Sáng Mịn Sau 7 Ngày Dưỡng sáng chuyên sâu 330 ML",235000,300000,65000,22
TIKI,lam-dep-suc-khoe,98872338,"Máy Massage Cầm Tay Cao Cấp KINGTECH KH-720 - 20 Cấp Độ, Hỗ Trợ Mát Xa Chuyên Sâu, Giảm Đau Cơ, Cứng Khớp - Chính Hãng",1055000,1850000,795000,43
TIKI,lam-dep-suc-khoe,272359857,"Combo Sữa rửa mặt Simple sạch thoáng không chứa xà phòng 150ml+ Nước hoa hồng Simple 200ML  [Chính Hãng Độc Quyền]",263000,292500,29500,10
TIKI,lam-dep-suc-khoe,274152803,"Viên uống Tăng Đề Kháng MUN – NHẬP KHẨU MỸ (Hộp 30 Viên). TĂNG CƯỜNG ĐỀ KHÁNG - GIẢM NGUY CƠ MẮC BỆNH ĐƯỜNG HÔ HẤP",298000,298000,0,0
TIKI,lam-dep-suc-khoe,631034,"Sữa rửa mặt dưỡng ẩm tối ưu Hada Labo Advanced Nourish Cleanser 80g",72000,83000,11000,13
TIKI,lam-dep-suc-khoe,36987686,"Dầu gội dược liệu Antisol - Ngăn ngừa nấm da đầu, gàu, ngứa da đầu",283000,320000,37000,12
TIKI,lam-dep-suc-khoe,118537006,"Bấm Cắt Móng Tay Móng Chân Bằng Thép Cacbon Cường Độ Cao, Lưỡi Bấm Siêu Sắc, Siêu Bền, Kèm Dũa Móng Tay, Thiết Kế Hiện Đại, Thời Trang, Loại Gấp Gọn Dành Cho Người Lớn Và Trẻ Nhỏ",14900,14900,0,0
TIKI,lam-dep-suc-khoe,217539886,"[Nhập coupon giảm ngay 50K]Bàn Chải Điện P/S S100 PRO - Phiên Bản Ultra Violet Giới Hạn - Sạch chuẩn sóng âm",819000,1276370,457370,36
TIKI,lam-dep-suc-khoe,154476177,"Radiance - Kem dưỡng trắng sáng da ban đêm",1575000,1575000,0,0
TIKI,lam-dep-suc-khoe,177911621,"Gương trang điểm để bàn có đèn LED Xiaomi Jordan Judy NV026 - Hàng Chính Hãng",179000,249000,70000,28
TIKI,lam-dep-suc-khoe,98605258,"Bao cao su Durex Jeans Hộp 30 bao",269000,490000,221000,45
TIKI,lam-dep-suc-khoe,35526543,"Sữa Rửa Mặt Neutrogena Làm Sạch Sâu Và Kiểm Soát Nhờn",99000,125000,26000,21
TIKI,lam-dep-suc-khoe,134318997,"SET Khẩu Trang KF94 Hàn Quốc, 4 Lớp, 50 Cái",40000,40000,0,0
TIKI,lam-dep-suc-khoe,54058501,"Kem dưỡng trắng Hada Labo Perfect White Tranexamic Acid Cream 50g",193000,240000,47000,20
TIKI,lam-dep-suc-khoe,128912879,"Túi chườm bụng kinh 700ml, túi chườm nóng giảm đau bụng đau lưng nam tặng nữ",169000,169000,0,0
TIKI,lam-dep-suc-khoe,36987686,"Dầu gội dược liệu Antisol - Ngăn ngừa nấm da đầu, gàu, ngứa da đầu",283000,320000,37000,12
TIKI,lam-dep-suc-khoe,90683425,"Bao Cao Su Durex Jeans",42000,49000,7000,14
TIKI,lam-dep-suc-khoe,74527291,"Máy Xông Tinh Dầu Tặng 3 Tinh Dầu Sả Chanh + Bạc Hà + Quế. Máy Khuếch Tán Tinh Dầu Có Remote Điều Khiển Từ Xa Chuyên Dụng Xông Tinh Dầu Cho Phòng Lớn",288000,656000,368000,56
TIKI,lam-dep-suc-khoe,5560235,"Gel bôi trơn Durex Play Classic 50ml",82000,93000,11000,12
TIKI,lam-dep-suc-khoe,58731239,"Combo 2 Nước rửa tay Lifebuoy sữa dưỡng ẩm túi 400g",100000,118000,18000,15
TIKI,lam-dep-suc-khoe,121485363,"[Coupon giảm 50K]Bàn Chải Điện P/S S100 PRO Trắng Răng Công Nghệ Sóng Âm Xanh Chải Sạch Mảng Bám Tới 10X 1 bộ",850000,1276370,426370,33
TIKI,lam-dep-suc-khoe,91565733,"Chỉ nha khoa SGS nhập khẩu Hàn Quốc - 500D hương bạc hà mới",7000,70000,63000,90
TIKI,lam-dep-suc-khoe,186434710,"Túi chườm nóng thảo dược giảm đau nhức mỏi mắt dùng lò vi sóng - Hapaku",250000,250000,0,0
TIKI,lam-dep-suc-khoe,92146086,"Combo Bao cao su Durex Invisible Extra Thin Extra Lubricated 10 Bao và Extra Sensitive 10 Bao",458000,634000,176000,28
TIKI,lam-dep-suc-khoe,25074713,"Phấn phủ kiềm dầu dạng bột innisfree No Sebum Mineral Powder 5g",162000,180000,18000,10
TIKI,lam-dep-suc-khoe,212219580,"Bàn Chải Đánh Răng Điện LocknLock ENR346BLK - DC3.7V, Trọng Lượng 235g, Sạc Không Dây - Màu Đen",915000,1664000,749000,45
TIKI,lam-dep-suc-khoe,72644676,"Gối Massage Đa Năng KingTech KP-315 - Máy Mát xa Toàn Thân Nhiệt Hồng Ngoại - Chuyên Sâu Cho Cổ, Vai Gáy, Lưng Dưới, Đùi, Chân - Sử Dụng Tại Nhà, Văn Phòng, Trên Ô Tô - Quà Tặng Cho Bạn Bè, Người Thân",780000,1250000,470000,38
TIKI,lam-dep-suc-khoe,1672211,"Gel bôi trơn Durex Play Warming 100ml",167000,194000,27000,14
TIKI,lam-dep-suc-khoe,50699284,"Nước tẩy trang Công Nghệ Micella Bioderma Sensibio H2O",499000,525000,26000,5
TIKI,lam-dep-suc-khoe,907522,"Viên uống bổ mắt Lutein Rohto V5 ( Hộp 30 viên)",460000,485000,25000,5
TIKI,lam-dep-suc-khoe,108535197,"Bao cao su Sagami Spearmint - Hương bạc hà - Hộp 10 chiếc",105000,170000,65000,38
TIKI,lam-dep-suc-khoe,20541866,"Dầu gội Selsun chống gàu, sạch gàu & hết ngứa da đầu Selsun Anti-Dandruff Shampoo 50ml",53000,59000,6000,10
TIKI,lam-dep-suc-khoe,56381615,"Nước Tẩy Trang Thanh Lọc Và Làm Sạch Sâu Neutrogena Deep Clean Micellar Purifying Water 400ml",169000,220000,51000,23
TIKI,lam-dep-suc-khoe,78280123,"Bộ 2 Chai Nước Súc Miệng làm trắng răng LISTERINE HEALTHY BRIGHT 750mlx2 Chai",267000,346000,79000,23
TIKI,lam-dep-suc-khoe,75523405,"Combo 3 Tinh Dầu Sả Chanh + Tinh Dầu Bạc Hà + Tinh Dầu Oải Hương (Lavender) - Tinh Dầu Xông Phòng Nguyên Chất Giúp Thư Giãn, Đuổi Muỗi Và Thơm Phòng (3 chai 10ML)",118000,176000,58000,33
TIKI,lam-dep-suc-khoe,181097568,"Dầu Tẩy Trang Dưỡng Ẩm Laneige Water Bank Blue HA Cleansing Oil 250ml",850000,850000,0,0
TIKI,lam-dep-suc-khoe,30689058,"Tinh chất dưỡng trắng da Dermaceutic Pháp - Tri Vita C30",2000000,2000000,0,0
TIKI,lam-dep-suc-khoe,2738497,"Bộ 3 Hộp Silcot Bông Trang Điểm (bông tẩy trang) Nhật Bản Cao Cấp (66 Miếng/Hộp)",115000,141000,26000,18
TIKI,lam-dep-suc-khoe,24245917,"Kem dưỡng trắng sáng da Dermaceutic Pháp - C25 Cream",1690000,1690000,0,0
TIKI,lam-dep-suc-khoe,385654,"Bao cao su Durex Performa 3 bao",67000,77000,10000,13
TIKI,lam-dep-suc-khoe,96593702,"Tinh Dầu Nguyên Chất Treo Xe Hơi, Treo Phòng Gia Đình| Tự Chọn Mùi, Có Kiểm Định Chất Lượng| Tinh Dầu TIDAMO Treo Thơm Phòng, Khử Mùi Xe Hơi, Thư Giản và Đuổi Muỗi",24000,88000,64000,73
TIKI,lam-dep-suc-khoe,91256307,"Tinh Dầu Xông Phòng Nguyên Chất TIDAMO 50ML, Tự Chọn Mùi | Có Kiểm Định Chất Lượng | Sử Dụng Với Máy Xông Tinh Dầu Giúp Thơm Phòng, Khử Khuẩn, Tốt Cho Sức Khỏe và Làm Đẹp",68000,164000,96000,59
TIKI,lam-dep-suc-khoe,108535196,"Bao cao su Sagami Superthin - Mỏng - Kiểu truyền thống - Hộp 10 chiếc",120000,120000,0,0
TIKI,lam-dep-suc-khoe,116446788,"Sữa Tắm pH 5.5 Johnson’s Adult - Dung Tích 750ml",134000,171000,37000,22
TIKI,lam-dep-suc-khoe,73632586,"Tinh dầu Sả Chanh Thiên Nhiên Cao Cấp 50ML (Lemongrass) - Tinh dầu Sả Chanh Nguyên Chất TIDAMO Giúp Bảo Vệ Sức Khỏe, Kháng Khuẩn, Đuổi Muỗi Và Thư Giãn Tinh Thần",119000,238000,119000,50
TIKI,dien-gia-dung,159885560,"Máy Xay Sinh Tố Philips HR2041/30 (450W) - Hàng Chính Hãng",785000,846000,61000,7
TIKI,dien-gia-dung,54348913,"máy sây tóc chất lượng cao công suất lớn",56490,56490,0,0
TIKI,dien-gia-dung,197410397,"Máy dập tóc sóng nước Vivid&Vogue VAV038-Hàng Chính Hãng",500000,500000,0,0
TIKI,dien-gia-dung,72945629,"Bộ lọc nước Konka KPW - LT01 (KJ) mẫu mới, lọc sạch nước an toàn không mùi clo, công nghệ 9 màng lọc, máy lắp trực tiếp tại vòi nước -Hàng nhập khẩu",399000,650000,251000,39
TIKI,dien-gia-dung,31252976,"Bếp Nướng Điện Nagakawa NAG3101 (1650W) - Hàng Chính Hãng",827000,1090000,263000,24
TIKI,dien-gia-dung,36995730,"tủ sấy quần áo hàn quốc",1049995,1049995,0,0
TIKI,dien-gia-dung,138077200,"Máy Sấy Tóc Pannasonni 3500w 2 Chiều Nóng Mát",56589,56589,0,0
TIKI,dien-gia-dung,34438039,"Dàn giải nhiệt - Hàng chính hãng",380000,380000,0,0
TIKI,dien-gia-dung,147202163,"Bóng Đèn Hồng Ngoại Y Tế: Supermed 250W Sưởi Ấm, Giảm Đau -VT0101",85000,85000,0,0
TIKI,dien-gia-dung,184697585,"Máy xay sinh tố công nghiệp Promix PM-819B - 1.5 lít - Hàng Chính Hãng",2795000,2795000,0,0
TIKI,dien-gia-dung,53655362,"Máy tạo bọt cafe, sữa cầm tay MFB1501D dung lượng pin 1200mAh",87856,87856,0,0
TIKI,dien-gia-dung,173891572,"Máy cạo râu đa năng 4in1 SeaSy SS68 - Máy cạo râu cầm tay cao cấp thế hệ mới 2022 thiết kế bộ 3 lưỡi kép thông minh - Cạo râu, Tông đơ cắt tóc, Tỉa lông mũi, Rửa mặt, Sạc điện, Chống nước dành cho nam - Hàng Chính Hãng",69000,69000,0,0
TIKI,dien-gia-dung,117837053,"Ấm Siêu Tốc Sunhouse SHD1306 (1.7 Lít) - Hàng Chính Hãng",393000,590000,197000,33
TIKI,dien-gia-dung,13527943,"Van bình áp máy lọc nước",33000,68000,35000,51
TIKI,dien-gia-dung,97045675,"Quạt treo tường Hali công nghiệp TC197 (2 Dây) Hàng Chính Hãng (màu đen) ",555000,555000,0,0
TIKI,dien-gia-dung,91864504,"Giắc ổ cắm chuyển đổi đầu 3 chân sang 2 chân nguồn 220V thông thường",20900,41800,20900,50
TIKI,dien-gia-dung,14548451,"Combo 2 Quạt Cầm Tay Mini Cắm Cổng USB Laptop, Sạc Dự Phòng No.1",15500,15500,0,0
TIKI,dien-gia-dung,10951384,"Quạt Treo 2 Dây Senko TC1626 (47W) - Hàng chính hãng",328000,328000,0,0
TIKI,dien-gia-dung,4754633,"Máy Đánh Trứng Philips HR3705 (300W) - Hàng Chính Hãng",725000,797000,72000,9
TIKI,dien-gia-dung,8073003,"Bàn Ủi Hơi Nước không dây Bluestone SIB-3854 (2400W) - Hàng chính hãng",846000,899000,53000,6
TIKI,dien-gia-dung,105602617,"Quạt đứng SENKO sải cảnh lớn , hẹn giờ bật tắt cao cấp hàng chính hãng- GIAO MÀU NGẪU NHIÊN  ",460000,460000,0,0
TIKI,dien-gia-dung,107360585,"Quạt đá điều hòa phun sương JTSL-08  Quạt hơi nước mini để bàn làm mát 8-10 độ dùng pin sạc 8-10 tiếng",399000,399000,0,0
TIKI,dien-gia-dung,20524490,"MÁY HÚT BỤI 2 CHIỀU VỪA HÚT VỪA THỔI",394270,443000,48730,11
TIKI,dien-gia-dung,53183173,"Hộp cơm điện mini đa năng AS2020 chất liệu inox siêu bền, giữ nhiệt tốt.Hộp cơm hâm nóng, nấu chín thức ăn, cơm.",360000,360000,0,0
TIKI,dien-gia-dung,34694884,"Tông Đơ Hớt Tóc Gia Đình Cho Bé JICHEN 0817 TẶNG Bộ Kéo Cắt Tỉa + Lấy Ráy Tai Có Đèn",147996,147996,0,0
TIKI,dien-gia-dung,182821944,"Máy Cạo Râu Mini Bugu Stardom BR-228 Ba Lưỡi Sát Chân Lông Sạc Nhanh Chống Nước - Hàng Chính Hãng",128000,249000,121000,49
TIKI,dien-gia-dung,444408,"Nồi Áp Suất Điện Tử Philips HD2136 (5 Lít) - Hàng Chính Hãng",2445000,2694000,249000,9
TIKI,dien-gia-dung,153495047,"Bếp điện từ Elmich ICE-3874 - Hàng chính hãng",1070000,1070000,0,0
TIKI,dien-gia-dung,111704764,"Thiết bị phun khử trùng nano cầm tay CTFAST - 05 : Máy phun khử trùng gia đình tích điện không dây kết hợp ánh sáng xanh an toàn, khử trùng, diệt khuẩn, đuổi muỗi",199000,349000,150000,43
TIKI,do-choi-me-be,59143359,"Combo Tiết Kiệm - 4 Gói Khăn Ướt Bobby Care Không Hương 100 Tờ/Gói",164000,164000,0,0
TIKI,dien-gia-dung,11259209,"Ấm Sắc Thuốc Gốm Bát Tràng Fujika FJ-Ck33K6 (3.3L) - Hàng chính hãng",290700,290700,0,0
TIKI,do-choi-me-be,172348753,"Combo 3 đồ bộ bé trai cao cấp in hình 3D hoạt hình, thời trang, chất liệu thun dày mịn mát và thông thoáng, set, quần áo, đồ bộ tay ngắn, đồ bé trai từ 8kg-28kg - Giao màu ngẫu nhiên",219000,219000,0,0
TIKI,do-choi-me-be,81196152,"Đồ chơi xếp hình, lắp ráp Qman 3105 – Người băng sao hỏa (908 mảnh ghép)",459000,539000,80000,15
TIKI,do-choi-me-be,56998980,"Tinh dầu hoa anh thảo - Blackmores Evening Primrose (190 viên - MẪU MỚI NHẤT)",463000,668750,205750,31
TIKI,do-choi-me-be,127546045,"Giày thể thao da bé gái in hình thỏ ngộ nghĩnh từ 5 - 16 tuổi - TT111",169000,169000,0,0
TIKI,thiet-bi-kts-phu-kien-so,110850007,"Tai nghe nhét tai có dây jack 3.5mm Remax RM-512 (New Package) - Hàng chính hãng",106550,150000,43450,29
TIKI,do-choi-me-be,182800115,"Tã/Bỉm Quần Mijuku đủ size M/L/XL/2Xl/3Xl số lượng 50 Miếng cho bé",155000,155000,0,0
TIKI,thiet-bi-kts-phu-kien-so,201437484,"Giá Đỡ Máy Tính, Laptop, iPad, Macbook Hợp Kim Nhôm Cao Cấp. Hỗ Trợ Tản Nhiệt Chống Mỏi Cổ, Vai, Gáy. Hàng Chính Hãng Tamayoko",489000,489000,0,0
TIKI,thiet-bi-kts-phu-kien-so,216238849,"Bộ sạc nhanh cho IP công suất 18W Remax RP-U37 - Hàng chính hãng",249000,300000,51000,17
TIKI,thiet-bi-kts-phu-kien-so,143957287,"HUB Type C và HUB USB 3.0 tốc độ cao 4 in 1 Sidotech bộ chia cổng usb mở rộng kết nối chuyển đổi cho Macbook Pro Laptop PC máy tính hỗ trợ sạc pin kết nối đa năng ổ cứng bàn phím chuột máy in, thiết bị ổ chia usb - Hàng chính hãng",399000,399000,0,0
TIKI,dien-gia-dung,175154487,"Nồi Cơm Điện cao tần Sharp KS-IH191V-GL(1.8L) Đa Chức Năng Hàng Chính Hãng",2483000,4190000,1707000,41
TIKI,dien-gia-dung,115519514,"MÁY CẠO RÂU BOLI RSCW 6008 | Máy cạo râu bền rẻ",165000,165000,0,0
TIKI,do-choi-me-be,113270183,"Tẩy mốc tường HGO CLEAN tẩy sàn rêu mốc, tấm alu bẩn mốc ố vàng an toàn tiện lợi hiệu quả 500ml",79000,145000,66000,46
TIKI,thiet-bi-kts-phu-kien-so,123838761,"Apple AirPods 2 - MV7N2 - Hộp Sạc Thường",2690000,5390000,2700000,50
TIKI,dien-gia-dung,90364348,"Quạt Điều Hòa Làm Mát Bằng Hơi Nước Dung Tích 40L, Công Suất 130W, Siêu Mát Với 3 Cấp Gió Giúp Làm Mát Nhanh, Tiết Kiệm Điện",1234905,1299900,64995,5
TIKI,thiet-bi-kts-phu-kien-so,72796676,"Giá Đỡ Laptop Hợp Kim Nhôm Cao Cấp Có Thể Gấp Gọn, Giúp Tản Nhiệt Laptop, Macbook, Máy Tính Xách Tay. 07 Vị Trí Điều Chỉnh Góc Độ. Hàng Chính Hãng Tamayoko FS060",199000,229000,30000,13
TIKI,do-choi-me-be,48565688,"Dung dịch vệ sinh máy rửa bát Finish 250ml (thị trường Đức) - Giao ngẫu nhiên",99000,99000,0,0
TIKI,do-choi-me-be,13671262,"Bộ Cờ Vua Nam Châm Bàn Cũng Là Hộp Đựng UBon",86310,95900,9590,10
TIKI,dien-gia-dung,20699969,"Nồi Lẩu Điện Mini Đa Năng 2 In 1 ( 18 Cm )",79000,79000,0,0
TIKI,do-choi-me-be,185913217,"Núm ty ngậm Siêu mềm Philips Avent cho bé từ 0-6 tháng tuổi - Vỉ đơn",185000,185000,0,0
TIKI,dien-gia-dung,5818893,"Siêu sắc thuốc Gali GL-1801 (3.3L)- Hãng chính hãng",649000,649000,0,0
TIKI,thiet-bi-kts-phu-kien-so,126697,"Tai Nghe Nhét Tai Sony MDR-EX15AP",190000,199000,9000,5
TIKI,thiet-bi-kts-phu-kien-so,111031533,"Cáp sạc nhanh 2.4A và truyền dữ liệu chân type-C Remax Colorful Light RC-152a [Hàng chính hãng",112250,150000,37750,25
TIKI,do-choi-me-be,57776884,"Combo Bộ 16 Miếng Dụng Cụ Silicone Chặn Và Bịt Góc Bàn Tủ Cửa Bảo Vệ Bé Legaxi",7000,7000,0,0
TIKI,do-choi-me-be,570099,"Bột Giặt Tide Chuyên Dụng 9Kg",289000,289000,0,0
TIKI,thiet-bi-kts-phu-kien-so,273908414,"Cáp sạc nhanh IP chuẩn PD 20W iCybernet IC-1003 TypeC to IP chiều dài 1,2m - Hàng chính hãng",98000,150000,52000,35
TIKI,do-choi-me-be,68258090,"Gối cao su non cho bé chống bẹp đầu cao cấp. Gối dành cho bé từ 1 tuổi đến 6 tuổi. Mềm mại, thoáng khí, giúp con ngủ ngon hơn",249000,249000,0,0
TIKI,dien-gia-dung,165035326,"Máy Hút Chân Không Cao Cấp Mini Vacuum Sealer. Hút Chân Không Kiêm Hàn Miệng Túi Thực Phẩm",109875,109875,0,0
TIKI,thiet-bi-kts-phu-kien-so,142439870,"Cáp sạc Baseus Cafule sạc nhanh dùng cho iPhone - Hàng chính hãng",89000,159000,70000,44
TIKI,thiet-bi-kts-phu-kien-so,71672203,"Thẻ Nhớ microSDHC SanDisk Ultra 32GB UHS-I - 100MB/s (New 2020) - Hàng Nhập Khẩu",108000,108000,0,0
TIKI,thiet-bi-kts-phu-kien-so,123847933,"Apple Pencil 2 - MU8F2",2690000,4890000,2200000,45
TIKI,dien-gia-dung,1734985,"Máy Nước Nóng Lạnh Toshiba RWF-W1669BV(K1) 650W - Hàng chính hãng",3780000,5390000,1610000,30
TIKI,dien-gia-dung,57983571,"Lõi lọc nước Toshiba số 2 F-1686-RO - HÀNG CHÍNH HÃNG",879000,990000,111000,11
TIKI,do-choi-me-be,26062573,"Nước Xả Làm Mềm Vải Comfort Chăm Sóc Dịu Nhẹ Cho Da Nhạy Cảm 3.2L",204000,204000,0,0
TIKI,dien-gia-dung,98675019,"Máy khử mùi đa năng dành cho nhà bếp, phòng ngủ, nhà vệ sinh",329000,360000,31000,9
TIKI,dien-gia-dung,52867858,"Combo Máy Xay Sinh Tố Công Nghiệp JTC Omniblend I TM-767A 1200W (1.5L) và Cối Rời JTC Omniblend (1.5L) - Chính Hãng",4475000,4475000,0,0
TIKI,thiet-bi-kts-phu-kien-so,273906522,"Cáp sạc USB to IP iCybernet IC-1001 sạc 2.4A và truyền dữ liệu đồng thời, chiều dài 1,2m - Hàng chính hãng",58000,100000,42000,42
TIKI,thiet-bi-kts-phu-kien-so,1060082,"Dây Cáp Sạc Li.ght.ning Cho i.Phone Anker PowerLine II 1.8m - A8433H22",320000,380000,60000,16
TIKI,thiet-bi-kts-phu-kien-so,109393113,"Tai nghe bluetooth nhét tai chống ồn cao cấp V5.0 chính hãng dùng cho iPhone Samsung OPPO VIVO HUAWEI XIAOMI tai nghe không dây Hàng Chính Hãng PKCB",280000,500000,220000,44
TIKI,thiet-bi-kts-phu-kien-so,71091864,"Đồng Hồ Pomodoro Hẹn Giờ 60 Phút Kim Loại Nhiều Kiểu Dáng",75000,75000,0,0
TIKI,do-choi-me-be,89565445,"Yến mạch nguyên hạt cán mỏng DK Harvset nhập khẩu ÚC - Thích hợp cho bé ăn dặm từ 6 tháng tuổi - Túi 500g",39000,39000,0,0
TIKI,do-choi-me-be,121231481,"Combo 5 Bản Mèo Nổ Mở Rộng Việt Hóa Lá Bài Chuẩn Đẹp",80000,80000,0,0
TIKI,do-choi-me-be,20470442,"Xe tập đi bằng gỗ con gà cho bé",92998,92998,0,0
TIKI,do-choi-me-be,174293493,"Xe ô tô điều khiển từ xa KAVY BS009A có tạo hình chữ đèn LED tốc độ cực kì cao, trình diễn tự động 5 chế độ",353000,353000,0,0
TIKI,do-choi-me-be,50886887,"Combo 3 bịch bỉm/tã quần cao cấp MIJUKU - XXL",515000,515000,0,0
TIKI,do-choi-me-be,118997177,"Gel khử mùi bồn cầu diệt khuẩn toilet gel dính bồn cầu dạng thạch hình bông hoa với 5 mùi thơm cho nhà vệ sinh",9500,10000,500,5
TIKI,thiet-bi-kts-phu-kien-so,195999085,"Cáp sạc siêu nhanh 100W Remax RC-183c chiều dài 2m - Hàng chính hãng",144550,200000,55450,28
TIKI,do-choi-me-be,205436577,"Dung dịch vệ sinh máy rửa bát Finish hương chanh 250ml Finish EU",125000,125000,0,0
TIKI,thiet-bi-kts-phu-kien-so,102782859,"Tai nghe In Ear Remax RM330 - Hàng chính hãng",212000,250000,38000,15
TIKI,thiet-bi-kts-phu-kien-so,102391960,"Giá Đỡ Máy Tính, Laptop, iPad, Macbook Hợp Kim Nhôm Cao Cấp. Hỗ Trợ Tản Nhiệt Chống Mỏi Cổ, Vai, Gáy. Hàng Chính Hãng Tamayoko",450000,500000,50000,10
TIKI,do-choi-me-be,191925662,"Boardgame Thám Tử Lừng Danh Conan Nàng Dâu Halloween - Thính",89100,99000,9900,10
TIKI,thiet-bi-kts-phu-kien-so,174593860,"Chuột Không Dây Bluetooth PIX-LINK P100B Chống Ồn, DPI 1600, Chế Độ Kép Wireless Usb 2.4Ghz, Bluetooth Dùng Cho Macbook, Laptop, PC - Hàng chính Hãng",133000,299000,166000,56
TIKI,do-choi-me-be,73243127,"Cetaphil tắm gội hữu cơ Organic - Cetaphil Baby Wash & Shampoo with Organic Calendula ",275500,530000,254500,48
TIKI,do-choi-me-be,190712077,"Combo 10 gói khăn giấy lau tay Roto eco20-2 RT20-2 hai lớp 100% bột giấy nguyên sinh, dài 20cm, họa tiết chấm bi xốp, thấm hút 2 chiều, gồm 102 tờ/gói",130000,180000,50000,28
TIKI,thiet-bi-kts-phu-kien-so,97547734,"Giá Đỡ Để Bàn Điện Thoại Di Động, Máy Tính Bảng, Ipad Hợp Kim Nhôm Cao Cấp Hai Trục Xoay 180 Độ Chống Đổ Hàng Chính Hãng Tamayoko",390000,450000,60000,13
TIKI,do-choi-me-be,136981293,"Hộp 1 Bình sữa mô phỏng tự nhiên hiệu Philips Avent cho trẻ từ 6 tháng tuổi",305000,305000,0,0
TIKI,do-choi-me-be,176472306,"Ghế gội đầu cho bé Holla 03151 - Hàng chính hãng",509000,660000,151000,23
TIKI,thiet-bi-kts-phu-kien-so,123518348,"Tai nghe Remax RM-201 - Hàng chính hãng",112250,150000,37750,25
TIKI,thiet-bi-kts-phu-kien-so,88798139,"Dây Cáp Dù Lõi HDMI 2.1 8K 48Gbps, 4K 165Hz Dài 2M CHOETECH XHH01 Dùng Cho Tivi/ Máy Tính/ Playstation - Hàng Chính Hãng",219000,390000,171000,44
TIKI,do-choi-me-be,136021304,"Thùng mix vị 18 hộp sữa đêm tăng cân Fruto Nyanya 200ml/hộp",497664,622080,124416,20
TIKI,thiet-bi-kts-phu-kien-so,36007224,"Bàn phím có dây Dell KB216 USB - Hàng Chính Hãng",160000,160000,0,0
TIKI,thiet-bi-kts-phu-kien-so,137864606,"Tấm Lót Chuột, Thảm Da Trải Bàn Làm Việc VinBuy, Miếng Di Chuột Cỡ Lớn 40cmx80cm - Hàng Chính Hãng",90000,180000,90000,50
TIKI,thiet-bi-kts-phu-kien-so,3671793,"Sim 4G Mobifone 12FD50 Tặng 150GB/Tháng(5GB/Ngày) Trọn Gói 1 Năm- Hàng Chính Hãng - Mẫu ngẫu nhiên",750000,750000,0,0
TIKI,thiet-bi-kts-phu-kien-so,273891515,"Cáp sạc siêu nhanh PD 100W iCybernet IC-1004 C to C chiều dài 1m - Hàng chính hãng",98000,150000,52000,35
TIKI,thiet-bi-kts-phu-kien-so,174593826,"Lót chuột máy tính PixLink kích thước 22x18cm hàng chính hãng",14000,39000,25000,64
TIKI,thiet-bi-kts-phu-kien-so,123836523," Adapter Sạc 1 Cổng USB Type-C 20W Apple MHJE3ZA/A",450000,790000,340000,43
TIKI,thiet-bi-kts-phu-kien-so,73179180,"Thẻ Nhớ microSD SanDisk Ultra 128GB UHS-I - 100MB/s (New 2020) - Hàng Nhập Khẩu",229000,229000,0,0
TIKI,thiet-bi-kts-phu-kien-so,73315307,"Thẻ Nhớ microSD SanDisk Ultra 64GB UHS-I - 100MB/s (New 2020) - Hàng Nhập Khẩu",129000,129000,0,0
TIKI,thiet-bi-kts-phu-kien-so,174490279,"Chuột không dây bluetooth Logitech Signature M650 - Dành cho tay có kích cỡ từ nhỏ tới trung bình, Cuộn SmartWheel, giảm ồn, các nút bên có thể tùy chỉnh - Hàng chính hãng",576000,869000,293000,34
TIKI,thiet-bi-kts-phu-kien-so,273906695,"Cáp sạc và truyền dữ liệu 2.4A iCybernet IC-1002 USB to TypeC - Hàng chính hãng",58000,100000,42000,42
TIKI,do-choi-me-be,109334060,"Núm ty ngậm thông khí Philips Avent hình thú (phiên bản Lime) cho trẻ từ 6-18 tháng tuổi _ vỉ đôi",245000,245000,0,0
TIKI,thiet-bi-kts-phu-kien-so,72796676,"Giá Đỡ Laptop Hợp Kim Nhôm Cao Cấp Có Thể Gấp Gọn, Giúp Tản Nhiệt Laptop, Macbook, Máy Tính Xách Tay. 07 Vị Trí Điều Chỉnh Góc Độ. Hàng Chính Hãng Tamayoko FS060",179000,179000,0,0
TIKI,thiet-bi-kts-phu-kien-so,1059892,"Dây Cáp Sạc Lightning Cho iPhone Anker PowerLine II 0.9m - A8432H21",260000,330000,70000,21
TIKI,do-choi-me-be,120170570,"Xe chòi chân kiêm xe đạp cho bé Motion - Xe thăng bằng khung thép, ghế da cho trẻ em DC018",239000,239000,0,0
TIKI,do-choi-me-be,120380556,"Combo 2 nước rửa bình sữa  (Gói)",142400,160000,17600,11
TIKI,thiet-bi-kts-phu-kien-so,19419738,"Bộ Thu Phát Bluetooth TP-Link UB400 USB Nano Bluetooth 4.0 - Hàng Chính Hãng",102000,102000,0,0
TIKI,do-choi-me-be,110756554,"Ghế Ăn Dặm Cho bé tặng kèm chân cao",259000,259000,0,0
TIKI,do-choi-me-be,116572144,"Thùng 4 lon sữa bột dinh dưỡng công thức HiPP 3 Organic Combiotic chất lượng hữu cơ tăng cường sức khoẻ hệ miễn dịch, bổ sung Canxi và vitamin D dành cho trẻ trên 12 tháng tuổi (4 lon x 800g)",2880000,2880000,0,0
TIKI,thiet-bi-kts-phu-kien-so,273908702,"Bộ sạc nhanh IP công suất 20W chuẩn PD iCybernet IC-3001 (C to L cho IP14 trở xuống) - Hàng chính hãng",192000,300000,108000,36
TIKI,thiet-bi-kts-phu-kien-so,299461,"Chuột Không Dây Logitech M331 Silent",389000,389000,0,0
TIKI,thiet-bi-kts-phu-kien-so,162772687,"Chuột không dây Logitech SIGNATURE M650 Wireless/Bluetooth - Hàng Chính Hãng",650000,650000,0,0
TIKI,thiet-bi-kts-phu-kien-so,76480235,"Bao Tay Chơi Game Cảm Ứng Chống Mồ Hôi SIDOTECH Siêu Mỏng Vải Sợi Carbon Siêu Bền Chống Giãn Xù, Cảm Ứng Nhạy Thuộc Dòng Găng Tay Chơi Game Bao Ngón Tay Cho PUBG Tốc Chiến Freefire Liên Quân mobile - Hàng Chính Hãng",26000,26000,0,0
TIKI,thiet-bi-kts-phu-kien-so,134364129,"Bộ Thu Phát Bluetooth TP-Link UB500 USB Nano Bluetooth 5.0 - Hàng Chính Hãng",118000,118000,0,0
TIKI,do-choi-me-be,4317493,"Nước lau bàn ăn Hando 500ml",32000,32000,0,0
TIKI,thiet-bi-kts-phu-kien-so,172146754,"Ốp lưng chống sốc lưng trong phong cách mới dành cho iPhone 11 / 12 / 13 / 11 Pro / 12 Pro / 13 Pro / 11 Pro Max / 12 Pro Max / 13 Pro Max / 12 Mini / 13 Mini - Hàng chính hãng",179000,250000,71000,28
TIKI,thiet-bi-kts-phu-kien-so,1935009,"Tai Nghe Apple EarPods Cổng Lightning - MMTN2",480000,790000,310000,39
TIKI,thiet-bi-kts-phu-kien-so,189474023,"Sạc dự phòng không dây từ tính Remax RPP-65 10000mAh - Hàng chính hãng",753500,990000,236500,24
TIKI,do-choi-me-be,73535991,"Khăn sữa sợi tre mềm mại thấm hút tốt, thương hiệu KACHOO 8 cái/hộp kích thước 30x30cm",79000,79000,0,0
TIKI,do-choi-me-be,117261556,"Bàn chải Colgate Minion dành cho bé từ 2 tuổi",35000,37000,2000,5
TIKI,do-choi-me-be,173858511,"Xe ô tô điều khiển từ xa KAVY 608 tỷ lệ 1:12 kích cỡ rất lớn tốc độ cao, màu sắc cực kì ngầu",545000,545000,0,0
TIKI,thiet-bi-kts-phu-kien-so,299431,"Chuột Không Dây Logitech M221",280000,280000,0,0
TIKI,thiet-bi-kts-phu-kien-so,171657209,"Thẻ Nhớ Micro SDXC Samsung Evo Plus U3 130MB/s 128GB New  - Hàng Nhập Khẩu",295000,295000,0,0
TIKI,thiet-bi-kts-phu-kien-so,158868703,"[Miễn Phí 12 Tháng] SIM MAX DATA 4G VIETNAMOBILE 6GB/Ngày. Trọn Gói 1 Năm - Hàng Chính Hãng",368000,650000,282000,43
TIKI,thiet-bi-kts-phu-kien-so,174593840,"Chuột Không Dây PIX-LINK P100 Wireless 2.4Ghz Sạc Pin, Chống Ồn, DPI1600 Dùng Cho Máy Tính, Laptop, Tivi-Hàng Chính Hãng",115000,230000,115000,50
TIKI,thiet-bi-kts-phu-kien-so,56859344,"Chuột không dây sạc điện HXSJ M103 - Hàng chính hãng",119000,199000,80000,40
TIKI,thiet-bi-kts-phu-kien-so,273908828,"Bộ sạc nhanh IP, Android chuẩn PD 20W iCybernet IC-3002 cáp C to C 1,2m (Cáp hỗ trợ sạc tối đa 100W cho mọi thiết bị typeC) - Hàng chính hãng",192000,300000,108000,36
TIKI,do-choi-me-be,47208389,"[ComBo 2 Hộp ] Thông Tắc Ngẽn Bồn Cầu, Thông Tắc Ngẽn Cống, Bột thông cống mạnh. Loại lớn 260+-30g. Xử Lý nhanh tắc ngẽn",69000,69000,0,0
TIKI,do-choi-me-be,109127772,"Núm ty ban đêm Philips Avent cho trẻ từ 6-18 tháng tuổi 376.21",265000,265000,0,0
TIKI,do-choi-me-be,95035959,"Dinh dưỡng 100% Trái cây nghiền Organic HiPPiS Táo, Chuối",60000,60000,0,0
TIKI,thiet-bi-kts-phu-kien-so,201437484,"Giá Đỡ Máy Tính, Laptop, iPad, Macbook Hợp Kim Nhôm Cao Cấp. Hỗ Trợ Tản Nhiệt Chống Mỏi Cổ, Vai, Gáy. Hàng Chính Hãng Tamayoko",479000,489900,10900,2
TIKI,thiet-bi-kts-phu-kien-so,113568856,"Tai nghe chụp tai không dây Remax RB-660HB - Hàng chính hãng",563500,700000,136500,20
TIKI,thiet-bi-kts-phu-kien-so,56889347,"Chuột Không Dây HXSJ X50 Plus - Hàng Chính Hãng",129000,245000,116000,47
TIKI,thiet-bi-kts-phu-kien-so,146266186,"Miếng Lót Chuột Kai Hình Chữ Nhật Siêu Dễ thương Nhiều Mẫu Mới",23000,28000,5000,18
TIKI,thiet-bi-kts-phu-kien-so,389145,"Chuột không dây Logitech B175 - đầu thu USB 2.4Ghz, pin 1 năm, nhỏ gọn, thiết kế thuận cả 2 tay, phù hợp PC/ Laptop - Hàng chính hãng",199000,199000,0,0
TIKI,do-choi-me-be,15356106,"Thùng 48 Hộp Sữa Bột Pha Sẵn Vinamilk Dielac Grow Plus - Đỏ 110ml",403000,403000,0,0
TIKI,dien-gia-dung,85137578,"Máy sấy chén Cuckoo 40 lít CDD-A910S - Hàng chính hãng",3492000,3492000,0,0
TIKI,dien-gia-dung,170184016,"Máy Trộn Bột Đánh Trứng Đa Năng UNIE EM5 Cao Cấp Tiêu Chuẩn Đức Dung Tích 8 Lít Công Suất 1300W  - Hàng Chính Hãng",7789000,7789000,0,0
TIKI,dien-gia-dung,82912300,"Quạt đứng hẹn giờ SENKO DH1600 - Hàng chính hãng",465000,465000,0,0
TIKI,dien-gia-dung,75443000,"Máy Hút Bụi Ô Tô Cầm Tay Không Dây Damas XC628 - Máy có thể hút khô và nước - Sử dụng sạc pin - Hàng Nhập Khẩu",441000,700000,259000,37
TIKI,dien-gia-dung,74261830,"Máy Xay Cà Phê Mini Zamboo ZB-100GR - Hàng Chính Hãng",450000,450000,0,0
TIKI,dien-gia-dung,80087066,"Nồi áp suất điện đa năng 6L Tefal CY601868 - Hàng chính hãng",1865000,2242800,377800,17
TIKI,dien-gia-dung,46812719,"Máy Cạo Râu Thanh Lịch Tiện Dụng SK301 Kèm Một Bộ Lưỡi Và Lưới Bảo Vệ ",86000,86000,0,0
TIKI,dien-gia-dung,109328166,"Quạt không cánh siêu mát an toàn Kjapan CR-309 để bàn hoặc treo tường",1299000,1299000,0,0
TIKI,dien-gia-dung,112092520,"Máy Xay Sinh Tố Lock&Lock EJM436 (250W - 600ml) - Hàng Chính Hãng, Lưỡi Xay Inox 304, Thao Tác Một Chạm Đơn Giản, Chân Đế Chống Trượt - Tặng Kèm Ống Hút Và Cọ Rửa",526000,920000,394000,43
TIKI,dien-gia-dung,187183489,"Hàng chính hãng Quạt đối lưu không khí Iris Ohyama STF-DC18T",3400000,4000000,600000,15
TIKI,dien-gia-dung,66456774,"Ấm Đun Thủy Tinh Siêu Tốc Cao Cấp Đa Năng Ariranglife AL-A17G5 – màu xám (1,7 lít) - Ấm Đun Thủy Tinh Thông Minh Chịu Nhiệt - Bình đun thủy tinh siêu nhanh cao cấp đa năng, có thể đun nước, pha trà, pha sữa, pha mì, tự ngắt điện khi sôi, an toàn sức khỏe",389000,799000,410000,51
TIKI,dien-gia-dung,93405093,"_Tụ quạt điện",20000,20000,0,0
TIKI,dien-gia-dung,3492413,"Máy sấy hoa quả Makxim USA MKX-DH-2015 - Hàng chính hãng",1145000,1145000,0,0
TIKI,dien-gia-dung,108747198,"Quạt treo tường Senko TR1628 có remote điều khiển - Bảo hành 2 năm - Hàng chính hãng - Được chọn màu",535000,535000,0,0
TIKI,dien-gia-dung,82874777,"Quạt Lỡ ống nhựa SENKO L1638 - Hàng chính hãng",385000,385000,0,0
TIKI,dien-gia-dung,111641927,"Quạt hút gió hình sên 200w - Quạt hút mùi, thông gió lưu lượng lớn - Chuyên dùng cho nhà xưởng, bếp công nghiệp",904000,904000,0,0
TIKI,dien-gia-dung,72519557,"Nồi Nấu Mỳ Lẩu Điện Chảo Lẩu Chống Dính Men Gốm Ceramic Nắp Kính Cường Lực",393995,393995,0,0
TIKI,dien-gia-dung,1275469,"Máy Lọc Không Khí Bắt Muỗi Sharp FP-GM50E - Đen - Hàng chính hãng",4541000,5690000,1149000,20
TIKI,dien-gia-dung,140100854,"Bếp Từ Cảm Ứng Lock&Lock EJI411 (2000W) Mặt Kính Cảm Ứng, Chế Độ Hẹn Giờ, Làm Mát Nhanh - Hàng Chính Hãng Tặng Combo Ống Hút + Cọ Rửa",1219000,2228000,1009000,45
TIKI,dien-gia-dung,82673534,"Quạt treo 2 dây SENKO TC1626 - Hàng chính hãng",350000,350000,0,0
TIKI,dien-gia-dung,196153245,"Nồi chiên không dầu màu Pastel Gaabor AF50T-WH01A dung tích 5 lít công suất mạnh 1400W - Hàng chính hãng",999500,1999000,999500,50
TIKI,dien-gia-dung,114929040,"Máy xay cà phê tay C2 - Khung kim loại và Lưỡi thép tiện không rỉ",1390000,1390000,0,0
TIKI,dien-gia-dung,183567346,"Máy Hút Bụi Không Dây Cầm Tay DREAME T30 Pin Rời Thuận Tiện Sạc Điện Siêu Nhẹ Thời Gian Làm Việc 45 - 90 Phút Lực Hút 27KPa Công Suất Cao 550 W - Hàng Chính Hãng",8799000,17519000,8720000,50
TIKI,dien-gia-dung,449129,"Bình Thủy Điện Sunhouse SHD1542 (4.2 lít) - Hàng chính hãng",983500,983500,0,0
TIKI,dien-gia-dung,43935650,"Máy xay ép đa năng Panasonic MJ-M176 - hàng nhập khẩu",2089000,2089000,0,0
TIKI,dien-gia-dung,72801254,"Bàn ủi hơi nước bình treo công nghiệp ES-94AL Silver Star - Hàng chính hãng",2200000,2200000,0,0
TIKI,dien-gia-dung,56404404,"Máy làm bánh nướng bánh hình thú Magic cao cấp tặng kèm máy đánh trứng và đầu chuyển 3 chấu thành 2 chấu",265000,265000,0,0
TIKI,dien-gia-dung,273020028,"Nồi Chiên Không Dầu KALITE KL-1200 Dung Tích 12 Lít Công Suất 1800 W - Hàng Chính Hãng",2999000,5979000,2980000,50
TIKI,dien-gia-dung,32392226,"Máy sấy tóc có giá đỡ cho phòng tắm nhà hàng khách sạn Interhasa - Hàng nhập khẩu",318000,318000,0,0
TIKI,dien-gia-dung,58057110,"Máy xay sinh tố Philips HR2222/00 (700W) - Hàng Chính Hãng",1425000,1567000,142000,9
TIKI,dien-gia-dung,146214755,"Máy Hút Bụi Cầm Tay cho Xe Hơi/Ô tô Dòng Điện DC USA Stanley SL18125DC - Hàng Chính Hãng",980000,980000,0,0
TIKI,dien-gia-dung,163297792,"[Hàng Chính Hãng] Máy Ép Hoa Quả Nhanh Cao Cấp Promix FJ-01",2049000,2600000,551000,21
TIKI,dien-gia-dung,52049251,"Máy Đánh Trứng Cầm Tay 7 Tốc Độ Công Suất 180W",73000,88000,15000,17
TIKI,dien-gia-dung,147721633,"[HCM]Quạt Kẹp Bình 12V Công Nghiệp B3 Lổ Cắm 5.5 ly 3 Tốc Độ Gió Chạy Trực Tiếp NLMT. HÀNG CHÍNH HÃNG",249000,249000,0,0
TIKI,dien-gia-dung,220661346,"Bàn Ủi Hơi Nước Cầm Tay Sokany 3060 Có Thể Gấp Gọn - Hàng Chính Hãng",404000,439000,35000,8
TIKI,dien-gia-dung,180318163,"Lược Điện Chải Tóc Chuyên Nghiệp - Kiêm Máy Uốn - Duỗi - Ép Tóc - Tạo Kiểu Nhanh Chóng Với 6 Mức Nhiệt ",69894,69894,0,0
TIKI,dien-gia-dung,186276961,"Nồi Chiên Không Dầu Elmich AFE-3950 (14Lít) - Hàng Chính Hãng",3350000,4690000,1340000,29
TIKI,dien-gia-dung,173098007,"Bàn ủi hơi nước đứng - Là mọi chất liệu, kèm Kệ bàn là tiện dụng - PORYVOS",1090000,1090000,0,0
TIKI,dien-gia-dung,17965393,"Tông Đơ Cắt Tóc Gia Đình Công Nghệ Hàn Quốc Codol 531, Tông Đơ Cắt Tóc Đa Năng - Nhỏ Gọn - An Toàn - Dễ Sử Dụng",189997,189997,0,0
TIKI,dien-gia-dung,103368920,"Ấm Siêu Tốc Thủy Tinh Sunhouse SHD1215B (Đen) - Hàng Chính Hãng",300000,300000,0,0
TIKI,thiet-bi-kts-phu-kien-so,197541988,"[ VGA Male ra HDMI Female ] Đầu chuyển đổi tín hiệu VGA ra HDMI Vention ACNB - Hàng chính hãng",220000,220000,0,0
TIKI,thiet-bi-kts-phu-kien-so,45163095,"Loa Karaoke Bluetooth xách tay Kimiso KMS-S1 và micro có dây Hàng chính hãng",314500,314500,0,0
TIKI,thiet-bi-kts-phu-kien-so,12480771,"Loa Vi Tính (Có tích hợp thêm chức năng Bluetooth) Bosston T3500-BT ",303150,303150,0,0
TIKI,thiet-bi-kts-phu-kien-so,7192285,"Ốp Lưng Dành Cho iPhone 7 Plus / 8 Plus Họa Tiết Ô Vuông",45000,55000,10000,18
TIKI,thiet-bi-kts-phu-kien-so,72128011,"Ốp Lưng Nillkin Super Frosted Shield Matte cho Samsung Galaxy Note 20 Ultra _ Hàng Nhập Khẩu",115000,115000,0,0
TIKI,thiet-bi-kts-phu-kien-so,122965917,"Tripod - Giá Đỡ Điện Thoại 3 Chân Live Stream Quay Video Tiktok LT-04",151050,159000,7950,5
TIKI,thiet-bi-kts-phu-kien-so,184770634,"Dây cáp sạc Type C sạc nhanh 100W chuẩn PD 3.0 Type C to Type C hiệu Baseus Display Fast Charging Data Cable trang bị màn hình LED chuẩn 5A/QC 4.0, Smartchip - hàng nhập khẩu",186000,186000,0,0
TIKI,thiet-bi-kts-phu-kien-so,11522917,"Bàn Phím Siêu nhỏ gọn Mini Keyboard K1000 (Tặng kèm cáp OTG)",80900,80900,0,0
TIKI,thiet-bi-kts-phu-kien-so,133138645,"Chuột E-DRA EM630 Ultra Light - Hàng chính hãng ",369000,369000,0,0
TIKI,thiet-bi-kts-phu-kien-so,25813422,"Bao Da Cover Cho Máy Tính Bảng Huawei Mediapad T5 10.1 inch Hỗ Trợ Smart Cover",129000,129000,0,0
TIKI,thiet-bi-kts-phu-kien-so,91241820,"Miếng Dán PPF Cầu Vồng Tự Phục Hồi Mặt Sau cho iPhone X/ XS/ XS Max/ 11/ 11 Pro/ 11 Pro Max/ 12 Mini/ 12/ 12 Pro/ 12 Pro Max - Hàng Chính Hãng",48999,48999,0,0
TIKI,thiet-bi-kts-phu-kien-so,188128780,"Củ loa bass 30 từ 140 coil 51 Sườn nhôm Hải Triều (hàng chính hãng) 1 cặp.",940000,940000,0,0
TIKI,thiet-bi-kts-phu-kien-so,143494566,"Kính Cường Lực Camera Lens Zeelot Titanium Dành Cho iPhone 12 Promax/ 12 Pro_ Hàng Chính Hãng",250000,250000,0,0
TIKI,thiet-bi-kts-phu-kien-so,144294839,"Bộ Củ Sạc Nhanh CHOETECH 38W PD5002 Và Cáp C to C 60W Dài 1.8M CC0005-SR Cho Điện Thoại Samsung, Oppo, Vivo, Xiaomi - Hàng Chính Hãng",429000,790000,361000,46
TIKI,thiet-bi-kts-phu-kien-so,150673043,"Giá đỡ chống rung ulanzi Iron Man II bằng nhôm cho điện thoại	ST-02 Đen - Hàng Nhập Khẩu",188100,198000,9900,5
TIKI,thiet-bi-kts-phu-kien-so,89746305,"Pin Dành Cho điện thoại Vsmart Bee",149000,149000,0,0
TIKI,thiet-bi-kts-phu-kien-so,105737570,"Bao Da Cover Cho Máy Tính Bảng Amazon Kindle Fire HD 10 / HD 10 Plus 2021",129000,129000,0,0
TIKI,thiet-bi-kts-phu-kien-so,16217219,"Đầu đọc thẻ nhớ Nhôm NS 4667",10899,10899,0,0
TIKI,thiet-bi-kts-phu-kien-so,47733739,"Cáp LN Mophie 9cm - chống rối - đạt chứng nhận MFI từ Apple dành cho iPhone - Hàng chính hãng",450000,450000,0,0
TIKI,thiet-bi-kts-phu-kien-so,91190769,"Dây AV nối dài 3.5mm đầu mạ vàng dài từ 0.5-2m UGREEN AV118 - Hàng chính hãng",139000,139000,0,0
TIKI,thiet-bi-kts-phu-kien-so,73633117,"VINETTEAM Giá Đỡ Laptop Máy Tính Bảng Để Bàn Hợp Kim Nhôm Cao Cấp  Giúp Tản Nhiệt Gọn Nhẹ Sử Dụng Từ 10 - 18 Inch - hàng chính hãng ",245000,250000,5000,2
TIKI,thiet-bi-kts-phu-kien-so,27983285,"Ốp lưng dẻo trong suốt chính hãng Nillkin Nature dành cho SamSung Galaxy Note 10 Plus",89000,89000,0,0
TIKI,thiet-bi-kts-phu-kien-so,3528399,"Dây cáp dẹt 2 đầu HDMI 3m",22225,22225,0,0
TIKI,thiet-bi-kts-phu-kien-so,55457074,"Bộ 2 chiếc găng tay chơi game, bao tay chơi game, mobile chống trơn trượt mồ hôi tay thao tác dễ dàng - Hàng Nhập Khẩu",30355,43846,13491,31
TIKI,thiet-bi-kts-phu-kien-so,35848771,"Dây loa 1 đầu 3.5 ra 2 AV dài 5m",20900,20900,0,0
TIKI,thiet-bi-kts-phu-kien-so,262689341,"Ruizu H10 - Máy Nghe Nhạc Buetooth 5.0 Hai Chiều, Màn Hình Cảm Ứng, Xem Phim Full HD, Có Loa Ngoài (16GB) - Hàng Chính Hãng",1049000,1049000,0,0
TIKI,thiet-bi-kts-phu-kien-so,7478243,"Module Băm Xung PWM V4 Điều Khiển Tốc Độ Đông Cơ DC 12V-40V 10A",30000,30000,0,0
TIKI,thiet-bi-kts-phu-kien-so,43831781,"Midle Green - Ốp lưng chống sốc cho iPhone 11 Pro Max (6.5 inch) hiệu Memumi Ultra Thin độ mỏng 0.3mm , có gờ bảo vệ Camera - Hàng nhập khẩu",81167,162334,81167,50
TIKI,thiet-bi-kts-phu-kien-so,43130947,"Dây cáp sạc nhanh đầu USB-C to light sạc  cho iPhone / iPad dài 100cm hiệu CHOETECH S-MT009L cho iPhone / iPad (sạc nhanh 2.4A, chất liệu cao cấp, chip sạc thông minh) - Hàng chính hãng",99000,99000,0,0
TIKI,thiet-bi-kts-phu-kien-so,373571,"Chuột Có Dây Newmen M180 - Hàng Chính Hãng",77000,77000,0,0
TIKI,thiet-bi-kts-phu-kien-so,6706511,"Cây Que Chọc Sim Dùng Cho Điện Thoại Và Máy Tính Bảng",1097,1097,0,0
TIKI,thiet-bi-kts-phu-kien-so,186242839,"Tai Nghe Chụp Tai Máy Tính Teement TM01 Gaming MC Q9 Có Đèn Led Đổi Màu, Mic Đàm Thoại, Headphone Chơi Game Trên Laptop, Pc - Hàng Chính Hãng",345000,345000,0,0
TIKI,thiet-bi-kts-phu-kien-so,19339749,"Bao Da Cover Cho Máy Đọc Sách Kindle Gen 9 10th 2019 Da",150000,150000,0,0
TIKI,thiet-bi-kts-phu-kien-so,66622335,"Chuột không dây A2 thiết kế thon gọn, không tạo tiếng ồn, có cổng micro USB để sạc, Led 7 màu sinh động",67900,67900,0,0
TIKI,thiet-bi-kts-phu-kien-so,55670282,"Chân cắm sạc tròn chắc chắn, thẩm mỹ thay thế cho chân dẹt của Iphone/Ipad/Macbook",45000,45000,0,0
TIKI,thiet-bi-kts-phu-kien-so,125772673,"Miếng Dán Cường Lực Mipow Kingbull Mờ Chống Vân MIPOW KINGBULL ANTI-GLARE Premium Silk HD (2.7D) iPhone 13 Mini / iPhone 13/ iPhone 13 Pro/ iPhone 13 ProMax_ Hàng Chính Hãng",277000,299000,22000,7
TIKI,thiet-bi-kts-phu-kien-so,58079182,"Micro Behringer SL 75C - Dynamic Cardioid Microphone- Hàng chính hãng",630000,630000,0,0
TIKI,thiet-bi-kts-phu-kien-so,103124618,"Adapter Sạc 12W dành cho iPad/ iPhone",95000,169000,74000,44
TIKI,thiet-bi-kts-phu-kien-so,75582647,"Bộ Cốc sạc và Cáp sạc nhanh Baseus Super Si PD 20W CCCJGCC for iPhone 12 (Hàng chính hãng)",299000,299000,0,0
TIKI,thiet-bi-kts-phu-kien-so,88798444,"Dây Cáp Máy In USB 2.0 Từ USB-A To Type-B Dài 3M CHOETECH AB0011 - Hàng Chính Hãng",109000,150000,41000,27
TIKI,dien-gia-dung,41095382,"Quạt Lồng Sắt Mini 4 Cánh Để Bàn",48441,50990,2549,5
TIKI,dien-gia-dung,42648351,"Máy Làm Sữa Đậu Nành Lock&Lock EJS226 (1.3 Lít) - Hàng Chính Hãng",1680000,3344000,1664000,50
TIKI,dien-gia-dung,91023317,"Quạt mini, quạt tích điện để bàn cầm tay Bamboo Life chính hãng dung lượng pin 4000mAh xoay 360 độ sạc pin kẹp nôi kẹp xe đẩy cho bé",249000,249000,0,0
TIKI,dien-gia-dung,113633607,"Bếp từ đơn Hafele HSI-21FW (Hàng chính hãng)",1129000,2030000,901000,44
TIKI,dien-gia-dung,56048866,"Lõi Lọc Diệt Khuẩn Cho Máy Lọc Không Khí Xiaomi Mi Air Purifier HEPA Filter Màu Xám - Hàng Chính Hãng",649000,649000,0,0
TIKI,dien-gia-dung,106053875,"Robot Hút Bụi Lau Nhà LIECTROUX C30B- Hàng chính hãng.",3467000,3617000,150000,4
TIKI,dien-gia-dung,35035538,"Bàn là hơi nước cầm tay gấp gọn",265000,265000,0,0
TIKI,dien-gia-dung,2393139,"Nồi Lẩu Điện Sunhouse SHD4521 (3L) - Hàng chính hãng",479000,776000,297000,38
TIKI,dien-gia-dung,147903537,"Bếp Từ Đơn Sunhouse SHD6157 (1800W) - Kèm Nồi Lẩu - Hàng Chính Hãng",679000,1094000,415000,38
TIKI,dien-gia-dung,124481286,"Máy ép chậm, máy ép trái cây Mitomo EC-55 hàng chính hãng",1320000,1320000,0,0
TIKI,dien-gia-dung,984199,"Máy Sấy Tóc Ion Panasonic PAST-EH-NE81-K645 - Hàng Chính Hãng",1150000,1330000,180000,14
TIKI,dien-gia-dung,1695753,"Máy Sấy Tóc Philips HP8108/00 - Hàng Chính Hãng",230000,320000,90000,28
TIKI,dien-gia-dung,60824784,"Máy Lọc Nước Pureit Classic Không Dùng Điện - Hàng Chính Hãng",1195000,2390000,1195000,50
TIKI,dien-gia-dung,35597937,"Máy hút bụi mini cầm tay DEERMA DX118C - Giao màu ngẫu nhiên - Hàng chính hãng",489000,538000,49000,9
TIKI,dien-gia-dung,2365901,"Nồi Cơm Nắp Gài Toshiba RC-10JFM(H)VN (1L) - Hàng chính hãng",479000,650000,171000,26
TIKI,dien-gia-dung,72285990,"Máy Sấy Tóc Cao Cấp Kiểu Dáng Sang Trọng Tinh Tế Công Suất Lớn Chuyên Dụng Tại Nhà và Cho Hair Salon - Máy Sấy Tóc Bổ Sung Ion Dưỡng Ẩm, Làm Mềm Mượt Tóc - Máy Sấy Tóc Cao Cấp Động Cơ Êm Ái, Ổn Định – Chính Hãng VinBuy (Máy sấy tóc) - Đỏ",254000,450000,196000,44
TIKI,dien-gia-dung,179237419,"Quạt Mini Để Bàn, Quạt Tích Điện USB Cầm Tay, Quạt Kẹp Bàn Đa Năng SeaSy SS74, 3 Cấp Độ Gió Cực Mát, Điều Chỉnh Hướng Gió 720 Độ, Không Gây Tiếng Ồn, Pin Dung Lượng Lớn, Sử Dụng Trong Nhiều Giờ – Hàng Chính Hãng",177000,209000,32000,15
TIKI,dien-gia-dung,900834,"Nồi Cơm Điện Kangaroo KG826S (1.2L) - Cam - Hàng chính hãng",535000,970000,435000,45
TIKI,dien-gia-dung,183484077,"Nồi Lẩu Điện Mini 2 Mức Nhiệt - Ca Nấu Mì Điện Đa Năng DAMAS DK-8012 (1.2 Lít) - Hàng Chính Hãng",259000,500000,241000,48
TIKI,dien-gia-dung,114750893,"Nồi Lẩu Mini 2 Tầng - Nồi Điện Đa Năng Tặng Kèm Khay Hấp Cao Cấp 1.2 Lít - Hàng Chính Hãng miDoctor - Logo trên thân nồi hình ngẫu nhiên",164000,220000,56000,25
TIKI,dien-gia-dung,658092,"Quạt treo tường 2 dây SENKO TC1626 - Hàng Chính Hãng",375000,375000,0,0
TIKI,dien-gia-dung,20831639," Bộ lõi lọc nước Kangaroo số 1, 2, 3 Hàng chính hãng",89000,92000,3000,3
TIKI,dien-gia-dung,74173695,"Bộ Lọc Thay Thế Pureit Classic - Hàng chính hãng",470000,470000,0,0
TIKI,dien-gia-dung,126415343,"Bếp hồng ngoại Sanaky SNK-2018HG - Hàng chính hãng",550000,980000,430000,44
TIKI,dien-gia-dung,214154250,"Nồi cơm điện mini Barwell GMBear Jiashi đa năng dùng cho 1-3 người ăn kèm muỗng, cốc đong và khay hấp - Hàng chính hãng, giao màu ngẫu nhiên",416500,490000,73500,15
TIKI,dien-gia-dung,70832055,"Máy Cạo Râu Panasonic ES534DP527 - Hàng Chính Hãng",200000,219000,19000,9
TIKI,dien-gia-dung,38041512,"Nồi Chiên Không Dầu Magic A-801 (6.0 Lít)",1270000,2590000,1320000,51
TIKI,dien-gia-dung,448842,"Máy Sấy Tóc Panasonic PAST-EH-ND11-W645 - Hàng Chính Hãng",329000,329000,0,0
TIKI,dien-gia-dung,113274611,"Máy phun sương nano tạo ẩm không khí SEASY SS12, máy xông và khuyếch tán tinh dầu dung tích 3 lít với 3 chế độ phun, tích hợp đèn ngủ tự thay đổi màu sắc, phun liên tục 20h và tự ngắt khi hết nước - Hàng chính hãng",291000,439000,148000,34
TIKI,dien-gia-dung,126131828,"Máy cạo râu lưỡi kép 3 mức tốc độ Kemei KM-2026 màn hình LCD, công suất 5w mạnh mẽ dùng cạo trắng fade tóc, cạo trọc đầu tặng kèm lưỡi dự phòng",320000,654000,334000,51
TIKI,dien-gia-dung,147981051,"Máy làm tóc uốn, bấm, duỗi đa năng KM 1213 Nhiều Chức Năng Làm Phồng Uốn Cụp Uốn Xoăn Dập Xù Duỗi Thẳng (Màu Ngẫu Nhiên)",195000,195000,0,0
TIKI,dien-gia-dung,71111211,"TÔNG ĐƠ CẮT TÓC CHUYÊN NGHIỆP KEMEI- KM 809A",229000,458000,229000,50
TIKI,dien-gia-dung,57588479,"Máy Lọc Không Khí Lock&Lock ENP126WHT (23W) - Hàng Chính Hãng",2012000,4045000,2033000,50
TIKI,dien-gia-dung,650250,"Máy Hấp Thực Phẩm Magic Korea A64 (5.0 Lít) - Hàng chính hãng",325000,499000,174000,35
TIKI,dien-gia-dung,65221065,"Máy hút chân không tự động không kén túi P290B Hàng Nhập Khẩu",2200000,2200000,0,0
TIKI,dien-gia-dung,109393205,"Máy xay sinh tố cầm tay mini, cốc xay sinh tố đa năng CTFAST - JUICER 01 (50W - 300ml) : Thiết kế cảm ứng tự động, cốc xay thủy tinh an toàn tuyệt đối khi sử dụng, pin sạc 1500 mAh - Hàng chính hãng",190000,199000,9000,5
TIKI,dien-gia-dung,46134873,"Bàn Ủi Hơi Nước Đứng Philips GC482/29 (1600W)- Hàng Chính Hãng",1360000,1674000,314000,19
TIKI,dien-gia-dung,40307233,"Siêu sắc thuốc bắc tự động loại 2 lít  - mẫu ngẫu nhiên",189000,189000,0,0
TIKI,dien-gia-dung,188049859,"Máy uốn tóc tự động xoăn VIVID&VOGUE®️ VAV022B/Màu Hồng, máy uốn tóc cầm tay có trục uốn 28mm-Hàng chính hãng",500000,500000,0,0
TIKI,dien-gia-dung,48191840,"Máy Duỗi , Ép Tóc Mini Đa Năng Tiện Lợi Bàn Kẹp To An Toàn Dễ Dàng Sử Dụng MP035 (Màu Ngẫu Nhiên)",31999,31999,0,0
TIKI,lam-dep-suc-khoe,50736325,"Sáp Vuốt Tóc Apestomen Volcanic Clay V4 + Lược Bán Nguyệt",249000,249000,0,0
TIKI,lam-dep-suc-khoe,385574,"Durex Gel Bôi Trơn Play Massage 2 - in- 1 200ml",287000,300000,13000,4
TIKI,lam-dep-suc-khoe,118708687,"Máy Đo Nồng Độ Oxy Trong Máu và Nhịp Tim Dạng Kẹp Ngón Tay KINGTECH PULSE SPO2 - Hàng Chuẩn",229000,495000,266000,54
TIKI,lam-dep-suc-khoe,68826659,"Bàn Chải Đánh Răng Điện LocknLock Portable Electric Toothbrush ENR236 (162 x 20 x 20 mm)",186000,337000,151000,45
TIKI,lam-dep-suc-khoe,13325863,"Kem chống nắng nâng tông Skin Aqua Tone up Lavender cho da tối màu & da vàng, dạng sữa Sunplay Skin Aqua Tone Up UV Milk Lavender SPF 50+ PA++++ 50g",161000,199000,38000,19
TIKI,lam-dep-suc-khoe,426104,"Combo 3 Phim Thấm Dầu Jomi Mayan (70 Tờ) - Xanh",163000,198000,35000,18
TIKI,lam-dep-suc-khoe,95253531,"Combo Dầu gội, Dầu xả & Kem ủ TRESEMME Keratin Smooth Dưỡng tóc vào nếp suôn mượt vào nếp suôn mượt Công thức chuẩn salon Hydrolyzed Keratin 640g, 620g, 180ml",420000,640000,220000,34
TIKI,lam-dep-suc-khoe,3554629,"Dầu Gội Clear Sạch Gàu Dầu Gội Sạch Gàu Mát Lạnh Bạc Hà 3X Sức Mạnh Đánh Bay Gàu, Ngứa, Vi Khuẩn 1.4kg",265000,343000,78000,23
TIKI,lam-dep-suc-khoe,42889999,"Tẩy Da Chết Cà phê Đăk Lăk Cocoon 200ml",125000,125000,0,0
TIKI,lam-dep-suc-khoe,19640804,"Cân điện tử thông minh Xiaomi Body Composition Scale 2 - Chính hãng",480000,550000,70000,13
TIKI,lam-dep-suc-khoe,108535251,"Bao cao su Sagami 002 - Siêu mỏng - Non Latex - Hộp 6 chiếc",218000,300000,82000,27
TIKI,lam-dep-suc-khoe,10298023,"Saffron nhụy hoa nghệ tây Kingdom Herb Iran chính hãng loại thượng hạng hộp 1 gram",265000,519000,254000,49
TIKI,lam-dep-suc-khoe,124480931,"Derma Forte Gel 15g - Adavanced, Giảm Mụn Trứng Cá, Mờ Sẹo, Dưỡng Da",122000,160000,38000,24
TIKI,lam-dep-suc-khoe,90218797,"Bộ 2 Chai Nước súc miệng giúp nướu chắc khỏe Listerine Gum Care 750ml/chai 101109930",252000,326000,74000,23
TIKI,lam-dep-suc-khoe,133245970,"Bộ 2 đầu bàn chải điện P/S - Sạch Sâu",184000,245455,61455,25
TIKI,lam-dep-suc-khoe,8959289,"Kem chống nắng nâng tông Skin Aqua Tone up Lavender cho da tối màu & da vàng, dạng tinh chất Sunplay Skin Aqua Tone Up UV Essence Lavender SPF 50+ PA++++ 50g",161000,199000,38000,19
TIKI,lam-dep-suc-khoe,16625449,"(Mẫu mới) Bộ Đôi Kem Dưỡng Da Ngày Và Đêm Trắng Hồng Rạng Rỡ Pond's White Beauty (45g)",275000,300000,25000,8
TIKI,lam-dep-suc-khoe,125608918,"Megaduo Gel 15g - Giảm Mụn Trứng Cá, Ngừa Thâm, Mờ Sẹo, Dưỡng Da - Gam ma",129000,170000,41000,24
TIKI,lam-dep-suc-khoe,153599393,"Son lì dạng thỏi Flawsome Creamy Lip Stain (2g) Sunday Morning (Màu Đỏ hồng trầm)",145000,180000,35000,19
TIKI,lam-dep-suc-khoe,183076377,"Combo 3 Túi Khẩu Trang Y Tế ANYGUARD SENSE Lọc 99% Vi Khuẩn, Màu Sắc Trendy, An Toàn Da Nhạy Cảm Dành Cho Người Lớn (Túi 10 Chiếc/ Màu Xanh, Tím, Hồng)",71250,75000,3750,5
TIKI,lam-dep-suc-khoe,104397632,"Kem tẩy lông cho da nhạy cảm Veet Silk Fresh 50g",63000,70100,7100,10
TIKI,lam-dep-suc-khoe,190252222,"Khẩu trang KF94 - 4D An Tâm, không xù lông, dễ thở, ko đứt dây, nhiều màu ( 10 cái/túi)",7900,7900,0,0
TIKI,lam-dep-suc-khoe,26339567,"Cân Sức Khỏe Xiaomi Thông Minh Mi Smart Scale 2",295000,300000,5000,2
TIKI,lam-dep-suc-khoe,174834852,"Sữa Rửa Mặt Dạng Gel Dành Cho Da Nhờn Mụn SVR Sebiaclear Gel Moussant 400ml",388000,555000,167000,30
TIKI,lam-dep-suc-khoe,252035646,"Dầu Gội Dược Liệu Thái Dương 3 Hương Hoa Lá (500ml)",115000,115000,0,0
TIKI,lam-dep-suc-khoe,68832828,"Cân Sức Khỏe Điện Tử LocknLock ENC516BLK Dùng Trong Gia Đình - 180kg",423000,702000,279000,40
TIKI,lam-dep-suc-khoe,66469559,"Máy Xông Tinh Dầu Siêu Âm Dung Tích Lớn 500ml Có Điều Khiển Từ Xa",179000,358000,179000,50
TIKI,lam-dep-suc-khoe,1672155,"Bao cao su Durex Kingtex 3 bao",41000,49000,8000,16
TIKI,lam-dep-suc-khoe,272362188,"100 Viên Nến Tealight Sáp Cọ 2 giờ Lorganic An Toàn Sức Khỏe, dùng kết hợp với đèn xông và tinh dầu, khử mùi, xua đuổi muỗi và côn trùng hiệu quả, trang trí",95000,140000,45000,32
TIKI,lam-dep-suc-khoe,11949005,"[24 cái] Bộ 2 hộp bao cao su Innova Đen - Kéo dài thời gian | Hộp 12 cái",160000,160000,0,0
TIKI,lam-dep-suc-khoe,568659,"Mặt Nạ Ngủ Cho Môi Laneige Lip Sleeping Mask Berry 8g",195000,220000,25000,11
TIKI,lam-dep-suc-khoe,17043131,"Dầu gội TRESEMME Keratin Smooth Cho tóc khô xơ rối Công thức Hydrolyzed Keratin Dưỡng Tóc Vào Nếp Suôn Mượt 850g",252000,276000,24000,9
TIKI,lam-dep-suc-khoe,48627056,"Máy Massage Cầm Tay Đa Năng KINGTECH  KT1768 - Mát Xa Chuyên Sâu Cho Cổ, Vai Gáy, Bụng, Lưng, Cánh Tay, Chân - Giảm Đau Mỏi Toàn Thân Cho Dân Văn Phòng, Gymer, Người Già, Người Lao Động Nặng - Món Quà Tuyệt Vời Cho Ông Bà, Bố Mẹ - Hàng Chính Hãng",523000,1050000,527000,50
TIKI,lam-dep-suc-khoe,52280564,"Kem chống nắng nâng tông Skin Aqua Tone up Mint Green cho da trắng có khuyết điểm đỏ, dạng sữa Sunplay Skin Aqua Tone Up UV Milk Mint Green SPF 50+ PA++++ 50g",161000,199000,38000,19
TIKI,lam-dep-suc-khoe,125864764,"Combo Serum Dưỡng Sáng Mờ Thâm 3D Glow và Kem Dưỡng Ẩm Ngày Đêm Pond's Bright Beauty 30G & 45G x2",539000,559000,20000,4
TIKI,lam-dep-suc-khoe,385614,"Bao cao su Durex Pleasuremax Hộp 3 Bao",59000,70000,11000,16
TIKI,lam-dep-suc-khoe,74163324,"Khẩu Trang Y Tế Kháng Khuẩn Trẻ Em TDCare- Hộp 50 Cái.",27000,49000,22000,45
TIKI,lam-dep-suc-khoe,52758862,"[MẪU 2020] Lăn khử mùi Etiaxil Detranspirant Traitement Aisselles 15ml",189000,189000,0,0
TIKI,lam-dep-suc-khoe,92702781,"Serum chống nắng cơ thể Vaseline 50x bảo vệ da với SPF 50+ PA++++ giúp da sáng hơn gấp 2X 300ML",146000,190000,44000,23
TIKI,lam-dep-suc-khoe,48677365,"Bộ chiết mỹ phẩm mini 7 món tiện lợi",21990,21990,0,0
TIKI,thiet-bi-kts-phu-kien-so,20633527,"Cáp Tín Hiệu Chuyển Đổi VGA sang HDMI Có Audio - VGA to HDMI có AV",46000,71300,25300,35
TIKI,thiet-bi-kts-phu-kien-so,58080959,"Túi đựng dây sạc củ sạc chuột máy tính, tai nghe và phụ kiện công nghệ Baona - Hàng nhập khẩu",141840,177300,35460,20
TIKI,thiet-bi-kts-phu-kien-so,57799633,"Thiết Bị Thu Phát Nhạc Không Dây Bluetooth 5.0 BT-2IN1 AZONE",133000,138000,5000,4
TIKI,thiet-bi-kts-phu-kien-so,115487957,"Giá Đỡ Để Bàn Cho Điện Thoại, Máy Tính Bảng P10 - Chất Liệu Hợp Kim Nhôm Cao Cấp Gấp Gọn Siêu Di Động Model P10- Hàng Chính Hãng Tamayoko",129000,129000,0,0
TIKI,thiet-bi-kts-phu-kien-so,2002793,"Bộ Switch Ugreen Vào 3 HDMI Ra 1 HDMI 40234",495000,519000,24000,5
TIKI,thiet-bi-kts-phu-kien-so,110152488,"Bao Da Samsung Galaxy Tab S7 FE T730 / T736 12.4 Inch Cover Cho Máy Tính Bảng Hỗ Trợ Smart Cover",179000,179000,0,0
TIKI,thiet-bi-kts-phu-kien-so,3571519,"Bộ Thu Phát Âm Thanh Chuyển Đổi Bluetooth 4.1 TP-Link HA100 (Đen) - Hàng Chính Hãng",389000,699000,310000,44
TIKI,thiet-bi-kts-phu-kien-so,8031566,"Bộ sạc điện thoại gắn trực tiếp cho xe máy",34900,34900,0,0
TIKI,thiet-bi-kts-phu-kien-so,74908430,"Bàn phím cơ E-Dra EK3104 Huano Switch(Blue/Brown",1118600,1118600,0,0
TIKI,thiet-bi-kts-phu-kien-so,136029610,"Hub chuyển đổi mở rộng USB Typec sang USB 3.0 – Hàng chính hãng",189000,370000,181000,49
TIKI,thiet-bi-kts-phu-kien-so,212981756,"Giá đỡ máy tính, macbook, laptop giúp tản nhiệt có thể mang đi tiện lợi -Funu Home",119000,135000,16000,12
TIKI,thiet-bi-kts-phu-kien-so,108753341,"Cốc sạc siêu nhỏ gọn 20W Baseus Compact Quick Charger (USB + Type C, công suất 20W) - Hàng Chính Hãng",165000,199000,34000,17
TIKI,thiet-bi-kts-phu-kien-so,14605245,"Cáp Chuyển Đổi USB 3.0 To Lan - USB Sang Lan ",98500,98500,0,0
TIKI,thiet-bi-kts-phu-kien-so,73500929,"Bộ chia 4 cổng USB 3.0 có cổng cấp nguồn phụ Orico TWU3-4A - Hàng Chính Hãng",204000,204000,0,0
TIKI,thiet-bi-kts-phu-kien-so,15254795,"Ốp Lưng cao cấp Auto Focus Vân da cho điện thoại SAMSUNG: Note 8/ Note 9 (Màu Đen) - Hàng nhập khẩu",12000,12000,0,0
TIKI,thiet-bi-kts-phu-kien-so,23410785,"Ốp Lưng Kính Cường Lực Trong Suốt Hoàn Toàn. Lưng Kính Không Ố Vàng, Viền Máy Dẻo Cho Iphone X/ XS/ XS Max/ XR/ 7/8 Plus",85499,89999,4500,5
TIKI,thiet-bi-kts-phu-kien-so,56026597,"Hộp đựng phụ kiện công nghệ SmileBox form cứng đựng ổ cứng, pin sạc, tai nghe, bộ sạc điện thoại nhiều size- Hàng chính hãng",45000,45000,0,0
TIKI,thiet-bi-kts-phu-kien-so,34520643,"[COMBO] Bộ vệ sinh laptop 6 món + Tặng kèm máy hút bui bàn phím (màu ngẫu nhiên) - Hàng nhập khẩu",52500,52500,0,0
TIKI,thiet-bi-kts-phu-kien-so,16654097,"Bộ Chuyển Đổi Vga Sang HDMI Có Audio - Tặng Dây HDMI 1.5m ( Vga To HDMI Full HD 1080 )",93000,93000,0,0
TIKI,thiet-bi-kts-phu-kien-so,189580427,"Chuột Không Dây Logitech M221 White - Hàng Chính Hãng",249000,249000,0,0
TIKI,thiet-bi-kts-phu-kien-so,168586745,"Ốp lưng dành cho iPhone 13 Pro Max/13 Pro/ 13 Lucky Tiger Cat chống sốc bảo vệ camera _ Hàng Chính Hãng",94050,99000,4950,5
TIKI,thiet-bi-kts-phu-kien-so,72646091,"Giá Đỡ Điện Thoại Gương Chiếu Hậu Trong Xe Hơi Chất Liệu Nhựa ABS Hoco CA70 - Siêu Chắc Chắn - Hàng Nhập Khẩu",48888,66813,17925,27
TIKI,thiet-bi-kts-phu-kien-so,102766392,"Loa Bluetooth thông minh kháng nước Remax RB-M28 hàng chính hãng",1190000,1300000,110000,8
TIKI,thiet-bi-kts-phu-kien-so,21315699,"Sim Du Lịch Trung Quốc - HongKong - MaCao Không Giới Hạn Internet Trong 10 Ngày",350000,350000,0,0
TIKI,thiet-bi-kts-phu-kien-so,52620058," Kẹp Điện Thoại Xe Máy Hợp Kim C2 Cao Cấp PKS - Giao màu ngẫu nhiên ",35084,47420,12336,26
TIKI,thiet-bi-kts-phu-kien-so,14701982,"Đầu DVI(24+1) to HDMI",21185,22300,1115,5
TIKI,thiet-bi-kts-phu-kien-so,115529829,"SD/TF chuẩn USB 3.1 Type C Đầu đọc thẻ nhớ vỏ nhôm cao cấp Ugreen đt401n80888CM - Hàng chính hãng",270000,270000,0,0
TIKI,thiet-bi-kts-phu-kien-so,2431785,"Máy Trợ Giảng Không Dây Shidu SD-S611 (UHF)",712999,712999,0,0
TIKI,thiet-bi-kts-phu-kien-so,194458001,"Tai nghe bluetooth nhét tai chống ồn cao cấp V5.3 chính hãng dùng cho iPhone Samsung OPPO VIVO HUAWEI XIAOMI tai nghe không dây - Hàng Chính Hãng PKCB",313000,500000,187000,37
TIKI,thiet-bi-kts-phu-kien-so,196559521,"Loa Nghe Nhạc Mini Cầm Tay Huqu HQ-M10- Thiết Kế Nhỏ Gọn, Cầm Tay -Hàng Chính Hãng",275500,290000,14500,5
TIKI,thiet-bi-kts-phu-kien-so,120462971,"Cáp chuyển đổi USB ra 2 cổng PS/2 dành cho phím chuột",32000,37990,5990,16
TIKI,thiet-bi-kts-phu-kien-so,177191449,"Ốp lưng chống sốc dành cho Xiaomi Redmi 10C nhựa dẻo, túi khí chống sốc 4 góc, bảo vệ Camera ",28900,28900,0,0
TIKI,thiet-bi-kts-phu-kien-so,195305688,"Adapter Sạc 2 Cổng ANKER 521 Nano Pro 40W Type-C Sạc Nhanh Nhỏ Gọn Tích Hợp PIQ 3.0 Tương Thích Iphone 13/13 Mini / 13 Pro / 13 Pro Max / 12, Galaxy, Pixel 4/3, Ipad / Ipad Mini A2038 - Hàng Chính Hãng",800000,950000,150000,16
TIKI,thiet-bi-kts-phu-kien-so,97821182,"Dây Cáp Sạc Từ Tính cho Đồng Hồ Xiaomi Mi Band 6",35000,35000,0,0
TIKI,thiet-bi-kts-phu-kien-so,54356554,"Thẻ nhớ microSDXC 64GB OEM tốc độ class 10 U3",75000,110000,35000,32
TIKI,thiet-bi-kts-phu-kien-so,5911431,"Cáp Chuyển Đổi Displayport To HDMI 4K Ugreen 40363 - Hàng Chính Hãng",220000,220000,0,0
TIKI,thiet-bi-kts-phu-kien-so,157215759,"Chuột Không Dây GX9 - Bluetooth + Wireless 2.4G  - Pin sạc  - Chống ồn - hàng nhập khẩu",310000,310000,0,0
TIKI,thiet-bi-kts-phu-kien-so,4167993,"Bàn phím gấp gọn Bluetooth tích hợp chuột touchpad hỗ trợ chơi game B033 Aturos (màu Đen) - Hàng chính hãng",445000,445000,0,0
TIKI,thiet-bi-kts-phu-kien-so,103539803,"Ốp lưng dành cho Samsung M51 silicon dẻo trong suốt cao cấp A+",12000,12000,0,0
TIKI,thiet-bi-kts-phu-kien-so,24865067,"Bút laser trình chiếu Slide VSON N35 - Hàng nhập khẩu",172000,172000,0,0
TIKI,thiet-bi-kts-phu-kien-so,188565088,"Loa Bluetooth JBL Flip 6 - Hàng Chính Hãng",2840000,2990000,150000,5
TIKI,thiet-bi-kts-phu-kien-so,128678712,"Apple Watch Series 7 GPS Sport Band (Viền Nhôm, Dây Cao Su)",7890000,12990000,5100000,39
TIKI,thiet-bi-kts-phu-kien-so,127695415,"Loa Bluetooth HXSJ V6 Bản Mở Rộng Hỗ Trợ Kết Nối Bluetooth 5.0, Thẻ Nhớ, USB, Công suất 2 loa 10W Nhiều Màu Sắc - Hàng chính hãng",349000,689000,340000,49
TIKI,thiet-bi-kts-phu-kien-so,26029929,"Bàn di,tấm lót chuột chơi game Mouse pad",11900,11900,0,0
TIKI,thiet-bi-kts-phu-kien-so,637038,"Chuột Có Dây Dell MS116 (Đen) - Hàng Chính Hãng",82000,82000,0,0
TIKI,thiet-bi-kts-phu-kien-so,169196334,"Bàn Di Chuột Cỡ Lớn 30-80cm,Pad Chuột,Lót Chuột Phím Tắt Văn Phòng Cao Cấp - Bàn Di Công Thức",39000,39000,0,0
TIKI,thiet-bi-kts-phu-kien-so,193209851,"Pin Sạc Dự Phòng 20000mAh Sạc Nhanh PD 20W QC 18W RAVPower RP-PB1205 - Hàng Chính Hãng",699000,1190000,491000,41
TIKI,thiet-bi-kts-phu-kien-so,52945747,"Giá đỡ laptop nhôm có thể gấp gọn dành cho Macbook Ipad Surface và máy tính xách tay",109000,109000,0,0
TIKI,thiet-bi-kts-phu-kien-so,195277333,"Ốp lưng dẻo cho iPhone 8 / SE 2020 / 8 Plus / X / XS / XR / XS Max / 11 / 11 Pro / 11 Pro Max / 12 / 12 Pro / 12 Pro Max / 12 Mini / 13 / 13 Pro / 13 Pro Max / 13 Mini / 14 / 14 Pro / 14 Pro Max / 14 Max -Hàng chính hãng-Photodesign VN",149000,250000,101000,40
TIKI,thiet-bi-kts-phu-kien-so,78010530,"Adapter Củ Sạc CHOETECH PD5005 PD 20W Chuyên Sạc Nhanh iPhone, iPad - Hàng Chính Hãng",199000,390000,191000,49
TIKI,thiet-bi-kts-phu-kien-so,102391960,"Giá Đỡ Máy Tính, Laptop, iPad, Macbook Hợp Kim Nhôm Cao Cấp. Hỗ Trợ Tản Nhiệt Chống Mỏi Cổ, Vai, Gáy. Hàng Chính Hãng Tamayoko",450000,500000,50000,10
TIKI,thiet-bi-kts-phu-kien-so,177883578,"Vải lưới vải ê căng ê-căng bảo vệ loa kích thước 1m x 1.5m",90000,90000,0,0
TIKI,thiet-bi-kts-phu-kien-so,195305655,"Adapter Sạc ANKER 511 Nano Pro 20W Type-C Sạc Nhanh Tích Hợp PIQ 3.0 A2637 Tương Thích iPhone 13 series và iPhone 12 series, Galaxy, Pixel 4/3, iPad / iPad mini - Hàng Chính Hãng",250000,450000,200000,44
TIKI,lam-dep-suc-khoe,194458001,"Tai nghe bluetooth nhét tai chống ồn cao cấp V5.3 chính hãng dùng cho iPhone Samsung OPPO VIVO HUAWEI XIAOMI tai nghe không dây - Hàng Chính Hãng PKCB",313000,500000,187000,37
TIKI,thiet-bi-kts-phu-kien-so,192364741,"Miếng Lót Chuột ,Bàn Di Chuột Huqu -Chất Liệu Sợi Fiber -Hàng Chính Hãng ",28500,30000,1500,5
TIKI,thiet-bi-kts-phu-kien-so,201437397,"Giá Đỡ Laptop Hợp Kim Nhôm Cao Cấp Dễ Dàng Gấp Gọn, Giúp Tản Nhiệt Laptop, Máy Tính Xách Tay - 07 Nấc Điều Chỉnh Góc Độ. Hàng Chính Hãng Tamayoko",160000,160000,0,0
TIKI,thiet-bi-kts-phu-kien-so,191684818,"Tai Nghe Bluetooth True Wireless AMOI F9 Cảm Ứng Vân Tay, Nâng Cấp Dock Sạc có Led Báo Pin Kép - Hàng Nhập Khẩu",89000,94000,5000,5
TIKI,thiet-bi-kts-phu-kien-so,68985833,"Dây sạc Cáp sạc Nam châm Đồng hồ Thông minh Q12, Q16, Q19, Q100, TD26, A28, DS60, DS66, Y95, D06, DF39 Hàng nhập khẩu",57000,57000,0,0
TIKI,thiet-bi-kts-phu-kien-so,188998014,"Ốp Bảo Vệ Chống Sốc Armor TPU PC Cho Airpods 1,2 / Airpods 3/ Airpods Pro/ Airpods Pro 2 Kèm Móc Treo- Hàng Chính Hãng",99000,99000,0,0
TIKI,thiet-bi-kts-phu-kien-so,1517005,"Thẻ Nhớ Micro SDHC SanDisk UHS-1 32GB Class 10 - Hàng Chính Hãng",108000,108000,0,0
TIKI,lam-dep-suc-khoe,169196334,"Bàn Di Chuột Cỡ Lớn 30-80cm,Pad Chuột,Lót Chuột Phím Tắt Văn Phòng Cao Cấp - Bàn Di Công Thức",39000,39000,0,0
TIKI,thiet-bi-kts-phu-kien-so,95085073,"Dây Cáp Chuyển Đổi USB Type C To HDMI 4K 60Hz Dài 1.8M CHOETECH CH0019 - Hàng Chính Hãng",369000,590000,221000,37
TIKI,lam-dep-suc-khoe,127695415,"Loa Bluetooth HXSJ V6 Bản Mở Rộng Hỗ Trợ Kết Nối Bluetooth 5.0, Thẻ Nhớ, USB, Công suất 2 loa 10W Nhiều Màu Sắc - Hàng chính hãng",349000,689000,340000,49
TIKI,thiet-bi-kts-phu-kien-so,87675294,"Đồng Hồ Thông Minh Trẻ Em Chống Nước Chuẩn IP67 AMA Watch Q12 Hàng nhập khẩu",280000,280000,0,0
TIKI,thiet-bi-kts-phu-kien-so,91013563,"Remote Quạt Senko Điều Khiển (Tất Cả Các Loại như TR1683, DR1608, TR1628, DH1600) Hàng Chính Hãng",70000,70000,0,0
TIKI,lam-dep-suc-khoe,52945747,"Giá đỡ laptop nhôm có thể gấp gọn dành cho Macbook Ipad Surface và máy tính xách tay",109000,109000,0,0
TIKI,thiet-bi-kts-phu-kien-so,117987260,"Loa Máy Tính Doron V-196 - Âm Thanh Siêu Trầm 4D, Bass Êm - Hàng Chính Hãng",190000,190000,0,0
TIKI,thiet-bi-kts-phu-kien-so,87106876,"Dây Cáp Sạc Nhanh USB Type C to Type C 100W Dài 1.8M Chuyên Sạc iPhone 15, Macbook, Laptop, Smartphone CHOETECH XCC-1002-GY - Hàng Chính Hãng",189000,280000,91000,33
TIKI,lam-dep-suc-khoe,192364741,"Miếng Lót Chuột ,Bàn Di Chuột Huqu -Chất Liệu Sợi Fiber -Hàng Chính Hãng ",28500,30000,1500,5
TIKI,lam-dep-suc-khoe,195305655,"Adapter Sạc ANKER 511 Nano Pro 20W Type-C Sạc Nhanh Tích Hợp PIQ 3.0 A2637 Tương Thích iPhone 13 series và iPhone 12 series, Galaxy, Pixel 4/3, iPad / iPad mini - Hàng Chính Hãng",250000,450000,200000,44
TIKI,lam-dep-suc-khoe,78010530,"Adapter Củ Sạc CHOETECH PD5005 PD 20W Chuyên Sạc Nhanh iPhone, iPad - Hàng Chính Hãng",199000,390000,191000,49
TIKI,lam-dep-suc-khoe,201437397,"Giá Đỡ Laptop Hợp Kim Nhôm Cao Cấp Dễ Dàng Gấp Gọn, Giúp Tản Nhiệt Laptop, Máy Tính Xách Tay - 07 Nấc Điều Chỉnh Góc Độ. Hàng Chính Hãng Tamayoko",160000,160000,0,0
TIKI,thiet-bi-kts-phu-kien-so,110169574,"Thảm Lót Chuột Cỡ Lớn, Dùng Được Hai Mặt - Da PU Chống Nước - Doron HD01 - Kiêm Deskpad Thảm Da, Trải Bàn Làm Việc - Hàng Nhập Khẩu",79000,79000,0,0
TIKI,lam-dep-suc-khoe,107338360,"Bàn Di Chuột - Miếng Lót Chuột Cỡ Lớn Doron-HDC01 Size 40x80, 45x90 cm - Kiêm Deskpad Thảm Da, Trải Bàn Làm Việc Chống Nước Dùng Được Hai Mặt - Hàng Nhập Khẩu",99000,99000,0,0
TIKI,lam-dep-suc-khoe,193209851,"Pin Sạc Dự Phòng 20000mAh Sạc Nhanh PD 20W QC 18W RAVPower RP-PB1205 - Hàng Chính Hãng",699000,1190000,491000,41
TIKI,lam-dep-suc-khoe,24865067,"Bút laser trình chiếu Slide VSON N35 - Hàng nhập khẩu",172000,172000,0,0
TIKI,thiet-bi-kts-phu-kien-so,125652874,"Combo củ cáp sạc nhanh chuẩn PD 20W cho IP12,IP13 Remax RPU88i-RC188i- Hàng chính hãng",450000,500000,50000,10
TIKI,lam-dep-suc-khoe,128678712,"Apple Watch Series 7 GPS Sport Band (Viền Nhôm, Dây Cao Su)",7890000,12990000,5100000,39
TIKI,lam-dep-suc-khoe,95085073,"Dây Cáp Chuyển Đổi USB Type C To HDMI 4K 60Hz Dài 1.8M CHOETECH CH0019 - Hàng Chính Hãng",369000,590000,221000,37
TIKI,lam-dep-suc-khoe,360660,"Bộ Bàn Phím Và Chuột Logitech MK220 Không Dây - Hàng chính hãng",419000,419000,0,0
TIKI,thiet-bi-kts-phu-kien-so,72540740,"Ốp lưng dẻo thoát nhiệt dành cho iPhone 11 PRO MAX - Đen - Hàng chính hãng",49000,69000,20000,29
TIKI,thiet-bi-kts-phu-kien-so,895314,"Tai Nghe Nhét Tai Langsdom Super Bass JM26",45000,50000,5000,10
TIKI,lam-dep-suc-khoe,87675294,"Đồng Hồ Thông Minh Trẻ Em Chống Nước Chuẩn IP67 AMA Watch Q12 Hàng nhập khẩu",280000,280000,0,0
TIKI,lam-dep-suc-khoe,26029929,"Bàn di,tấm lót chuột chơi game Mouse pad",11900,11900,0,0
TIKI,thiet-bi-kts-phu-kien-so,111983048,"Dây Cáp HDMI 2.1 CHOETECH XHH03-BK Dài 2M Phân Giải Tối Đa 8K 48Gbps, 4K 120Hz Dùng Cho Tivi/Laptop/Playstation/PC - Hàng Chính Hãng",179000,260000,81000,31
TIKI,lam-dep-suc-khoe,125652874,"Combo củ cáp sạc nhanh chuẩn PD 20W cho IP12,IP13 Remax RPU88i-RC188i- Hàng chính hãng",450000,500000,50000,10
TIKI,thiet-bi-kts-phu-kien-so,107338360,"Bàn Di Chuột - Miếng Lót Chuột Cỡ Lớn Doron-HDC01 Size 40x80, 45x90 cm - Kiêm Deskpad Thảm Da, Trải Bàn Làm Việc Chống Nước Dùng Được Hai Mặt - Hàng Nhập Khẩu",99000,99000,0,0
TIKI,lam-dep-suc-khoe,91013563,"Remote Quạt Senko Điều Khiển (Tất Cả Các Loại như TR1683, DR1608, TR1628, DH1600) Hàng Chính Hãng",70000,70000,0,0
TIKI,lam-dep-suc-khoe,637038,"Chuột Có Dây Dell MS116 (Đen) - Hàng Chính Hãng",82000,82000,0,0
TIKI,lam-dep-suc-khoe,53547831,"Lót chuột  siêu bền 26x21 cm - Hàng chính hãng",19000,19000,0,0
TIKI,lam-dep-suc-khoe,189474023,"Sạc dự phòng không dây từ tính Remax RPP-65 10000mAh - Hàng chính hãng",753500,990000,236500,24
TIKI,lam-dep-suc-khoe,191684818,"Tai Nghe Bluetooth True Wireless AMOI F9 Cảm Ứng Vân Tay, Nâng Cấp Dock Sạc có Led Báo Pin Kép - Hàng Nhập Khẩu",89000,94000,5000,5
TIKI,lam-dep-suc-khoe,895314,"Tai Nghe Nhét Tai Langsdom Super Bass JM26",45000,50000,5000,10
TIKI,thiet-bi-kts-phu-kien-so,189474023,"Sạc dự phòng không dây từ tính Remax RPP-65 10000mAh - Hàng chính hãng",753500,990000,236500,24
TIKI,lam-dep-suc-khoe,117987260,"Loa Máy Tính Doron V-196 - Âm Thanh Siêu Trầm 4D, Bass Êm - Hàng Chính Hãng",190000,190000,0,0
TIKI,lam-dep-suc-khoe,1517005,"Thẻ Nhớ Micro SDHC SanDisk UHS-1 32GB Class 10 - Hàng Chính Hãng",108000,108000,0,0
TIKI,lam-dep-suc-khoe,199165708,"Giá đỡ laptop tuỳ chỉnh góc nghiêng để phù hợp góc nhìn của bạn chất liệu hợp kim nhôm, hỗ trợ tản nhiệt tốt cho máy tính laptop, macbook và máy tính bảng",109000,109000,0,0
TIKI,lam-dep-suc-khoe,102391960,"Giá Đỡ Máy Tính, Laptop, iPad, Macbook Hợp Kim Nhôm Cao Cấp. Hỗ Trợ Tản Nhiệt Chống Mỏi Cổ, Vai, Gáy. Hàng Chính Hãng Tamayoko",450000,500000,50000,10
TIKI,lam-dep-suc-khoe,104268199,"Chuột không dây kiểu đứng sạc pin HXSJ T22 wireless USB 2.4GHz chống mỏi tay chuyên dùng cho pc laptop macbook ipad tivi - Hàng chính hãng",349000,599000,250000,42
TIKI,thiet-bi-kts-phu-kien-so,116783441,"5in1 - Bộ vệ sinh Laptop, Macbook, Máy ảnh Cao Cấp - Hàng Nhập Khẩu - Chính Hãng JRC",228800,228800,0,0
TIKI,thiet-bi-kts-phu-kien-so,104268199,"Chuột không dây kiểu đứng sạc pin HXSJ T22 wireless USB 2.4GHz chống mỏi tay chuyên dùng cho pc laptop macbook ipad tivi - Hàng chính hãng",349000,599000,250000,42
TIKI,thiet-bi-kts-phu-kien-so,122158068,"Tẩu sạc nhanh 20W trên xe hơi ô tô HOCO Z42 PD QC 3.0 Dành cho điện thoại iPhone iP Samsung Oppo cốc củ cóc sạc oto  - Hàng chính hãng",159000,159000,0,0
TIKI,lam-dep-suc-khoe,111983048,"Dây Cáp HDMI 2.1 CHOETECH XHH03-BK Dài 2M Phân Giải Tối Đa 8K 48Gbps, 4K 120Hz Dùng Cho Tivi/Laptop/Playstation/PC - Hàng Chính Hãng",179000,260000,81000,31
TIKI,lam-dep-suc-khoe,135410778,"Ốp Lưng Trong Suốt Hoco Dành Cho iPhone - Hàng Chính Hãng ",86000,86000,0,0
TIKI,lam-dep-suc-khoe,72540740,"Ốp lưng dẻo thoát nhiệt dành cho iPhone 11 PRO MAX - Đen - Hàng chính hãng",49000,69000,20000,29
TIKI,thiet-bi-kts-phu-kien-so,199165708,"Giá đỡ laptop tuỳ chỉnh góc nghiêng để phù hợp góc nhìn của bạn chất liệu hợp kim nhôm, hỗ trợ tản nhiệt tốt cho máy tính laptop, macbook và máy tính bảng",109000,109000,0,0
TIKI,lam-dep-suc-khoe,188998014,"Ốp Bảo Vệ Chống Sốc Armor TPU PC Cho Airpods 1,2 / Airpods 3/ Airpods Pro/ Airpods Pro 2 Kèm Móc Treo- Hàng Chính Hãng",99000,99000,0,0
TIKI,thiet-bi-kts-phu-kien-so,53547831,"Lót chuột  siêu bền 26x21 cm - Hàng chính hãng",19000,19000,0,0
TIKI,thiet-bi-kts-phu-kien-so,360660,"Bộ Bàn Phím Và Chuột Logitech MK220 Không Dây - Hàng chính hãng",419000,419000,0,0
TIKI,lam-dep-suc-khoe,88796298,"Dây Cáp Nối Dài Âm Thanh 3.5mm Dài 2M CHOETECH AUX001-BK - Hàng Chính Hãng",99000,150000,51000,34
TIKI,thiet-bi-kts-phu-kien-so,135410778,"Ốp Lưng Trong Suốt Hoco Dành Cho iPhone - Hàng Chính Hãng ",86000,86000,0,0
TIKI,thiet-bi-kts-phu-kien-so,126032985,"Ốp Lưng Trong Suốt MIPOW TEMPERED GLASS Dành Cho iPhone 13 Mini, Iphone 13/ 13 Pro, 13 Pro Max - Hàng Chính Hãng",68000,290000,222000,77
TIKI,thiet-bi-kts-phu-kien-so,88796298,"Dây Cáp Nối Dài Âm Thanh 3.5mm Dài 2M CHOETECH AUX001-BK - Hàng Chính Hãng",99000,150000,51000,34
TIKI,lam-dep-suc-khoe,87106876,"Dây Cáp Sạc Nhanh USB Type C to Type C 100W Dài 1.8M Chuyên Sạc iPhone 15, Macbook, Laptop, Smartphone CHOETECH XCC-1002-GY - Hàng Chính Hãng",189000,280000,91000,33
TIKI,lam-dep-suc-khoe,126032985,"Ốp Lưng Trong Suốt MIPOW TEMPERED GLASS Dành Cho iPhone 13 Mini, Iphone 13/ 13 Pro, 13 Pro Max - Hàng Chính Hãng",68000,290000,222000,77
TIKI,lam-dep-suc-khoe,195277333,"Ốp lưng dẻo cho iPhone 8 / SE 2020 / 8 Plus / X / XS / XR / XS Max / 11 / 11 Pro / 11 Pro Max / 12 / 12 Pro / 12 Pro Max / 12 Mini / 13 / 13 Pro / 13 Pro Max / 13 Mini / 14 / 14 Pro / 14 Pro Max / 14 Max -Hàng chính hãng-Photodesign VN",149000,250000,101000,40
TIKI,lam-dep-suc-khoe,110169574,"Thảm Lót Chuột Cỡ Lớn, Dùng Được Hai Mặt - Da PU Chống Nước - Doron HD01 - Kiêm Deskpad Thảm Da, Trải Bàn Làm Việc - Hàng Nhập Khẩu",79000,79000,0,0
TIKI,lam-dep-suc-khoe,116783441,"5in1 - Bộ vệ sinh Laptop, Macbook, Máy ảnh Cao Cấp - Hàng Nhập Khẩu - Chính Hãng JRC",228800,228800,0,0
TIKI,lam-dep-suc-khoe,122158068,"Tẩu sạc nhanh 20W trên xe hơi ô tô HOCO Z42 PD QC 3.0 Dành cho điện thoại iPhone iP Samsung Oppo cốc củ cóc sạc oto  - Hàng chính hãng",159000,159000,0,0
TIKI,lam-dep-suc-khoe,68985833,"Dây sạc Cáp sạc Nam châm Đồng hồ Thông minh Q12, Q16, Q19, Q100, TD26, A28, DS60, DS66, Y95, D06, DF39 Hàng nhập khẩu",57000,57000,0,0
TIKI,dien-gia-dung,6774373,"Máy Xay Sinh Tố Đa Năng Sunhouse HappyTime HTD5113G (Xanh) 350W - Hàng chính hãng",329000,590000,261000,44
TIKI,dien-gia-dung,53681690,"Máy tạo bọt cafe, sữa, đánh trứng mini cầm tay MFB1501D kích thước nhỏ gọn, tiện dụng",93000,93000,0,0
TIKI,dien-gia-dung,20701352,"Quạt bàn Senko B102 (giao màu ngẫu nhiên) - Hàng Chính Hãng",240000,240000,0,0
TIKI,dien-gia-dung,166524882,"Máy sấy tóc mini chính hãng CameWell công suất lớn 1000W, giảm tiếng ồn, tặng đầu sấy tạo kiểu tóc chuyên nghiệp 2 chiều nóng lạnh CW01HD",79000,149000,70000,47
TIKI,dien-gia-dung,31502012,"Nồi Chiên Không Dầu Magic A-802 (4.6 Lít) Đỏ- Hàng Chính Hãng",969000,1990000,1021000,51
TIKI,dien-gia-dung,81676555,"Bàn Ủi Hơi Nước Philips STH3010/70 (1000W) - Hàng Chính Hãng",844000,1199000,355000,30
TIKI,dien-gia-dung,4526261,"Quạt đứng Senko DTS1607 - Hàng chính hãng",415000,415000,0,0
TIKI,dien-gia-dung,76016726,"Bộ 3 Lõi Lọc Số 1 RO KAROFI KRF-L1 - Hàng Chính Hãng",140000,140000,0,0
TIKI,dien-gia-dung,170658293,"Máy cắt tỉa lông mũi Panasonic ER-GN30-K453 - Hàng chính hãng",419000,419000,0,0
TIKI,dien-gia-dung,2394877,"Bếp Gas Hồng Ngoại Đôi Sunhouse SHB004MT - Hàng chính hãng",670000,871000,201000,23
TIKI,dien-gia-dung,53758851,"Bình Đun Siêu Tốc 2 Lớp Nagakawa NAG0315 (1.8 Lít)",382000,690000,308000,45
TIKI,dien-gia-dung,137727744,"Bình thủy điện Panasonic NC-EG4000CSY 4 lít - Hàng Chính Hãng",2289000,2517000,228000,9
TIKI,dien-gia-dung,973080,"Quạt Hút Thông Gió Senko H250 40W - Hàng Chính Hãng",275000,275000,0,0
TIKI,dien-gia-dung,1733763,"Bộ Van Bình Ngắt Gas Tự Động Namilux NA-345S-VN - Hàng Chính Hãng",168000,168000,0,0
TIKI,dien-gia-dung,63560677,"Ấm sắc thuốc Trường An TA68 Nâu - Hàng chính hãng",545000,545000,0,0
TIKI,dien-gia-dung,190860235,"Nồi chiên không dầu đa chức năng 12 trong 1 Sunhouse SHD4087 (6.0 Lít) - Hàng chính hãng",2070000,3590000,1520000,42
TIKI,dien-gia-dung,27577963,"Nồi Điện Đa Năng Lock&Lock EJC141 (1.5 Lít) - Hàng Chính Hãng",1029000,2073000,1044000,50
TIKI,dien-gia-dung,134333386,"Nồi áp suất điện tử Lock&Lock EJP666SLV 6 Lít - Hàng chính hãng",1910000,3841000,1931000,50
TIKI,dien-gia-dung,456050,"Nồi Cơm Điện Nắp Gài Sharp KS-181TJV - 1.8 L - Hàng chính hãng",543000,899000,356000,40
TIKI,dien-gia-dung,6772415,"Lò Nướng Điện Sunhouse SHD4206 (10L) - Hàng chính hãng",537000,786000,249000,32
TIKI,dien-gia-dung,182139555,"Máy pha cà phê HiBREW H8A tự động đánh bọt sữa cho Cappuccino, Latte, áp suất 19 Bar, hàng chính hãng",4390000,4390000,0,0
TIKI,dien-gia-dung,141673652,"Nồi Cơm Điện Nắp Rời Happy Cook HCD-180V 1.8L - Hàng Chính Hãng",719000,719000,0,0
TIKI,dien-gia-dung,212981956,"Máy sấy tóc, máy sấy tóc công suất 2000W, tặng kèm 5 phụ kiện sấy tóc tạo kiểu chuyên dụng - Funu Home",95000,120000,25000,21
TIKI,dien-gia-dung,126734433,"Máy lọc không khí Sharp FP-J40E-W - Hàng chính hãng",4440000,4850000,410000,8
TIKI,dien-gia-dung,67012257,"Máy xay sinh tố cầm tay Philips HR2531/00 (650W) - Hàng chính hãng",565000,900000,335000,37
TIKI,dien-gia-dung,161017652,"Máy Hút Bụi Cầm Tay Không Dây Sử Dụng Pin Sạc DAMAS Vacuum Cleaner D610W - Hàng Chính Hãng",579000,950000,371000,39
TIKI,dien-gia-dung,132847951,"Bếp Gas Dương Đôi Kangaroo KG8G1A - Hàng Chính Hãng",580000,970000,390000,40
TIKI,dien-gia-dung,15398266,"Máy Xay Sinh Tố Mini Hafele GS-621 (350W) - Hàng Chính Hãng",599000,1010000,411000,41
TIKI,dien-gia-dung,253190854,"Nồi Chưng Yến, Nồi Tiềm Thuốc Bắc, Nồi Nấu Chậm BEAR SUBE001 Kèm Lồng Hấp Dung Tích 0.8 Lít, Công Suất 200 W - Hàng Chính Hãng",390000,529900,139900,26
TIKI,dien-gia-dung,88249851,"Máy đánh trứng tạo bọt cafe mini 2 trong 1 với 3 chế độ dùng pin sạc USB cao cấp",80986,80986,0,0
TIKI,dien-gia-dung,46476944,"MÁY THỔI VÀ HÚT BỤI PHÒNG NÉT SD9020- HÀNG NHẬP KHẨU",198100,198100,0,0
TIKI,dien-gia-dung,187284937,"Quạt Mini Tích Sạc Điện Gấp Gọn Đa Năng Để Bàn Làm Việc,  3 Chế Độ Gió Linh Hoạt - Quạt Gấp Gọn Điều Chỉnh Chiều Cao Q17 Giải pháp cho mùa hè Siêu tiện Ích",113050,119000,5950,5
TIKI,dien-gia-dung,87960372,"Lò Nướng Chân Không Điện Tử Lock&Lock EJF291BLK 10L - Hàng Chính Hãng",2599000,6180000,3581000,58
TIKI,dien-gia-dung,73230349,"Nồi cơm điện Kim Cương 0.6L - KC-0.6L - Hàng chính hãng",254000,299000,45000,15
TIKI,dien-gia-dung,78625780,"Quạt điện Senko để bàn tiện lợi cao cấp B1216 màu ngẫu nhiên - Hàng Chính Hãng",285000,285000,0,0
TIKI,dien-gia-dung,11502504,"Máy xay thịt osaka japan new 2019 - Hàng Chính Hãng",149900,149900,0,0
TIKI,dien-gia-dung,91978576,"Nồi cơm điện áp suất Cuckoo CRP-PK1000S 1,8 lít nhiều màu - Hàng chính hãng",3880000,5980000,2100000,35
TIKI,dien-gia-dung,169561154,"Tông Đơ Cắt Tóc Chuyên Nghiệp Kemei 809A, Tích Hợp Pin 2600 mAh Sử Dụng 240 phút Công Suất 5W, Đèn Led Hiện Dung Lượng Pin, Lưỡi Cắt Titatium, Động Cơ Hạn Chế Tiếng Ồn - HÀNG CHÍNH HÃNG",223000,229000,6000,3
TIKI,dien-gia-dung,36627593,"Nồi Chiên Không Dầu Lock&Lock EJF357WHT (5.2 Lít) - Hàng Chính Hãng",1979000,5215000,3236000,62
TIKI,dien-gia-dung,185248203,"Máy Xay Đồ Ăn Dặm Cho Bé 6 Lưỡi Cối Thuỷ Tinh Hàng Nội Địa Trung Bản Cao Cấp Siêu Mịn Tiện Dụng - Tặng Kèm Dụng Cụ Rửa Máy-Hàng Chính Hãng",235000,249000,14000,6
TIKI,do-choi-me-be,3690599,"Chăn Lưới Chống Ngạt, Thoáng Mát Cho Bé Dùng Quanh Năm Xuất Xứ Thái Lan (75 x 100cm) - Xanh",230000,230000,0,0
TIKI,do-choi-me-be,56441154,"Bộ tranh xếp hình cao cấp 330 mảnh ghép – Khói Lam Chiều",78000,100000,22000,22
TIKI,do-choi-me-be,68110347,"Bộ body chần bông cài giữa cho bé Haki BB015",214000,240000,26000,11
TIKI,do-choi-me-be,67063506,"QUÂY CŨI KIÊM NHÀ BÓNG HÌNH CHỮ NHẬT",379000,379000,0,0
TIKI,do-choi-me-be,100901845,"Bộ tranh xếp hình 150 mảnh – Spiderman",45000,65000,20000,31
TIKI,do-choi-me-be,40715526,"Sữa Lean Max Bone Người Loãng Xương",300000,300000,0,0
TIKI,do-choi-me-be,169904349,"Gel thơm khử trùng bồn cầu gel khử mùi bồn cầu dạng thạch hình bông hoa với 6 mùi thơm cho toilet",10000,11500,1500,13
TIKI,do-choi-me-be,51299417,"Áo thun Đội bay siêu đăng bé trai",110000,110000,0,0
TIKI,do-choi-me-be,115689068,"Đồ chơi lắp ráp gỗ 3D Mô hình Tháp đồng hồ Big Ben Tower TG507 Kèm đèn LED",239000,299000,60000,20
TIKI,do-choi-me-be,113919089,"Bình sữa cổ thường Pur Advanced 250ml (1802)",96000,96000,0,0
TIKI,do-choi-me-be,82485968,"Gấu Bông Cá Nemo (50 Cm) Gb109 (Màu Cam)",189000,189000,0,0
TIKI,do-choi-me-be,156212009,"Combo nước rửa bình Arau Baby bình và túi thay thế",278800,328000,49200,15
TIKI,do-choi-me-be,70631578,"Set Mũ Len Kèm Khăn Quả Bông Cho Bé",42000,42000,0,0
TIKI,do-choi-me-be,160879556,"Áo thun bé trai và áo thun bé gái QATE662 - áo thun cho bé trai và áo thun cho bé gái từ sơ sinh đến 18kg",40000,40000,0,0
TIKI,do-choi-me-be,117218465,"Bô Gấu Hokori Có Ngăn Cho Bé Đi Vệ Sinh Cao Cấp",100000,100000,0,0
TIKI,do-choi-me-be,55597362,"Ba Lô DONI DINO Nàng Cá Nhỏ - Xanh BFO1109",193000,385000,192000,50
TIKI,do-choi-me-be,103533595,"04 bộ tranh xếp hình 35 mảnh khổ A4 20x30cm – đồ chơi trí tuệ cho bé từ 2 tuổi – Combo 5",75000,100000,25000,25
TIKI,do-choi-me-be,4465541,"Nước diệt kiến sạch kiến sau hai giờ - Hantox 50ml",25999,25999,0,0
TIKI,do-choi-me-be,50793298,"Gấu Bông Heo Lười Mắt Híp Có 5 Kích Thước 2 Màu",69000,69000,0,0
TIKI,do-choi-me-be,76047617,"Ly uống nước có nắp đậy cho bé STENLOCK (Chính hãng Hàn Quốc)",158650,167000,8350,5
TIKI,do-choi-me-be,145394244,"Khay ăn dặm 5 ngăn Edison Hàn Quốc có đế chống trơn cho bé mã 6872",158000,158000,0,0
TIKI,do-choi-me-be,82862705,"Gấu bông gối ôm chó corgi tròn siêu đẹp dễ thương,Gấu bông sang trọng, Đồ chơi thú bông",265000,530000,265000,50
TIKI,do-choi-me-be,126508763,"NGỰA PONY 1 CON",75000,75000,0,0
TIKI,do-choi-me-be,75977831,"Đồ chơi lật đật phát âm thanh hình gà con xinh xắn biết chớp mắt và có nhạc nhẹ nhàng cho bé yêu, chọn màu theo ý-Đồ chơi giải trí - Đồ chơi ngộ nghĩnh cho bé từ 3 tháng tuổi trở lên",89000,115700,26700,23
TIKI,do-choi-me-be,32428423,"Combo Tinh dầu xịt phòng Xá Xị, khử mùi hôi (02 Chai xịt và 1 lọ treo nguyên chất)",209000,220000,11000,5
TIKI,do-choi-me-be,197409762,"Tấm lót chống thấm thay tã cho bé 4 lớp cao cấp Bonny thấm hút nhanh, kháng khuẩn, thoáng khí (KT50x70Cm)",120000,120000,0,0
TIKI,do-choi-me-be,53756902,"Sữa bột Nutricare ColosCare 0+ - sữa non tăng cường miễn dịch (800g)",429000,429000,0,0
TIKI,do-choi-me-be,181462670,"Bàn chải đánh răng trẻ em TLI Richell Nhật Bản | Baby",126655,126655,0,0
TIKI,do-choi-me-be,1508591,"Chất Làm Sạch Bình Đun Nước Mao Bao (2 Gói x 25g)",38000,45000,7000,16
TIKI,do-choi-me-be,114264109,"Lều công chúa lều hoàng tử cao cấp cỡ đại cho bé",204000,204000,0,0
TIKI,do-choi-me-be,74190242,"Xe Trượt Scooter Trẻ Em Có Ghế Gấp Gọn 3 Bánh Phát Sáng, Có Nhạc Và Đèn Báo, Dành Cho Bé Từ 2-12 Tuổi",215000,263900,48900,19
TIKI,do-choi-me-be,42688572,"Máy hút sữa điện đôi Biohealth IE - Sử dụng pin sạc, có chế độ massage và 3 chế độ hút",1370000,1370000,0,0
TIKI,do-choi-me-be,40752351,"Combo 5 bịch khăn vải khô đa năng Mama (bịch 240 tờ)",249000,249000,0,0
TIKI,do-choi-me-be,118208166,"Bộ Xếp Hình Gỗ Thành Phố Cho Bé (120 chi tiết mẫu MỚI - 160 chi tiết mẫu cũ) || Montessori cao cấp || Đồ chơi Gỗ - Giáo dục - An toàn - Thông minh",148000,169000,21000,12
TIKI,do-choi-me-be,104154864,"Tổ yến mô hình dùng để trưng bày",15000,15000,0,0
TIKI,do-choi-me-be,48264349,"Sonno - SIRO THẢO DƯỢC CHÂU ÂU GIÚP BÉ NGỦ SÂU GIẤC TỰ NHIÊN",345000,345000,0,0
TIKI,do-choi-me-be,33934889,"Sữa tắm cho bé chiết xuất thảo dược Yaocare baby 250ml - DK Pharma",185000,185000,0,0
TIKI,do-choi-me-be,194567446,"(combo 25 tấm khổ 12,5cm x 22,5cm) vải nỉ, vải dạ làm đồ thủ công",25000,25000,0,0
TIKI,do-choi-me-be,4282597,"Mũ chắn nước gội đầu cho bé (màu ngẫu nhiên)",12999,12999,0,0
TIKI,do-choi-me-be,53051272,"Kimono cho bé gái từ 19-32 kg",310000,310000,0,0
TIKI,thiet-bi-kts-phu-kien-so,173058453,"Chuột không dây bluetooth Logitech POP MOUSE - giảm ồn, nút emoji tùy chỉnh - Hàng chính hãng",529000,899000,370000,41
TIKI,thiet-bi-kts-phu-kien-so,191817608,"Bộ Bàn Phím Chuột không dây W201 nhỏ gọn",218500,230000,11500,5
TIKI,thiet-bi-kts-phu-kien-so,116125939,"Dán màn hình dành cho iPad Paper-like Kai Cao Cấp chống vân tay cho cảm giác vẽ như trên giấy",145000,145000,0,0
TIKI,thiet-bi-kts-phu-kien-so,111748361,"Lót chuột phím tắt văn phòng đã Việt hóa khổ lớn cực tiện dụng - Hàng chính hãng",55000,55000,0,0
TIKI,thiet-bi-kts-phu-kien-so,270767050,"[Mới 100%] Sim VIETNAMOBILE Chuyên Dùng Để Nghe Gọi & Tạo Tài Khoản TMĐT, Laz, Sope, Sen, Face, ZaL0, Momo, Tw, Tele, Game... TK 0đ Giá Rẻ - Cam Kết Chưa Từng Đăng Ký Dịch Vụ Gì. Hàng Chính Hãng",55900,110000,54100,49
TIKI,thiet-bi-kts-phu-kien-so,52602232,"Combo Sạc cáp nhanh 25w Type C dùng cho SS Note10 / S10plus 5G / A80, OPPO, VIVO, HUAWEI",110000,110000,0,0
TIKI,thiet-bi-kts-phu-kien-so,55210024,"Giá Đỡ Dành Cho Laptop Macbook Để Bàn Chất Liệu Hợp Kim Nhôm Cao Cấp Hàng Nhập Khẩu Helios",219000,400000,181000,45
TIKI,thiet-bi-kts-phu-kien-so,158848954,"Chuột không dây Wireless Bluetooth sạc pin SIDOTECH PM1 không cần thay pin, sạc 1 lần dùng 30 ngày thiết kế công thái học không mỏi tay, silent chống ồn ban đêm tương thích Laptop Macbook Máy tính bảng PC- Hàng Chính Hãng",182000,182000,0,0
TIKI,thiet-bi-kts-phu-kien-so,122949142,"Tai nghe Bluetooth True Wireless Samsung Galaxy Buds 2 - Hàng Chính Hãng",1590000,2990000,1400000,47
TIKI,thiet-bi-kts-phu-kien-so,86018342,"Kính Cường Lực KingKong 9D Trong Suốt Dành Cho iPhone - Full Hộp Sắt Cao Cấp - Dán Full Màn - Hàng Chính Hãng",105991,211982,105991,50
TIKI,thiet-bi-kts-phu-kien-so,54616399,"Giá đỡ điện thoại để bàn gấp Điện thoại di động Giá đỡ bàn cho iPhone ipad pro mini Samsung Xiaomi Tablet Đứng tăng và giảm Giá đỡ có thể điều chỉnh",13007,13007,0,0
TIKI,dien-gia-dung,532619,"Ấm Siêu Tốc Inox Sunhouse SHD1186 - 1.8L - Hàng chính hãng",211000,270000,59000,22
TIKI,thiet-bi-kts-phu-kien-so,158868825,"[FREE 6 Tháng - Đầu Số 092] SIM MAX DATA 4G VIETNAMOBILE - 6GB/Ngày. Trọn Gói 6 Tháng Không Cần Nạp Tiền - Hàng Chính Hãng",268000,350000,82000,23
TIKI,dien-gia-dung,130412385,"Bàn Là Ủi Áo Quần Hơi Nước Cầm Tay Tiện Lợi Loại 1 Hàng Chính Hãng MINIIN- Là Được Tất Cả Loại Vải- Gấp Gọn Tiện Dụng",346000,384000,38000,10
TIKI,thiet-bi-kts-phu-kien-so,96595575,"Cáp USB nối dài 1.5M 3M 5M CHỐNG NHIỄU",12000,12000,0,0
TIKI,thiet-bi-kts-phu-kien-so,356188,"Chuột Có Dây Logitech B100 - Hàng Chính Hãng",89000,89000,0,0
TIKI,dien-gia-dung,27577966,"Máy Xay Sinh Tố Lock&Lock EJM462 (350W - 1.2 Lít) - Hàng Chính Hãng",851000,1723000,872000,51
TIKI,dien-gia-dung,73090080,"Máy hút bụi cầm tay Karcher VCH 2",892000,990000,98000,10
TIKI,dien-gia-dung,133815741,"Nồi Lẩu Điện Mini Núm Xoay 2 Nấc Nhiệt Kèm Giá Hấp 1,8L, Ca Nấu Mì,Nấu Cơm Đa Năng 2 Tầng Cao Cấp- Chính Hãng MINIIN",169000,169000,0,0
TIKI,dien-gia-dung,137543567,"Máy làm sữa hạt xay nấu UNIE V8S công suất 1800W dung tích 1.75L - Hàng chính hãng",5290000,5290000,0,0
TIKI,thiet-bi-kts-phu-kien-so,148824604,"Bộ thu phát Bluetooth, thiết bị hỗ trợ thu phát nhạc không dây Nano USB 5.0 Bluetooth dành cho Laptop, Máy tính để bàn, Tivi",30000,39000,9000,23
TIKI,dien-gia-dung,169604123,"Tông Đơ Cắt Tóc Cao Cấp KEMEI 809C Loại Có Dây, Công Suất 12W, Máy Hớt Tóc Gia Đình Salon Chuyên Nghiệp, Lưỡi Cắt Titatium, Động Cơ Hạn Chế Tiếng Ồn - HÀNG CHÍNH HÃNG",196000,416000,220000,53
TIKI,thiet-bi-kts-phu-kien-so,195998782,"Cáp sạc và truyền dữ liệu 2.4A Remax RC-138a USB to TypeC  - Hàng chính hãng",59000,99000,40000,40
TIKI,dien-gia-dung,48972911,"Tông đơ cắt tóc chuyên nghiệp thế hệ mẫu mã kiểu dáng mớiKemei KM1998",394000,394000,0,0
TIKI,thiet-bi-kts-phu-kien-so,126998612,"Loa Bluetooth JBL Charge 5 - Hàng Chính Hãng",3790000,3990000,200000,5
TIKI,thiet-bi-kts-phu-kien-so,173034520,"Combo chuột phím không dây Logitech MK345 - 1 đầu thu USB, pin lâu, chống tràn, fullsize - Hàng chính hãng",565000,749000,184000,25
TIKI,thiet-bi-kts-phu-kien-so,68467585,"Đồng Hồ Thông Minh Trẻ Em ngôn ngữ Tiếng Việt, Pin sử dụng được 2 ngày, dây đeo có Hoa văn hình Trái tim Dễ thương Model Y85 Pro - Hàng nhập khẩu",490000,490000,0,0
TIKI,thiet-bi-kts-phu-kien-so,51059393,"Tai Nghe Dây Cho Các Dòng Sản Phẩm Phân Khúc Galaxy J Của Samsung",27900,27900,0,0
TIKI,thiet-bi-kts-phu-kien-so,115847303,"Giá Đỡ Để Bàn Điện Thoại Di Động, Máy Tính Bảng. Chất Liệu Hợp Kim Nhôm Cao Cấp. Xoay 270 Độ Tự Do Điều Chỉnh Góc Nhìn Model Z4. Hàng Chính Hãng Tamayoko",120000,149000,29000,19
TIKI,thiet-bi-kts-phu-kien-so,13781962,"Bút trình chiếu Lazer- Bút thuyết trình- Bút trình chiếu silde- Bút điều khiển trình chiếu- Bút trình chiếu powerpoint",94500,94500,0,0
TIKI,dien-gia-dung,2498045,"Quạt Điện Đứng 7 cánh Senko LTS1636 - Giao Màu Ngẫu Nhiên - Hàng Chính Hãng",415000,415000,0,0
TIKI,thiet-bi-kts-phu-kien-so,135412837,"Đế Sạc Nhanh Không Dây Đa Năng 3in1 Remax RP-W53 - Hỗ Trợ Sạc Nhanh Lên Đến 15W - Hàng Chính Hãng",550000,550000,0,0
TIKI,dien-gia-dung,184973099,"Máy Hút Bụi Cầm Tay Không Dây VinBuy Lực Hút Mạnh Mẽ 16000PA Chức Năng Hút Bụi Khô Và Ướt - Máy Hút Bụi Ô Tô, Máy Hút Bụi Gia Đình - Hàng Chính Hãng",360000,750000,390000,52
TIKI,thiet-bi-kts-phu-kien-so,4539349,"Bộ Vệ Sinh Laptop ",19000,19000,0,0
TIKI,dien-gia-dung,795679,"Quạt Bàn Đảo 2 Tấc Senko BD230 (27W) - Mẫu Ngẫu Nhiên - Hàng chính hãng",215000,215000,0,0
TIKI,dien-gia-dung,403438,"Máy Làm Bánh 3 Trong 1 Tiross TS513 (750W) - Hàng Chính Hãng",679000,790000,111000,14
TIKI,thiet-bi-kts-phu-kien-so,1457747,"Thẻ Nhớ Micro SDXC SanDisk UHS-1 64GB Class 10 - Hàng Chính Hãng",173000,173000,0,0
TIKI,dien-gia-dung,194479808,"Nồi cơm điện tử Cuckoo 1.08L CR-0675F - Tùy chọn 3 vị cơm, 9 chế độ nấu tích hợp, chế độ tự động làm sạch - Hàng chính hãng",1690000,2185000,495000,23
TIKI,dien-gia-dung,165182324,"Quạt mini để bàn, quạt tích điện sạc usb Besti M102 - Quạt cầm tay 3 tốc độ, điều chỉnh hướng gió xoay 360 độ, không gây ồn, pin sạc dung lượng cao - Hàng chính hãng",250000,250000,0,0
TIKI,thiet-bi-kts-phu-kien-so,3416201,"Bảng Vẽ Wacom Intuos S CTL-4100 - Hàng Chính Hãng",2147000,2147000,0,0
TIKI,dien-gia-dung,3611017,"Bếp Nướng Điện Kangaroo KG699G 2000W - Hàng chính hãng",519000,940000,421000,45
TIKI,thiet-bi-kts-phu-kien-so,195977274,"Bàn phím cơ gaming 5TECH Led RGB 10 chế độ nháy cực đẹp, chơi game gõ siêu đã, thiết kế nhỏ gọn dùng cho máy tính, laptop hàng chính hãng",449000,449000,0,0
TIKI,thiet-bi-kts-phu-kien-so,22633043,"Dây 2 Đầu HDMi 5M UNITEK - Cáp HDMI 5M UNITEK Full HD 4K - Hàng Nhập Khẩu",155000,155000,0,0
TIKI,dien-gia-dung,68942787,"Tông Đơ Cắt Tóc Kemei KM 5017 - Tặng Kèm Bộ Kéo Cắt Và Tỉa Tóc Không Gỉ Và Lược",350000,350000,0,0
TIKI,dien-gia-dung,90524877,"Quạt mini tích điện đeo cổ thời trang, giải nhiệt mùa hè đi du lịch , văn phòng DQ203 pin 2000mAH",179000,179000,0,0
TIKI,dien-gia-dung,26031273,"Máy ép chậm Panasonic MJ L500 - Hàng nhập khẩu",5169000,5169000,0,0
TIKI,dien-gia-dung,158746240,"Máy Hút Bụi Công Nghiệp Hút Khô Và Ướt USA Stanley SL19417P-6A - 23 lít/ Công suất 4000W (5.5HP) - Hàng Chính Hãng",1832600,1870000,37400,2
TIKI,dien-gia-dung,163825477,"Nồi Hấp Điện Đa Năng 3 Tầng Braburg- Hàng Chính Hãng",619000,619000,0,0
TIKI,dien-gia-dung,2635459,"Quạt Treo Tường Toshiba F-WSA20(H)VN (55W) - Xám - Hàng chính hãng",1045000,1220000,175000,14
TIKI,thiet-bi-kts-phu-kien-so,95681232,"Adapter Sạc Anker 1 cổng 65W Hỗ Trợ Sạc Nhanh PIQ 3.0 PowerPort III Pod Lite - A2718 - Hàng chính hãng",594000,750000,156000,21
TIKI,dien-gia-dung,137864140,"Quạt đeo cổ, Máy điều hòa không khí cá nhân",53000,53000,0,0
TIKI,dien-gia-dung,166340890,"Máy sấy tóc mini CameWell, máy sấy tóc công suất lớn 1000W, 2 chế độ sấy nóng/ lạnh, ngắt khi quá nhiệt an toàn CW01HD",79000,149000,70000,47
TIKI,thiet-bi-kts-phu-kien-so,183119284,"Case Silicon dành cho Airpods 1,2/ Airpods Pro/ Airpods 3 Hình Chó Cori_ Hàng Chính Hãng",85000,85000,0,0
TIKI,dien-gia-dung,162177652,"Nồi Chiên Không Dầu Sunhouse SHD4027 (6 Lít) - Hàng chính hãng",1410000,2590000,1180000,46
TIKI,dien-gia-dung,181359411,"Máy Đánh Trứng Cầm Tay NONOSTYLE H-D03 - Đánh Trứng & Xay Gia Vị - Hàng Chính Hãng",179000,379000,200000,53
TIKI,dien-gia-dung,2241935,"Cây Nước Nóng Lạnh Sunhouse SHD9601 - Hàng chính hãng",1150000,1600000,450000,28
TIKI,dien-gia-dung,127907978,"Nồi cơm điện mini Chigo 0.8L - CFXB15E dùng cho 1-2 người ăn công suất 350W nấu nhanh ruột chống dính 5 lớp - Hàng Chính Hãng",429000,800000,371000,46
TIKI,dien-gia-dung,174085836,"Máy Cạo Râu KM-6650 Đa Năng 4 Trong 1 Tích Hợp Pin 1400 mAh Công Suất 3W Kiêm Tông Đơ Cắt Tóc & Máy Tỉa Lông Mũi -HÀNG CHÍNH HÃNG",165000,350000,185000,53
TIKI,thiet-bi-kts-phu-kien-so,71291990,"Giá Đỡ Laptop Nhôm Gấp Gọn, Laptop Stand Dùng Cho Máy Từ 11~17 inch, Có Thể Điều Chỉnh Nhiều Mức Độ Cao, Chất Liệu Hợp Kim Nhôm Cao Cấp",65680,65680,0,0
TIKI,thiet-bi-kts-phu-kien-so,115105801,"Thiết Bị Đọc Thẻ Nhớ ROBOT CR202 - 2 Đầu Type-C Và USB 3.0, Khe Cắm Thẻ Nhớ SD/Micro SD - Hàng Chính Hãng",220000,220000,0,0
TIKI,thiet-bi-kts-phu-kien-so,72725402,"Combo chuột phím không dây Logitech MK295 Silent - Chống ồn 90%, có phím số, mắt đọc cải tiến, bền bỉ, không lag - Hàng chính hãng",694000,694000,0,0
TIKI,thiet-bi-kts-phu-kien-so,7734288,"SIM 4G Mobifone MDT250A Trọn Gói 1 Năm Không Cần Nạp Tiền - Hàng chính hãng - Mẫu ngẫu nhiên",299000,299000,0,0
TIKI,dien-gia-dung,109298151,"Máy Pha Cà Phê KONKA KCFCS2 Thiết Kế Kiểu Mới Hiện Đại, Sang Trọng - Hàng nhập khẩu",416000,429000,13000,3
TIKI,dien-gia-dung,165045880,"Máy cạo râu Philips điện 3 lưỡi tự mài đa năng khô và ướt S1050 - Hàng Nhập Khẩu",649000,1050000,401000,38
TIKI,thiet-bi-kts-phu-kien-so,150205187,"Que Chọc Sim",1490,1490,0,0
TIKI,dien-gia-dung,30700817,"Máy Hút Bụi Không Dây Dùng Pin Sạc Lock&Lock ENV151 (150W) - Hàng Chính Hãng",3260000,6367000,3107000,49
TIKI,dien-gia-dung,444297,"Máy Xay Thịt Philips HR1393 (0.7 Lít) - Hàng chính hãng",589000,799000,210000,26
TIKI,dien-gia-dung,51998725,"Tông đơ cắt tóc chuyên nghiệp kemei 809A",222500,280000,57500,21
TIKI,thiet-bi-kts-phu-kien-so,148813604,"Chuột không dây Logitech M331 SILENT-Hàng chính hãng",397000,397000,0,0
TIKI,thiet-bi-kts-phu-kien-so,73261935,"Giá Đỡ Để Bàn Điện Thoại Di Động, Máy Tính Bảng, Ipad Mini. Chất Liệu Hợp Kim Nhôm Cao Cấp. Hàng Chính Hãng Tamayoko",119200,149000,29800,20
TIKI,dien-gia-dung,173550857,"Máy ép chậm Elmich JEE - 1855OL - Hàng chính hãng (New)",1850000,3890000,2040000,52
TIKI,thiet-bi-kts-phu-kien-so,135716055,"Ốp da cao cấp dành cho iPhone 13 / 13 Pro / 13 Pro Max / 13 Mini - Hàng chính hãng",149000,250000,101000,40
TIKI,thiet-bi-kts-phu-kien-so,97034068,"Tai Nghe Nhét Tai XSmart HiFi S2000 Pro Super Bass Chống Ồn Cực Tốt, Âm Thanh Khủng, Chơi Game Ngon - Hàng Chính Hãng",69000,69000,0,0
TIKI,thiet-bi-kts-phu-kien-so,175104946,"Thẻ Nhớ Micro SDXC Samsung Evo Plus U3 130MB/s 256GB New - Hàng Nhập Khẩu",480000,480000,0,0
TIKI,dien-gia-dung,120553719,"Ấm đun nước siêu tốc Elmich KEE-1779OL 1.7 Lít - Hàng Chính Hãng",600000,1050000,450000,43
TIKI,dien-gia-dung,7270329,"Bếp Gas Dương Mặt Kính Sunhouse SHB204MT - Hàng chính hãng",629000,1023000,394000,39
TIKI,dien-gia-dung,137851814,"Quạt sạc đa năng Comet CRF1406 có đèn Led, pin Lithium 2 viên x 1500 mAh - Hàng chính hãng",359000,459000,100000,22
TIKI,dien-gia-dung,112328914,"Nồi lẩu mini đa năng 2 tầng ca nấu mì điện hấp hàn quốc",77722,77722,0,0
TIKI,dien-gia-dung,187345103,"Máy hút bụi không dây Lock&lock ENV356GRY đa năng cầm tay 3 trong 1 (lau sàn, hút bụi, hút bụi giường nệm), động cơ BLDC - Hàng chính hãng",4939000,9900000,4961000,50
TIKI,dien-gia-dung,76277433,"Máy Vắt Cam Sharp EJ-J407-BK - Hàng chính hãng",294000,430000,136000,32
TIKI,thiet-bi-kts-phu-kien-so,135284116,"Dây cáp sạc nhanh Rockspace Z18 dành cho iphone, chuẩn PD 20W, ổn định, không nóng máy - Hàng chính hãng ",129000,179000,50000,28
TIKI,thiet-bi-kts-phu-kien-so,16217261,"Cáp Mạng Lan 20m NS 4485",27000,32600,5600,17
TIKI,thiet-bi-kts-phu-kien-so,74213041,"Ốp lưng kính màu Gradient viền dẻo dành cho Samsung Galaxy Note 20",9000,9000,0,0
TIKI,thiet-bi-kts-phu-kien-so,138315981,"Bộ 2 miếng kính cường lực Gor cho Xiaomi Redmi Note 10 4G - Redmi Note 10S - Trong suốt - Hàng nhập khẩu",109000,109000,0,0
TIKI,thiet-bi-kts-phu-kien-so,55317648,"Ốp Lưng TPU 2 Màu - Xanh Bạc - iPhone 11 Pro Max",69000,69000,0,0
TIKI,thiet-bi-kts-phu-kien-so,91190008,"Cáp sạc nhanh Micro USB 2.0A Ugreen US290 độ dài từ 0.25m đến 2m, vỏ sợi bện siêu bền - Hàng chính hãng",90000,117000,27000,23
TIKI,thiet-bi-kts-phu-kien-so,123850410,"Ốp lưng chống sốc dành cho iPad Gen 9 - 10.2" - (2021) silicon dẻo cao cấp",99000,99000,0,0
TIKI,thiet-bi-kts-phu-kien-so,164543499,"Bao da TPU Lishen cho iPad Air, Air2, Pro 9.7, Gen 5, Gen 6 ( 9.7 inch ) khay lưng dẻo nắp gập giá rẻ",108000,108000,0,0
TIKI,thiet-bi-kts-phu-kien-so,40439112,"Bộ vệ sinh laptop 6 món",37900,37900,0,0
TIKI,thiet-bi-kts-phu-kien-so,74935461,"LÓT CHUỘT PEANUTS SNOOPY HÀNG CHÍNH HÃNG",99000,99000,0,0
TIKI,thiet-bi-kts-phu-kien-so,53970127,"Máy game huyền thoại cầm tay Brick Game - màu giao ngẫu nhiên",30000,30000,0,0
TIKI,thiet-bi-kts-phu-kien-so,44611291,"Dây đeo cho Samsung Galaxy Fit R370",32000,53700,21700,40
TIKI,thiet-bi-kts-phu-kien-so,183551497,"Micro không dây Soundmax MC-01 - Hàng Chính hãng ",580000,580000,0,0
TIKI,thiet-bi-kts-phu-kien-so,132812897,"Mic hát karaoke, Micro có dây, Micro Karaoke XINGMA AK-319 cao cấp thế hệ mới chống hú, chống rè",104000,104000,0,0
TIKI,thiet-bi-kts-phu-kien-so,51569227,"Ốp lưng silicon dẻo trong suốt dành cho Xiaomi Mi 8 Lite - Hàng cao cấp",12000,12000,0,0
TIKI,thiet-bi-kts-phu-kien-so,169927935,"Combo 4 Jack Đấu Loa Ngắn ( 2 Đỏ 2 Đen )",19400,19400,0,0
TIKI,thiet-bi-kts-phu-kien-so,104850969,"Cáp sạc nhanh 2.4A Baseus Cafule dây bện chống gập đồng bộ data nhanh chóng dành cho iPhone dài 100CM ( nhiều màu ) - Hàng chính hãng",89000,159000,70000,44
TIKI,thiet-bi-kts-phu-kien-so,33146789,"COMBO 2 ĐẦU CHUYỂN TỪ JACK 6LY SANG LỖ 3.5 LOẠI TỐT",25900,25900,0,0
TIKI,thiet-bi-kts-phu-kien-so,90582384,"Bộ 2 Kính cường lực cho Google Pixel 5A 5G - trong suốt chính hãng GOR vát 2,5D ( 2 miếng)",99000,99000,0,0
TIKI,thiet-bi-kts-phu-kien-so,96186082,"Bộ 2 Kính Cường Lực GOR cho Asus ROG Phone 5 , 5 Pro ( 2 Miếng ) trong suốt, siêu mượt _ Hàng Nhập Khẩu",99000,99000,0,0
TIKI,thiet-bi-kts-phu-kien-so,62832033,"Ốp lưng lụa mỏng dành cho Samsung Galaxy Note 20 Ultra Hãng Memumi bảo vệ camera, siêu mỏng 0.3 mm - Hàng Chính Hãng",99000,99000,0,0
TIKI,thiet-bi-kts-phu-kien-so,169921704,"Tụ Hóa 1000uF 63V",5880,5880,0,0
TIKI,thiet-bi-kts-phu-kien-so,10763494,"Lót chuột lazer có in viền",10950,10950,0,0
TIKI,thiet-bi-kts-phu-kien-so,3602035,"Bộ Chia 2 Máy Tính Dùng Chung 1 Máy In Ugreen 30345 - Hàng Chính Hãng",249000,249000,0,0
TIKI,thiet-bi-kts-phu-kien-so,173516289,"Ốp lưng dành cho Oppo Reno 6 - Reno 6 5G - Reno 6Z 5G - Hành Gia Vui Vẻ",58000,80000,22000,28
TIKI,thiet-bi-kts-phu-kien-so,59463514,"Miếng đệm ốp tai nghe dùng cho tai nghe DareU EH416 - Hàng Nhập Khẩu",75000,75000,0,0
TIKI,thiet-bi-kts-phu-kien-so,138940635,"Ốp lưng dành cho Iphone 13 Mini - Iphone 13 - Iphone 13 Pro -  Iphone 13 Pro Max - Vợ Chồng Bên Nhau",45000,55000,10000,18
TIKI,thiet-bi-kts-phu-kien-so,58232513,"Bộ 2 Kính Cường Lực GOR cho iPhone X/XS ( 2 Miếng full box ) - Hàng Nhập Khẩu",99000,99000,0,0
TIKI,thiet-bi-kts-phu-kien-so,88090683,"CHAI XỊT CHỐNG CHUỘT - ĐUỔI CHUỘT CHO XE Ô TÔ - XE MÁY LIQUI MOLY MARTEN SPRAY 1515 (200ML) NGĂN CẢN THÂM NGẬP CỦA CHUỘT",171000,171000,0,0
TIKI,thiet-bi-kts-phu-kien-so,124275132,"Chuột Quang Có Dây Ms111",27200,27200,0,0
TIKI,thiet-bi-kts-phu-kien-so,176403835,"Bộ 40 Dây Cắm Test Board 20cm",16000,16000,0,0
TIKI,thiet-bi-kts-phu-kien-so,155110508,"Bàn phím giả cơ một tay Nuos K13 chơi game cực tốt - Hàng nhập khẩu",139000,139000,0,0
TIKI,thiet-bi-kts-phu-kien-so,35569118,"Ốp lưng silicon dẻo trong suốt dành cho OPPO A9 2020 siêu mỏng 0.6mm",12000,12000,0,0
TIKI,thiet-bi-kts-phu-kien-so,22755359,"Kính Cường Lực Full Keo Dành Cho Samsung Note 8",80000,80000,0,0
TIKI,thiet-bi-kts-phu-kien-so,42970784,"Combo 2 Cuộn Băng Gai Dính, Băng Dán Thu Gọn Dây 3 Mét giúp buộc gọn dây Cáp sạc điện thoại, dây LAN, máy tính",59000,69000,10000,14
TIKI,thiet-bi-kts-phu-kien-so,4482143,"Cáp nối dây máy in dài 3m",14000,19900,5900,30
TIKI,thiet-bi-kts-phu-kien-so,103710725,"Bao da dành cho Samsung Galaxy A72 dạng ví, hít nam châm cao cấp Fashion Case",140000,140000,0,0
TIKI,thiet-bi-kts-phu-kien-so,194805886,"Con lăn keo 20 cm",92000,92000,0,0
TIKI,thiet-bi-kts-phu-kien-so,169921308,"Nút nhấn đề vỏ nhựa, không giữ trạng thái ( nhấn nhả )",3920,3920,0,0
TIKI,thiet-bi-kts-phu-kien-so,58678581,"Dây đeo vai điện thoại/Máy ảnh Ringke Shoulder Design Strap - Hàng Chính Hãng",225000,250000,25000,10
TIKI,thiet-bi-kts-phu-kien-so,130084156,"Cáp sạc cho iPhone/ iPad Baseus Superior Series Fast Charging Data Cable USB to iP (2.4A, 480Mbps, Fast charge, ABS/ TPE Cable)",69000,69000,0,0
TIKI,thiet-bi-kts-phu-kien-so,138489704,"Găng tay chơi game MEMO - Sợi Carbon cao cấp siêu bền, co dãn, đàn hồi tốt , độ nhạy cao - Hàng nhập khẩu",13000,20000,7000,35
TIKI,thiet-bi-kts-phu-kien-so,162028506,"Ốp lưng thoát nhiệt dành cho iPhone 11 / 12 / 13 / 11 Pro / 12 Pro / 13 Pro / 11 Pro Max / 12 Pro Max / 13 Pro Max / 12 Mini / 13 Mini - Hàng chính hãng",59000,99000,40000,40
TIKI,thiet-bi-kts-phu-kien-so,131338682,"Túi Dây rút Chống Thấm kỹ thuật Bảo vệ tai nghe,Pin Sạc điện thoại nhỏ,Các vật dụng Cá Nhân",13000,13000,0,0
TIKI,thiet-bi-kts-phu-kien-so,72008056,"Đế Sạc Không Dây Apple MagSafe Charger Hỗ Trợ Sạc Nhanh 15W MHXH3 - Trắng",1150000,1990000,840000,42
TIKI,thiet-bi-kts-phu-kien-so,52769271,"SIM 4G Vinaphone VD149 12T Trọn Gói 1 Năm Không Cần Nạp Tiền, Khuyến Mãi 120GB/Tháng, Gọi + SMS Miễn Phí Nội Mạng, Cộng Thêm 200 Phút Gọi Ngại Mạng Mỗi Tháng - Hàng Chính Hãng (Giao mẫu ngẫu nhiên)",1179000,1179000,0,0
TIKI,thiet-bi-kts-phu-kien-so,5511229,"Tấm lót chuột  (22 x 18cm)",9300,9300,0,0
TIKI,thiet-bi-kts-phu-kien-so,122393354,"Hub chuyển đổi USB TypeC 6 trong 1 SEASY SS26, Cổng chuyển đổi HUB USB TypeC to HDMI, 1 cổng HDMI 4k UHD , 3 cổng USB 3.0, 2 khe đọc thẻ nhớ SD và TF, Kết nối nhiều thiết bị với tốc độ cao, Dùng cho Điện thoại/Laptop/PC/Macbook – Hàng chính hãng",279500,279500,0,0
TIKI,thiet-bi-kts-phu-kien-so,161541791,"Miếng Dán Bảo Vệ Viền PDF Kai dành cho iPhone 13 / 13 Pro / 13 Pro Max - Hàng Chính Hãng",23750,25000,1250,5
TIKI,thiet-bi-kts-phu-kien-so,87740824,"Thẻ nhớ MicroSD có bảo hành 12 tháng dùng kèm cho các thiết bị Điện thoại, máy ảnh, camera ip - NPD-MicroSD (Nhiều loại)",65000,100000,35000,35
TIKI,thiet-bi-kts-phu-kien-so,25410296,"Chuột Không Dây Wireless 2.4G HXSJ T21 - Hàng chính hãng",129000,249000,120000,48
TIKI,thiet-bi-kts-phu-kien-so,73822516,"Đầu Ngòi Bút Thay Thế Cao Cấp Cho Apple Pencil 1 / Apple Pencil 2 - Apple Pencil Tips",94000,94000,0,0
TIKI,thiet-bi-kts-phu-kien-so,45579046,"Adapter Sạc 2 Cổng Tích Hợp Type-C In/Out Hỗ Trợ Sạc Nhanh PD Power Delivery 61W RAVPower RP-PC105 - Hàng Chính Hãng",499000,850000,351000,41
TIKI,thiet-bi-kts-phu-kien-so,87108370,"Dây Cáp Sạc Nhanh USB Type C To Type C 60W Dài 1.2M Hỗ Trợ Sạc Nhanh iPhone 15 CHOETECH XCC-1003 - Hàng Chính Hãng",119000,210000,91000,43
TIKI,thiet-bi-kts-phu-kien-so,168122417,"Hub chuyển đổi USB Type C 3in1 sang HDMI, USB 3.0, cổng sạc nhanh PD Type-C dành cho Laptop, Macbook, Điện thoại, Samsung Dex",115000,159000,44000,28
TIKI,thiet-bi-kts-phu-kien-so,147125769,"Lót Chuột Phím Tắt Văn Phòng 80x30cm - Bàn Di Chuột Cỡ Lớn",44900,44900,0,0
TIKI,thiet-bi-kts-phu-kien-so,130172342,"Cáp sạc nhanh siêu bền IP 20W Baseus Superior Series Fast Charging Data Cable Type-C to iP PD (480Mbps)-Hỗ trợ sạc nhanh PD 20W trên iPhone 12 / PD 18W trên iP11/ iP XS Max- Hàng chính hãng",109000,109000,0,0
TIKI,thiet-bi-kts-phu-kien-so,126003,"Tai Nghe Chụp Tai Sony MDR-ZX310AP",675000,890000,215000,24
TIKI,thiet-bi-kts-phu-kien-so,192127239,"Đầu Chuyển Đổi USB Type C Sang USB 3.0 Hàng Chính Hãng, Hub Type C, Hub chuyển đổi USB Type-C Sang USB 3.0 - Hàng Chính Hãng",29000,90000,61000,68
TIKI,thiet-bi-kts-phu-kien-so,184783198,"Bộ sạc nhanh 10W (5V/2A) chân dẹt màu trắng tặng kèm cáp sạc USB micro dùng cho samsung, sony, nokia, vivo, oppo, redmi...",75000,75000,0,0
TIKI,thiet-bi-kts-phu-kien-so,103637245,"Dây sạc type C to C PROLiNK GCC_60_01 dài 1M, sạc siêu nhanh 60W, dành cho Samsung, Xiaomi, iPad Pro - Hàng chính hãng",69000,100000,31000,31
TIKI,thiet-bi-kts-phu-kien-so,33651679,"Ốp Lưng Silicon TPU trong suốt GOR cho Samsung Note 10/ Note 10 Plus_Hàng NHập Khẩu",40000,40000,0,0
TIKI,thiet-bi-kts-phu-kien-so,191501918,"Dây Cao Su Thay Thế cho Samsung Galaxy Fit 2 (SM-R220)- Hàng chính hãng",75000,75000,0,0
TIKI,thiet-bi-kts-phu-kien-so,900466,"Miếng Lót Chuột Logitech G440 - Hàng Chính Hãng",439000,449000,10000,2
TIKI,thiet-bi-kts-phu-kien-so,47470738,"Giá đỡ điện thoại kẹp điện thoại cao cấp 126  - Hàng Chính Hãng",99500,159000,59500,37
TIKI,thiet-bi-kts-phu-kien-so,19336345,"Dây Đeo Thay Thế Cho Vòng Đeo Tay Thông Minh Xiaomi Mi Band 3 / Mi Band 4 Dẻo TPU",32000,32000,0,0
TIKI,thiet-bi-kts-phu-kien-so,145124952,"Kính cường lực full màn hình Hoco G5 cho iPhone 13/ 13 pro/ 13 pro max - Hàng nhập khẩu",44999,51998,6999,13
TIKI,thiet-bi-kts-phu-kien-so,180912,"Bàn Phím Bluetooth Logitech K380 - Hàng Chính Hãng",600000,809000,209000,26
TIKI,thiet-bi-kts-phu-kien-so,36729773,"Dây sạc USB Type C sạc nhanh Qualcomm Quick Charge cho dòng Samsung và các máy có cổng Type-C khác",19000,19000,0,0
TIKI,thiet-bi-kts-phu-kien-so,112984330,"Giá Đỡ Laptop Để Bàn Hợp Kim Nhôm Cao Cấp - Gấp Gọn Tiện Lợi - Tản Nhiệt Mang Đến Góc Độ Nhìn Khoa Học Khi Làm Việc Học Tập-Hàng Chính Hãng",298000,298000,0,0
TIKI,thiet-bi-kts-phu-kien-so,75655835,"Chuột không dây A2 Pro, chuột máy tính không tạo tiếng ồn, có thể sạc lại, hiệu ứng đèn Led RGB- Hàng nhập khẩu",62800,62800,0,0
TIKI,thiet-bi-kts-phu-kien-so,57282867,"Tay cầm chơi game Fifa online 4 trên pc, laptop -black",153400,153400,0,0
TIKI,thiet-bi-kts-phu-kien-so,72818491,"Giá Đỡ Điện Thoại, Máy Tính Bảng Hợp Kim Nhôm Gập Hai Chỗ Có Thể Gấp Gọn Hàng Chính Hãng Tamayoko",249000,400000,151000,38
TIKI,thiet-bi-kts-phu-kien-so,20075565,"Cáp chia nguồn sata 1 ra 2 vuông góc 90 độ",25000,25000,0,0
TIKI,thiet-bi-kts-phu-kien-so,10784603,"Tai nghe chuyên game có Mic Plextone G25",189000,189000,0,0
TIKI,thiet-bi-kts-phu-kien-so,3237483,"Bàn Phím Gaming DareU LK145 USB - Hàng Chính Hãng",380000,380000,0,0
TIKI,thiet-bi-kts-phu-kien-so,74165192,"Giá Đỡ Laptop Đế Tản Nhiệt Laptop Để Bàn Chất Liệu Hợp Kim Nhôm Cao Cấp Tản Nhiệt – Nâng Hạ Điều Chỉnh Độ Cao - Gấp Gọn Cho Kích Cỡ 10-18 Inches Hàng Chính Hãng",599000,599000,0,0
TIKI,thiet-bi-kts-phu-kien-so,139713984,"Tai nghe không dây gaming X15 TWS công nghệ Bluetooth 5.0 cảm biến chạm, không có độ trễ, thiết kế thể thao ( Chip Jerry 6976D5)",199000,199000,0,0
TIKI,thiet-bi-kts-phu-kien-so,136042337,"Cáp chuyển đổi Seasy, Type-c ra 4 cổng HDMI/ VGA/ USB và cổng sạc hỗ trợ chế độ Dex - Hàng chính hãng",289000,389000,100000,26
TIKI,thiet-bi-kts-phu-kien-so,87107826,"Dây Cáp Sạc Type C To Lightning CHOETECH IP0039 MFI C94 Dài 1.2M Sạc Nhanh 20W Dành Cho iPhone 11, 12, IP13, IP14, Cho iPad - Hàng Chính Hãng",269000,450000,181000,40
TIKI,thiet-bi-kts-phu-kien-so,129586149,"Dây Audio chuyển tai nghe 3.5mm đầu cái sang 2 đầu Mic và Tai nghe đầu đực mạ vàng dài 20CM UGREEN AV140 20899,20897 hàng chính hãng",92000,92000,0,0
TIKI,thiet-bi-kts-phu-kien-so,8130816,"Bộ Chuyển Âm Thanh TV 4K Quang Optical Sang Audio AV Ra Amply + Cáp Optical (1m)",74000,74000,0,0
TIKI,thiet-bi-kts-phu-kien-so,36189773,"Chuột Bluetooth không dây loại xịn ADGX2 kết nối qua cổng USB không dây và Bluetooth đều được 2 trong 1 - Hàng nhập khẩu",75800,75800,0,0
TIKI,thiet-bi-kts-phu-kien-so,203734,"Chuột Không Dây Logitech M325 - Hàng Chính Hãng",432000,432000,0,0
TIKI,thiet-bi-kts-phu-kien-so,57518181,"Webcam HYSJ A849S cho máy tính - hàng nhập khẩu",150000,150000,0,0
TIKI,thiet-bi-kts-phu-kien-so,19611388,"Cáp Chuyên Đổi USB Ra Tai nghe Và Mic 7.1 Cao Cấp AZONE - Hàng Nhập Khẩu",35900,35900,0,0
TIKI,thiet-bi-kts-phu-kien-so,14011811,"Loa Bluetooth mini BS-01 - Loa Bluetooth Thời Trang Nhỏ Gọn ( Màu Ngẫu Nhiên )",119999,119999,0,0
TIKI,thiet-bi-kts-phu-kien-so,56879851,"Chuột Quang MACRO HXJS J900 RGB Bề Mặt Lưới Xuyên Thấu Cực Đẹp DPI 6400 - Hàng chính hãng",299000,399000,100000,25
TIKI,thiet-bi-kts-phu-kien-so,50586261,"Hub chia 1 ra 3 cổng USB",79000,79000,0,0
TIKI,thiet-bi-kts-phu-kien-so,97968242,"Đồng hồ thông minh trẻ em Q20, Lắp sim nghe gọi, định vị trẻ, chụp ảnh, giao diện Tiếng Việt - Hàng Nhập Khẩu",223000,223000,0,0
TIKI,thiet-bi-kts-phu-kien-so,33552972,"Chân Giá Đỡ Kẹp Micro",74420,74420,0,0
TIKI,thiet-bi-kts-phu-kien-so,20265205,"Bao Da Cover Cho Máy Tính Bảng Samsung Galaxy Tab A 10.1 (2019) T510 / T515 Hỗ Trợ Smart Cover",129000,129000,0,0
TIKI,thiet-bi-kts-phu-kien-so,84883551,"Tay cầm chơi game không dây E-dra EGP7601 Bluetooth/Receiver  - Hàng Chính Hãng",459000,459000,0,0
TIKI,thiet-bi-kts-phu-kien-so,76551611,"Miếng Dán Kính Cường Lực Camera chống trầy GOR cho iPhone 12 Mini / 12 / 12 Pro / 12 Pro Max (Bộ 2 Miếng) - Hàng Nhập Khẩu",65994,65994,0,0
TIKI,thiet-bi-kts-phu-kien-so,2292695,"Ốp lưng iPhone 7 plus / iPhone 8 Plus dẻo trong suốt mỏng 0.6mm chống trầy xước",29000,29000,0,0
TIKI,thiet-bi-kts-phu-kien-so,196479355,"Tai Nghe Bluetooth True WIreless TWS Cảm Ứng TCT-S18 Chống Ồn ENC - Mic Đàm Thoại- Chế Độ Nhạc vs Gaming - Điều Chỉnh Tăng Giảm Âm Lượng - Hàng Chính Hãng",599000,800000,201000,25
TIKI,thiet-bi-kts-phu-kien-so,23044885,"Đồng hồ cà chua Pomodoro - Tối ưu hóa hiệu quả làm việc của bạn",41000,41000,0,0
TIKI,thiet-bi-kts-phu-kien-so,196478933,"Tai Nghe Bluetooth True Wireless Cảm Ứng Không Dây TCT-HGD-X10 Dung Lượng Pin Lớn-Điều Chỉnh Âm Lượng - Hàng Chính Hãng",599000,599000,0,0
TIKI,thiet-bi-kts-phu-kien-so,35223515,"Cáp máy in 5M chống nhiễu cao cấp",44900,44900,0,0
TIKI,thiet-bi-kts-phu-kien-so,195134097,"Ốp lưng chống sốc cho Samsung Galaxy Z Fold 3 hiệu Likgus Glitter siêu mỏng 1.5mm độ trong tuyệt đối, chống trầy xước, chống ố vàng, tản nhiệt tốt - hàng nhập khẩu",108999,108999,0,0
TIKI,thiet-bi-kts-phu-kien-so,5993887,"Dây cáp DisplayPort 2 đầu đực tốc độ 21.6Gbps dài 3M UGREEN DP102 10212 - Hàng Chính Hãng",190000,190000,0,0
TIKI,thiet-bi-kts-phu-kien-so,50254961,"Ốp lưng dẻo cho Samsung Galaxy S20 Plus hiệu Nillkin mỏng 0.6mm, chống trầy xước - Hàng chính hãng",88000,88000,0,0
TIKI,thiet-bi-kts-phu-kien-so,120462537,"CÁP MÁY IN CHỐNG NHIỄU LOẠI TỐT CHUẨN USB 2.0 CHIỀU DÀI 1,5M / 3M /5M",10050,10050,0,0
TIKI,thiet-bi-kts-phu-kien-so,117091126,"Bao da kèm bàn phím Bluetooth dành cho Samsung Galaxy Tab S7 FE cao cấp - Hàng nhập khẩu",550000,550000,0,0
TIKI,thiet-bi-kts-phu-kien-so,165519983,"Dán cường lực Zeelot Pure Shield Glass Cho Galaxy Tab S8/ S8 Plus/ S8 Ultra - Hàng Chính Hãng",450000,450000,0,0
TIKI,thiet-bi-kts-phu-kien-so,33577507,"Ốp lưng silicon dẻo trong suốt dành cho SamSung Galaxy A50s siêu mỏng 0.5 mm",17000,17000,0,0
TIKI,thiet-bi-kts-phu-kien-so,110948021,"Tai nghe HiFi Headphone có dây siêu nhẹ Remax RM-595 [Hàng chính hãng",230050,330000,99950,30
TIKI,thiet-bi-kts-phu-kien-so,105513634,"Tai Nghe Bluetooth Tai Nghe Cảm Ứng Không Dây Wireless Headset - Hàng Chính Hãng PKCB",200000,500000,300000,60
TIKI,thiet-bi-kts-phu-kien-so,92084797,"Củ Sạc Adapter Baseus Super Si 20W Mini Type C Blue - PD/QC 3.0 - Tự Động Điều Chỉnh Ổn Định Dòng Điện - Hàng Chính Hãng",149000,149000,0,0
TIKI,thiet-bi-kts-phu-kien-so,112055244,"Đầu ngòi thay thế cho bút Apple Pencil 1/ Pencil 2 - Dùng như ngòi gốc Apple pencil tips_ Hàng Chính Hãng",89000,99000,10000,10
TIKI,thiet-bi-kts-phu-kien-so,174665988,"Bộ Bàn Phím Và Chuột Không Dây Wireless Microsoft 850 - PY9-00018 - Hàng Chính Hãng",599000,890000,291000,33
TIKI,thiet-bi-kts-phu-kien-so,20206058,"Bao Da Cover Cho Apple Ipad Mini 4 Mini 5 2019 Hỗ Trợ Smart Cover Gấp Chéo",160000,160000,0,0
TIKI,thiet-bi-kts-phu-kien-so,129728635,"Pad da dành cho tai nghe beats studio 3 - mút cao cấp",290000,290000,0,0
TIKI,thiet-bi-kts-phu-kien-so,101847035,"Loa Bluetooth Không Dây Cao Cấp XSmart A36 PRO BASS 2021 Âm Thanh Nghe Nhạc Siêu Đã Tương Thích Điện Thoại Máy Tính Laptop Tivi - Hàng Chính Hãng",179000,179000,0,0
TIKI,thiet-bi-kts-phu-kien-so,16051164,"Vô Lăng Logitech G29 Kèm Cần Số Rời - Hàng chính hãng",7700000,7999000,299000,4
TIKI,thiet-bi-kts-phu-kien-so,140376071,"Tai nghe bluetooth True Wireless thiết kế retro Remax TWS-38 - Hàng chính hãng",550000,990000,440000,44
TIKI,thiet-bi-kts-phu-kien-so,56248615,"Dây Đeo Thay Thế Cho Vòng Đeo Tay Thông Minh Xiaomi Mi Band 3 Mi Band 4 - Hàng Chính Hãng",28000,90000,62000,69
TIKI,thiet-bi-kts-phu-kien-so,117927658,"Máy chơi game cầm tay 4 nút Game stick 4k HDMI PS3000 kết nối không dây 3500 trò chơi",560000,580000,20000,3
TIKI,thiet-bi-kts-phu-kien-so,56458881,"Giá Đở Điện Thoại Và Máy Tính Bảng",13998,13998,0,0
TIKI,thiet-bi-kts-phu-kien-so,72295922,"Bàn Phím LED LANGTU L1 Black - hàng nhập khẩu",346000,346000,0,0
TIKI,lam-dep-suc-khoe,130084156,"Cáp sạc cho iPhone/ iPad Baseus Superior Series Fast Charging Data Cable USB to iP (2.4A, 480Mbps, Fast charge, ABS/ TPE Cable)",69000,69000,0,0
TIKI,lam-dep-suc-khoe,138489704,"Găng tay chơi game MEMO - Sợi Carbon cao cấp siêu bền, co dãn, đàn hồi tốt , độ nhạy cao - Hàng nhập khẩu",13000,20000,7000,35
TIKI,lam-dep-suc-khoe,162028506,"Ốp lưng thoát nhiệt dành cho iPhone 11 / 12 / 13 / 11 Pro / 12 Pro / 13 Pro / 11 Pro Max / 12 Pro Max / 13 Pro Max / 12 Mini / 13 Mini - Hàng chính hãng",59000,99000,40000,40
TIKI,lam-dep-suc-khoe,5511229,"Tấm lót chuột  (22 x 18cm)",9300,9300,0,0
TIKI,lam-dep-suc-khoe,126003,"Tai Nghe Chụp Tai Sony MDR-ZX310AP",675000,890000,215000,24
TIKI,lam-dep-suc-khoe,19336345,"Dây Đeo Thay Thế Cho Vòng Đeo Tay Thông Minh Xiaomi Mi Band 3 / Mi Band 4 Dẻo TPU",32000,32000,0,0
TIKI,lam-dep-suc-khoe,131338682,"Túi Dây rút Chống Thấm kỹ thuật Bảo vệ tai nghe,Pin Sạc điện thoại nhỏ,Các vật dụng Cá Nhân",13000,13000,0,0
TIKI,lam-dep-suc-khoe,52769271,"SIM 4G Vinaphone VD149 12T Trọn Gói 1 Năm Không Cần Nạp Tiền, Khuyến Mãi 120GB/Tháng, Gọi + SMS Miễn Phí Nội Mạng, Cộng Thêm 200 Phút Gọi Ngại Mạng Mỗi Tháng - Hàng Chính Hãng (Giao mẫu ngẫu nhiên)",1179000,1179000,0,0
TIKI,lam-dep-suc-khoe,10784603,"Tai nghe chuyên game có Mic Plextone G25",189000,189000,0,0
TIKI,lam-dep-suc-khoe,147125769,"Lót Chuột Phím Tắt Văn Phòng 80x30cm - Bàn Di Chuột Cỡ Lớn",44900,44900,0,0
TIKI,lam-dep-suc-khoe,130172342,"Cáp sạc nhanh siêu bền IP 20W Baseus Superior Series Fast Charging Data Cable Type-C to iP PD (480Mbps)-Hỗ trợ sạc nhanh PD 20W trên iPhone 12 / PD 18W trên iP11/ iP XS Max- Hàng chính hãng",109000,109000,0,0
TIKI,lam-dep-suc-khoe,45579046,"Adapter Sạc 2 Cổng Tích Hợp Type-C In/Out Hỗ Trợ Sạc Nhanh PD Power Delivery 61W RAVPower RP-PC105 - Hàng Chính Hãng",499000,850000,351000,41
TIKI,lam-dep-suc-khoe,87740824,"Thẻ nhớ MicroSD có bảo hành 12 tháng dùng kèm cho các thiết bị Điện thoại, máy ảnh, camera ip - NPD-MicroSD (Nhiều loại)",65000,100000,35000,35
TIKI,lam-dep-suc-khoe,900466,"Miếng Lót Chuột Logitech G440 - Hàng Chính Hãng",439000,449000,10000,2
TIKI,lam-dep-suc-khoe,36729773,"Dây sạc USB Type C sạc nhanh Qualcomm Quick Charge cho dòng Samsung và các máy có cổng Type-C khác",19000,19000,0,0
TIKI,lam-dep-suc-khoe,191501918,"Dây Cao Su Thay Thế cho Samsung Galaxy Fit 2 (SM-R220)- Hàng chính hãng",75000,75000,0,0
TIKI,lam-dep-suc-khoe,145124952,"Kính cường lực full màn hình Hoco G5 cho iPhone 13/ 13 pro/ 13 pro max - Hàng nhập khẩu",44999,51998,6999,13
TIKI,lam-dep-suc-khoe,33651679,"Ốp Lưng Silicon TPU trong suốt GOR cho Samsung Note 10/ Note 10 Plus_Hàng NHập Khẩu",40000,40000,0,0
TIKI,lam-dep-suc-khoe,161541791,"Miếng Dán Bảo Vệ Viền PDF Kai dành cho iPhone 13 / 13 Pro / 13 Pro Max - Hàng Chính Hãng",23750,25000,1250,5
TIKI,lam-dep-suc-khoe,122393354,"Hub chuyển đổi USB TypeC 6 trong 1 SEASY SS26, Cổng chuyển đổi HUB USB TypeC to HDMI, 1 cổng HDMI 4k UHD , 3 cổng USB 3.0, 2 khe đọc thẻ nhớ SD và TF, Kết nối nhiều thiết bị với tốc độ cao, Dùng cho Điện thoại/Laptop/PC/Macbook – Hàng chính hãng",279500,279500,0,0
TIKI,lam-dep-suc-khoe,168122417,"Hub chuyển đổi USB Type C 3in1 sang HDMI, USB 3.0, cổng sạc nhanh PD Type-C dành cho Laptop, Macbook, Điện thoại, Samsung Dex",115000,159000,44000,28
TIKI,lam-dep-suc-khoe,180912,"Bàn Phím Bluetooth Logitech K380 - Hàng Chính Hãng",600000,809000,209000,26
TIKI,lam-dep-suc-khoe,112984330,"Giá Đỡ Laptop Để Bàn Hợp Kim Nhôm Cao Cấp - Gấp Gọn Tiện Lợi - Tản Nhiệt Mang Đến Góc Độ Nhìn Khoa Học Khi Làm Việc Học Tập-Hàng Chính Hãng",298000,298000,0,0
TIKI,lam-dep-suc-khoe,139713984,"Tai nghe không dây gaming X15 TWS công nghệ Bluetooth 5.0 cảm biến chạm, không có độ trễ, thiết kế thể thao ( Chip Jerry 6976D5)",199000,199000,0,0
TIKI,lam-dep-suc-khoe,25410296,"Chuột Không Dây Wireless 2.4G HXSJ T21 - Hàng chính hãng",129000,249000,120000,48
TIKI,lam-dep-suc-khoe,73822516,"Đầu Ngòi Bút Thay Thế Cao Cấp Cho Apple Pencil 1 / Apple Pencil 2 - Apple Pencil Tips",94000,94000,0,0
TIKI,lam-dep-suc-khoe,20075565,"Cáp chia nguồn sata 1 ra 2 vuông góc 90 độ",25000,25000,0,0
TIKI,lam-dep-suc-khoe,103637245,"Dây sạc type C to C PROLiNK GCC_60_01 dài 1M, sạc siêu nhanh 60W, dành cho Samsung, Xiaomi, iPad Pro - Hàng chính hãng",69000,100000,31000,31
TIKI,lam-dep-suc-khoe,3237483,"Bàn Phím Gaming DareU LK145 USB - Hàng Chính Hãng",380000,380000,0,0
TIKI,lam-dep-suc-khoe,87108370,"Dây Cáp Sạc Nhanh USB Type C To Type C 60W Dài 1.2M Hỗ Trợ Sạc Nhanh iPhone 15 CHOETECH XCC-1003 - Hàng Chính Hãng",119000,210000,91000,43
TIKI,lam-dep-suc-khoe,57282867,"Tay cầm chơi game Fifa online 4 trên pc, laptop -black",153400,153400,0,0
TIKI,lam-dep-suc-khoe,72008056,"Đế Sạc Không Dây Apple MagSafe Charger Hỗ Trợ Sạc Nhanh 15W MHXH3 - Trắng",1150000,1990000,840000,42
TIKI,lam-dep-suc-khoe,87107826,"Dây Cáp Sạc Type C To Lightning CHOETECH IP0039 MFI C94 Dài 1.2M Sạc Nhanh 20W Dành Cho iPhone 11, 12, IP13, IP14, Cho iPad - Hàng Chính Hãng",269000,450000,181000,40
TIKI,lam-dep-suc-khoe,192127239,"Đầu Chuyển Đổi USB Type C Sang USB 3.0 Hàng Chính Hãng, Hub Type C, Hub chuyển đổi USB Type-C Sang USB 3.0 - Hàng Chính Hãng",29000,90000,61000,68
TIKI,lam-dep-suc-khoe,136042337,"Cáp chuyển đổi Seasy, Type-c ra 4 cổng HDMI/ VGA/ USB và cổng sạc hỗ trợ chế độ Dex - Hàng chính hãng",289000,389000,100000,26
TIKI,lam-dep-suc-khoe,72818491,"Giá Đỡ Điện Thoại, Máy Tính Bảng Hợp Kim Nhôm Gập Hai Chỗ Có Thể Gấp Gọn Hàng Chính Hãng Tamayoko",249000,400000,151000,38
TIKI,lam-dep-suc-khoe,184783198,"Bộ sạc nhanh 10W (5V/2A) chân dẹt màu trắng tặng kèm cáp sạc USB micro dùng cho samsung, sony, nokia, vivo, oppo, redmi...",75000,75000,0,0
TIKI,lam-dep-suc-khoe,47470738,"Giá đỡ điện thoại kẹp điện thoại cao cấp 126  - Hàng Chính Hãng",99500,159000,59500,37
TIKI,lam-dep-suc-khoe,75655835,"Chuột không dây A2 Pro, chuột máy tính không tạo tiếng ồn, có thể sạc lại, hiệu ứng đèn Led RGB- Hàng nhập khẩu",62800,62800,0,0
TIKI,lam-dep-suc-khoe,74165192,"Giá Đỡ Laptop Đế Tản Nhiệt Laptop Để Bàn Chất Liệu Hợp Kim Nhôm Cao Cấp Tản Nhiệt – Nâng Hạ Điều Chỉnh Độ Cao - Gấp Gọn Cho Kích Cỡ 10-18 Inches Hàng Chính Hãng",599000,599000,0,0
TIKI,thiet-bi-kts-phu-kien-so,152567389,"Sạc Dự Phòng Hoco J82 10000mAh Chính Hãng",139000,139000,0,0
TIKI,thiet-bi-kts-phu-kien-so,15725114,"Ốp lưng nhám siêu mỏng 0.3mm cho iPhone XS Max hiệu Memumi có gờ bảo vệ camera (đen) - Hàng chính hãng",87580,175160,87580,50
TIKI,thiet-bi-kts-phu-kien-so,52809028,"Dây USB 2.0 sang Mini USB mạ vàng dài 1M UGREEN US132 10355 (đen) - Hàng chính hãng",50000,62000,12000,19
TIKI,thiet-bi-kts-phu-kien-so,190202987,"Pin sạc dự phòng Energizer 10000mAh/3.7V UE10052BK - Hàng chính hãng",340000,550000,210000,38
TIKI,thiet-bi-kts-phu-kien-so,73383975," Kệ điện thoại, iPad để bàn có thể gập gọn, chống tê mỏi tay",20900,20900,0,0
TIKI,thiet-bi-kts-phu-kien-so,192804341,"Tripod mini - Gậy chụp ảnh - gậy tự sướng bluetooth không dây BT11 Selfie stick Tripod CAO1,7 mét kèm đèn led và điền khiển chụp ảnh từ xa - Giao màu ngẫu nhiên - Hàng Chính Hãng",276000,450000,174000,39
TIKI,thiet-bi-kts-phu-kien-so,135651780,"Ốp viền kính bảo vệ camera , vòng kim loại chống trầy xướt dành cho iPhone  13 Pro/ 13 Pro Max",42000,80000,38000,48
TIKI,thiet-bi-kts-phu-kien-so,198233,"Máy Nghe Nhạc Sony Walkman NW-WS413",2690000,2690000,0,0
TIKI,thiet-bi-kts-phu-kien-so,604943,"Loa Bluetooth Anker Soundcore Mini - A31011B1",850000,850000,0,0
TIKI,thiet-bi-kts-phu-kien-so,114691752,"Thiết Bị Nhận Bluetooth NFC Cho Loa Và Amply M6 - Bộ Chuyển Đổi Âm Thanh Không Dây Bluetooth 3 Trong 1 Có Điều Khiển Từ Xa Cho USB  Phát Và Truyền Thẻ TF Hiển Thị Màn Hình Led - Hàng Chính Hãng",399000,399000,0,0
TIKI,thiet-bi-kts-phu-kien-so,428235,"Loa Vi Tính Microlab M-300 2.1 (38W) - Hàng Chính Hãng",785000,785000,0,0
TIKI,thiet-bi-kts-phu-kien-so,63861299,"BẢNG VẼ ĐIỆN TỬ XP-PEN DECO MINI7 ANDROID HỖ TRỢ CẢM ỨNG NGHIÊNG BÚT VẼ KHÔNG SẠC P05D - HÀNG CHÍNH HÃNG",1295000,1295000,0,0
TIKI,thiet-bi-kts-phu-kien-so,75068056,"Củ Sạc Nhanh ZMI APB03 50W Kiêm Pin Dự Phòng 6700mAh, Kèm Cáp 2 Đầu Type C Dài 1m - Hàng Nhập Khẩu",990000,990000,0,0
TIKI,thiet-bi-kts-phu-kien-so,169977869,"Ốp lưng Usams siêu mỏng khoét từng camera dành cho iPhone 13 Pro Max - Hàng chính hãng",131039,137936,6897,5
TIKI,thiet-bi-kts-phu-kien-so,103615993,"Dây sạc type C to C PROLiNK GCC_100G2_01 dài 2M, Sạc siêu nhanh 100W, truyền dữ liệu audio, video 4K - Hàng chính hãng",219000,269000,50000,19
TIKI,thiet-bi-kts-phu-kien-so,270878718,"Cáp chuyển đổi kết nối ổ cứng HDD từ Usb 3.0 sang Sata 22 Pin 2.5 inch",75050,79000,3950,5
TIKI,thiet-bi-kts-phu-kien-so,178762645,"Củ sạc ba cổng Samsung T6530 (Max 65W) (Không kèm cáp) - Hàng Chính Hãng",1490000,1490000,0,0
TIKI,thiet-bi-kts-phu-kien-so,72850567,"Cáp HDMI 2.1 8K 60Hz 4K 120hz Cao Cấp màu đen Ugreen 135MM70319HD 1M hàng chính hãng",250000,250000,0,0
TIKI,thiet-bi-kts-phu-kien-so,137115097,"Case ốp cho Samsung Galaxy Buds 2 Pro/ Buds 2 TPU Kai Trong Suốt Animal Kèm Móc Treo_ Hàng Chính Hãng",84550,89000,4450,5
TIKI,thiet-bi-kts-phu-kien-so,167545410,"Keycap nhựa PBT cao cấp công nghệ in tiên tiến cực sắc nét nhiều mẫu lựa chọn - Hàng nhập khẩu",150000,150000,0,0
TIKI,thiet-bi-kts-phu-kien-so,100083467,"Tai Nghe Bluetooth Không Dây Nhét Tai, Cảm Ứng Vân Tay, Âm Thanh Hay - Hàng Chính Hãng",194000,500000,306000,61
TIKI,thiet-bi-kts-phu-kien-so,196515840,"Đế SẠC ĐÔI Samsung không dây - P5400 - Hàng Chính Hãng -  (Sản phẩm  gồm có: 1 đế sạc đôi & 1 bộ sạc nhanh 25w)",790000,790000,0,0
TIKI,thiet-bi-kts-phu-kien-so,137851155,"Bộ 2 kính cường lực Gor cho Xiaomi Mi 11T, 11T Pro 5G  trong suốt, vuốt mượt ( hộp 2 miếng) hàng nhập khẩu",99000,99000,0,0
TIKI,thiet-bi-kts-phu-kien-so,165085694,"Combo Củ Sạc Nhanh PPS PD 25W CHOETECH PD6003 Và Cáp Type C 60W Dài 1.2m XCC-1003 Cho Điện Thoại Samsung, Oppo, Vivo, Xiaomi - Hàng Chính Hãng",369000,590000,221000,37
TIKI,thiet-bi-kts-phu-kien-so,72628067,"Loa Thanh Siêu Trầm Bluetooth Gaming Soundbar 20W Để Bàn BS-10 Dùng Cho Máy Vi Tính PC, Laptop, Tivi",639000,639000,0,0
TIKI,thiet-bi-kts-phu-kien-so,97683764,"Kính cường lực 21D full màn hình dành cho Samsung A32, A52, A72",28000,28000,0,0
TIKI,thiet-bi-kts-phu-kien-so,26334631,"Máy nghe nhạc thẻ nhớ. USB, đài FM CR-853",168800,168800,0,0
TIKI,thiet-bi-kts-phu-kien-so,12276970,"Bàn Phím Cơ Có Dây DareU EK87 LED Tenkeyless",495000,495000,0,0
TIKI,thiet-bi-kts-phu-kien-so,74749721,"Chuột game không dây Logitech G Pro X Superlight - Siêu nhẹ, cảm biến Hero 25k, 25.6k DPI, Lightspeed, 5 nút lập trình, pin lâu, PC - Hàng chính hãng",2750000,2750000,0,0
TIKI,thiet-bi-kts-phu-kien-so,58932076,"Dây đeo thay thế cho Xiaomi Miband 5 nhựa dẻo TPU Trơn nhiều màu",29000,29000,0,0
TIKI,thiet-bi-kts-phu-kien-so,70101426,"Thiết Bị Thu Phát Nhạc Không Dây USB Bluetooth 5.0 TR6",32000,32000,0,0
TIKI,thiet-bi-kts-phu-kien-so,21861296,"Bộ chia USB 7 cổng có công tắc",38750,38750,0,0
TIKI,thiet-bi-kts-phu-kien-so,113245352,"Case Silicon cho Sony WF-1000XM4 Hình Máy Game Switch Kèm Móc Treo_ Hàng Chính Hãng",181000,199000,18000,9
TIKI,thiet-bi-kts-phu-kien-so,14104513,"Củ Sạc HOCO 1A UH102 - Hàng Chính Hãng",45000,55000,10000,18
TIKI,thiet-bi-kts-phu-kien-so,8706328,"Ốp dẻo silicon dành cho Samsung S8 - Trong suốt",18000,18000,0,0
TIKI,thiet-bi-kts-phu-kien-so,56262647,"Ốp lưng Vsmart Active 3 - Óp đen dẻo và ốp trong",15000,15000,0,0
TIKI,thiet-bi-kts-phu-kien-so,104540748,"Công Tắc Hẹn Giờ Điện Tử Bật Tắt Chu Kỳ Tháng Điều Khiển ATS TM6",248000,248000,0,0
TIKI,thiet-bi-kts-phu-kien-so,173429657,"Ốp lưng cho Huawei Nova 3i dẻo Carbon phay xước chống sốc chống vân tay",39000,39000,0,0
TIKI,thiet-bi-kts-phu-kien-so,7740549,"Khung giá đỡ iPad - Máy tính bảng VNR",14250,15000,750,5
TIKI,thiet-bi-kts-phu-kien-so,195658280,"Ốp Lưng Nillkin Super Frosted Shield Pro dành cho iPhone 14 / 14 Max / 14 Pro / 14 ProMax - Hàng Chính Hãng",116800,116800,0,0
TIKI,lam-dep-suc-khoe,140537792,"Sữa rửa mặt Hatomugi hạt ý dĩ",53100,54180,1080,2
TIKI,lam-dep-suc-khoe,7255881,"Thực phẩm chức năng Tảo xoắn Spirulina nội địa Nhật Bản 2200 viên",354000,453600,99600,22
TIKI,lam-dep-suc-khoe,191995136," Tinh dầu treo xe thiên nhiên HOMER / Bạc Hà/ Quế/ Oải hương/ Bưởi/ Cam/ Hoa Lài/ Quýt/ Tràm Huế/ Hoa Hồng/ Lavender/ Ngọc Lan Tây/ Tràm Trà/ Sả Java/ Trà Xanh/ Cà Phê/ Chanh/ Trà xanh/ Trà trắng",39000,39000,0,0
TIKI,lam-dep-suc-khoe,21482823,"Lược thưa chải tóc xoăn - Giao hàng màu ngẫu nhiên",1000,20000,19000,95
TIKI,lam-dep-suc-khoe,151519665,"Bao cao su cao cấp OZO Feelex Invisible Cool - Hộp 10 bcs",89000,89000,0,0
TIKI,lam-dep-suc-khoe,15134851,"Sáp vuốt tóc Apestomen Volcanic Clay",240000,240000,0,0
TIKI,lam-dep-suc-khoe,7727580,"Mặt nạ giấy hàn quốc tinh chất lô hội trắng da DABO HÀN QUỐC ( 22ml/ miếng)",8900,8900,0,0
TIKI,lam-dep-suc-khoe,152097293,"Bông tẩy trang ipek thổ nhĩ kì 150 miếng ( 120+30 miếng)",43500,43500,0,0
TIKI,lam-dep-suc-khoe,186288869,"Bộ đai chườm nóng thảo dược giảm đau đầu gối dùng điện - Hapaku",945000,1200000,255000,21
TIKI,lam-dep-suc-khoe,35526564,"Sữa Rửa Mặt Neutrogena Ngừa Mụn Đầu Đen 100ml",95000,125000,30000,24
TIKI,lam-dep-suc-khoe,77094737,"Viên Uống Thơm Miệng Breath Pearls",230000,230000,0,0
TIKI,lam-dep-suc-khoe,149460253,"Tinh Dầu Oải Hương Homer 100ML - Tinh Dầu Lavender Thiên Nhiên Nhập Khẩu Nguyên Chất Giúp Giảm Stress, Khử Khuẩn và Xua Đuổi Côn Trùng, Sử Dụng Hiệu Quả với Máy Xông Tinh Dầu",85000,85000,0,0
TIKI,lam-dep-suc-khoe,57649867,"Sữa Dưỡng Thể 350Ml Vaseline Dưỡng Ẩm Sáng Da Fresh & Bright 10X Niacinamide Giúp Da Sáng Khỏe Mịn Căng Tinh Chất Menthol Mát Lạnh Như Tuyết Tan Trên Da",109000,150000,41000,27
TIKI,lam-dep-suc-khoe,25108019,"Gel chấm mụn đầu trắng và đầu đen Acnes Sealing Jell 18g",66000,69000,3000,4
TIKI,lam-dep-suc-khoe,435317,"Máy Đo Huyết Áp Bắp Tay Omron - HEM-8712 - 100610698",795000,920000,125000,14
TIKI,lam-dep-suc-khoe,166595471,"Set Dưỡng Trắng Da Ốc Sên Cấp Ẩm Se Khít Lỗ Chân Lông Và Chống Lão Hóa Dewytree Ultra Vitalizing Snail 20ml",76500,90000,13500,15
TIKI,lam-dep-suc-khoe,47149569,"Gel Vệ Sinh Phụ Nữ Giảm Viêm Ngứa X2 Nano Nghệ Cocayhoala 150ml",199000,330000,131000,40
TIKI,lam-dep-suc-khoe,119068215,"Cân sức khỏe Cân gia đình Camry BR202007A cao cấp hoạt động cơ học, trọng tải tối đa 130kg ( bước nhảy +-1kg ) - Hàng nhập khẩu",175000,175000,0,0
TIKI,lam-dep-suc-khoe,72109547,"Gel ngừa mụn viêm thâm đầu đen  Decumar Advanced 20 gr hoàn toàn mới",77000,77000,0,0
TIKI,lam-dep-suc-khoe,191514845," Máy Rửa Mặt Mini Cầm Tay Crénot Nia P5 Chính Hãng, Sử Dụng Sóng Âm Và Silicone Siêu Mềm Sạch Sâu Bụi Bẩn Trang Điểm Ngừa Mụn - Máy Rửa Mặt Massage Mát xa Matxa Tốt Chăm Sóc Da Dầu Mụn Nhạy Cảm Cho Nam Nữ",580000,1160000,580000,50
TIKI,lam-dep-suc-khoe,195972836,"Máy Triệt Lông Vĩnh Viễn Băng Lạnh Trẻ Hóa Da Mini Cầm Tay Tại Nhà Crénot Graci X3 Dành Cho Nách Vùng Bikini Mặt Chân Toàn Thân Cá Nhân Giảm Mụn IPL Hair Removal Ice Cooling Compress",2090000,2190000,100000,5
TIKI,lam-dep-suc-khoe,115660001,"( CHÍNH HÃNG LÀN DA ĐẸP) Megaduo Gel New - Gel Giảm Mụn Và Thâm Mụn",125000,125000,0,0
TIKI,lam-dep-suc-khoe,197922834,"Tinh dầu Cà Phê Homer 100ml - Tinh Dầu Xông Thơm Phòng, Thư Giãn, Khử Mùi - Tinh dầu Sả Chanh/ Vỏ Quế/ Cam Ngọt/ Oải hương/ Ngọc Lan Tây/ Tràm Trà/ Bưởi Ngọt",65000,65000,0,0
TIKI,lam-dep-suc-khoe,6430923,"Lăn khử mùi chiết xuất thiên nhiên Refre Natural Green Tea Hương Trà Xanh 40ml",59000,65000,6000,9
TIKI,lam-dep-suc-khoe,81304013," Đai Chống Gù Lưng Rung Nhật Bản, dành cho trẻ em, học sinh, trẻ nhỏ",190000,350000,160000,46
TIKI,lam-dep-suc-khoe,43163776,"Nước hoa nam cao cấp chính hãng Jile Guilty 50ml với hương thơm mạnh mẽ, nam tính, lịch lãm, quý phái.",470000,470000,0,0
TIKI,lam-dep-suc-khoe,72555195,"50 que thử tiểu đường On call plus của hãng ACON/Mỹ, dùng cho máy On call plus và On call EZii",141000,250000,109000,44
TIKI,lam-dep-suc-khoe,75997194,"Máy Xông Tinh Dầu 2200ML Cho Phòng Rộng + Tinh Dầu Sả Chanh TIDAMO - Máy Khuếch Tán Tinh Dầu Thể Tích Lớn Nhất, Chuyên Dụng Xông Tinh Dầu, Phun Sương Tạo Ẩm Cho Không Gian Lớn",388000,776000,388000,50
TIKI,lam-dep-suc-khoe,106074482,"Viên uống Vitamin C DHC Nhật Bản giúp sáng da mờ thâm thực phẩm chức năng giúp tăng cường sức đề kháng JN-DHC-C",85000,90720,5720,6
TIKI,lam-dep-suc-khoe,126945370,"Bao Cao Su LifeStyles ZERO Cao Cấp Siêu Mỏng Tuyệt Đối, Dẻo Dai  - Hộp 12 bao",179000,215000,36000,17
TIKI,lam-dep-suc-khoe,195937695,"Máy Massage Mắt Cầm Tay Mini Nhiệt Rung Crenot Erie V2 Mát Xa Giảm Thâm Bọng Nhức Mỏi Mờ Nếp Nhăn",725000,1420000,695000,49
TIKI,lam-dep-suc-khoe,76178104,"Bàn chải đánh răng điện Colgate Minions dành cho trẻ em",274000,294000,20000,7
TIKI,lam-dep-suc-khoe,76169589,"[HỘP - FAMAPRO VN95] - Khẩu trang y tế kháng khuẩn 4 lớp Famapro VN95 đạt chuẩn N95 (10 cái/ hộp) - COMBO 5 HỘP",57000,85000,28000,33
TIKI,lam-dep-suc-khoe,631403,"Nước Súc Miệng Làm Trắng Răng Listerine Healthy Bright (750ml) - 8850007813385",135000,173000,38000,22
TIKI,lam-dep-suc-khoe,76166201,"[HỘP - FAMAPRO MAX] - Khẩu trang y tế kháng khuẩn 4 lớp Famapro Max (40 cái/ hộp) - COMBO 5 HỘP",129000,129000,0,0
TIKI,lam-dep-suc-khoe,197378660,"Phấn Nước Che Khuyết Điểm Nâng Tone Kiềm Dầu Chống Nắng Dưỡng Da Dewytree Urban Shade Cover & Fit Sun Cushion SPF50+ PA++++(14g)",468000,520000,52000,10
TIKI,lam-dep-suc-khoe,44878245,"Cho máy Braun Oral-B, Bộ 4 đầu bàn chải đánh răng điện - Đánh tan mảng bám- SB-17A",165000,165000,0,0
TIKI,lam-dep-suc-khoe,2609469,"Nước Tẩy Trang Làm Sạch Sâu Cho Da Nhạy Cảm La Roche-Posay Micellar Water Ultra Sensitive Skin 400ml",393000,525000,132000,25
TIKI,lam-dep-suc-khoe,108830964,"Bộ 3 Kem đánh răng P/S Than Hoạt Tính 230g",114000,135000,21000,16
TIKI,lam-dep-suc-khoe,134592241,"Lăn khử mùi dành cho nữ Aquaselin 50ml (loại mạnh)",290000,290000,0,0
TIKI,do-choi-me-be,114465568,"Nước Tắm Tinh Dầu Bảo Linh Dành Cho Trẻ Em 70ml",120000,165000,45000,27
TIKI,do-choi-me-be,5865883,"Nước thơm lau sàn nhà Hando 1L hương nhài",25000,25000,0,0
TIKI,do-choi-me-be,94392344,"Cây Xương Rồng Khiêu Vũ Nhảy Múa Phát Ra Âm Thanh Vui Nhộn - Xương rồng nhại tiếng",79000,79000,0,0
TIKI,do-choi-me-be,13288021,"Set 100 dây buộc tóc dễ thương cho bé (Giao mẫu ngẫu nhiên)",29000,29000,0,0
TIKI,do-choi-me-be,57751883,"Combo 3 Xịt da chống muỗi PlasmaKare chống muỗi 24/7",380000,380000,0,0
TIKI,do-choi-me-be,120761658,"Bộ quần áo bé trai cộc tay BIGFOX - MISS MEOW size đại mùa hè vải cotton phong cách Âu Mỹ in cá sấu  LATER ALIGATOR size trẻ em 3-11 tuổi 10 - 38 kg QATE",159000,200000,41000,21
TIKI,do-choi-me-be,35266659,"Combo 2 Áo Lót Mẹ Bầu Và Cho Con Bú Thông Hơi Cao Cấp (Giao Mầu Ngẫu Nhiên)",75000,75000,0,0
TIKI,do-choi-me-be,196048058,"Hộp 300 sợi chun buộc tóc nhiều màu siêu dễ thương cho bé",45000,60000,15000,25
TIKI,do-choi-me-be,72693442,"02 bộ tranh xếp hình 70 mảnh ghép khổ A3 – đồ chơi trí tuệ cho bé từ 3 tuổi – Combo 10",55000,75000,20000,27
TIKI,do-choi-me-be,51117816,"Gối Em Bé KuKu KU2084",262990,289000,26010,9
TIKI,do-choi-me-be,149490983,"Dây mực in PLA cho bút vẽ 3D: 50m 5 cuộn 5 màu khác nhau",75000,75000,0,0
TIKI,do-choi-me-be,13943439,"Mũ gội đầu hà mã - Royalcare 
(Màu",75000,109000,34000,31
TIKI,do-choi-me-be,117296501,"Đồ chơi an toàn cho bé 100 quả bóng nhựa Việt Nam Chất lượng cao cho nhà bóng lều bóng quây bóng",92999,92999,0,0
TIKI,do-choi-me-be,195707718,"Bộ Cổ Bo Màu Tay Ngắn BN0014 - Xanh Rêu Nhạt - Size 4 (12-13) kgs",129000,129000,0,0
TIKI,do-choi-me-be,805618,"Cháo Ăn Dặm  Mabu Nguyên Hạt (900g)",199000,199000,0,0
TIKI,do-choi-me-be,103514028,"04 bộ tranh xếp hình 35 mảnh khổ A4 20x30cm – đồ chơi trí tuệ cho bé từ 2 tuổi – Combo 1",75000,100000,25000,25
TIKI,do-choi-me-be,107792123,"Đồ bộ quần áo cộc tay cho bé hoạt tiết động vật QATE636 cho bé 8kg - 18kg",66000,66000,0,0
TIKI,do-choi-me-be,127190390,"SÉT 4 ÁO LÓT LÁ HỌC SINH XUẤT HÀN COTTON  cho bé gái từ 20-50kg",175000,175000,0,0
TIKI,do-choi-me-be,20547120,"Dây Bọc Cạnh Bàn Chống Va Chạm Cho Bé",46022,46022,0,0
TIKI,do-choi-me-be,150868398,"Quần thun thể dục 3 sọc Amazing, lưng thun, dây rút, vải cotton co giãn, hút mồ hôi, đủ size từ 20-100kg, Unisex",71000,114000,43000,38
TIKI,do-choi-me-be,161540109,"Mũ nồi dạ màu trơn cho bé 4-12y Mimo baby MN62",189000,189000,0,0
TIKI,do-choi-me-be,55498362,"Combo 10 Quần bỏ bỉm vải cotton 6 lớp siêu thấm, thoáng mát hiệu Goodmama cho Bé Gái từ 5-17 kg",370000,370000,0,0
TIKI,do-choi-me-be,13312863,"BÌNH SỮA Y TẾ CỔ THƯỜNG 250 ML DR.BROWN'S",386000,386000,0,0
TIKI,do-choi-me-be,123353396,"Gối Ôm Bà Bầu Chữ U Vải Nhung Mềm Mại (màu ngẫu nhiên)",250000,250000,0,0
TIKI,do-choi-me-be,52796364,"Đồ Chơi Rubik 4x4x4 Không Viền Sắc Màu",54000,57000,3000,5
TIKI,do-choi-me-be,54014704,"Đồ Chơi Baby Rock Star Happy Baby - Organ Điện Tử",82500,110000,27500,25
TIKI,do-choi-me-be,53872113,"Ngũ Cốc Mẹ Bầu Pregnlife Long Liên Cao Cấp Siêu Dinh Dưỡng Gồm 14 Loại Hạt - Tặng Kèm Muỗng Gỗ ",256000,320000,64000,20
TIKI,do-choi-me-be,196312554,"Máy hâm nóng sữa đôi điện tử Yoboo YB-0042 có 6 chức năng, điều khiển cảm ứng, hẹn giờ trước - Hàng chính hãng",559000,559000,0,0
TIKI,do-choi-me-be,128783539,"Thảm nằm 2 mặt cao cấp XPE loại 1 (hình ngẫu nhiên) đủ kích thước - 1m6 x 2m - Hàng Chất Lượng",139000,139000,0,0
TIKI,do-choi-me-be,37295439,"Bộ mài dũa móng tay 6  đầu dũa đa năng dành cho bé",87299,87299,0,0
TIKI,do-choi-me-be,193891171,"Balo tiểu học- Siêu nhân",176000,280000,104000,37
TIKI,do-choi-me-be,96924122,"BỊCH KHĂN VẢI KHÔ ĐA NĂNG 500GR - AIKO (HÀNG VIỆT NAM CHẤT LƯỢNG CAO)",60000,60000,0,0
TIKI,do-choi-me-be,29830344,"Gấu bông pokemon Rồng Dragonair",100000,100000,0,0
TIKI,do-choi-me-be,47422932,"Lắp ráp đồng hồ biến hình Robot",77000,77000,0,0
TIKI,do-choi-me-be,51597263,"Gối Ôm Chữ U Đa Năng cho Bà Bầu - Gối Ngủ cho Mẹ Bầu chính hãng Zcare - chứng nhận Độc Quyền bởi bộ Khoa học công nghệ; Gối bà bầu có hình chữ U nâng đỡ 6 điểm, giúp bà bầu thoải mái khi ngủ; Gối chuyên dụng cho bà bầu nên các nguyên vật liệu an toàn và c",619000,619000,0,0
TIKI,do-choi-me-be,58392954,"Combo 20 cuộn Giấy vệ sinh ALPHA, 2 Lớp, 60g/cuộn",74000,74000,0,0
TIKI,do-choi-me-be,72913355,"Bộ tranh xếp hình jigsaw puzzle cao cấp 330 mảnh – Trà Chiều",78000,100000,22000,22
TIKI,do-choi-me-be,102123817,"Quần lót bầu cạp chéo Azuno Chất Liệu Đũi Xước Thoáng Khí, Kháng Khuẩn Cho Mẹ",45000,55000,10000,18
TIKI,do-choi-me-be,191654241,"Nước giặt xả Hiclass 3500ml - Hàng Thái Lan",199000,199000,0,0
TIKI,do-choi-me-be,16555626,"Ngựa bập bênh kiêm xe chòi chân cho bé (có nhạc + bánh xe + đệm lót)",194000,194000,0,0
TIKI,dien-gia-dung,107982425,"Nồi Cơm Điện Tử Cảm Ứng Nagakawa NAG0136 Trắng đen - Giảm tinh bột - Lòng niêu chống dính - 11 chức năng (1.2L - 500W) - Hàng Chính Hãng",1310000,1860000,550000,30
TIKI,dien-gia-dung,107137543,"Bếp Từ Đơn Elmich ICE-1828OL (2100W) - Hàng Chính Hãng",982000,1790000,808000,45
TIKI,dien-gia-dung,162175137,"Ấm sắc thuốc bắc bằng điện tự động Xuân Tùng 2 chế độ nấu-hàng chính hãng",219000,219000,0,0
TIKI,dien-gia-dung,175161661,"Bình đun nước siêu tốc kiêm giữ nhiệt Deerma DR035S trang bị màn hình thị nhiệt độ nước - Hàng chính hãng",549000,790000,241000,31
TIKI,dien-gia-dung,168925162,"Bàn ủi hơi nước cầm tay Deerma DEM-HS100 - Hàng Nhập Khẩu",439000,690000,251000,36
TIKI,dien-gia-dung,62248218,"Máy Xay Đa Năng Japan New - Xay Thịt - Xay Đá - Hoa Quả - Xay Sinh Tố",103900,103900,0,0
TIKI,dien-gia-dung,36676655,"Máy cạo râu Xiaomi Enchen BlackStone  3 đầu cắt với lưỡi dao đôi - Hàng nhập khẩu",189000,215000,26000,12
TIKI,dien-gia-dung,73369303,"Quạt Hút Thông Gió Âm Trần WHIFA VDB-15CK (N) 5 Inch Màu Trắng - Hàng Nhập Khẩu",609000,609000,0,0
TIKI,dien-gia-dung,143116407,"Máy phun sương xông tinh dầu tạo ẩm Rhino H901 dung tích 420ml, nhỏ gọn, không gây tiếng ồn, tích hợp đèn ngủ RGB nhiều màu, có chế độ tự ngắt - Hàng chính hãng",97000,129000,32000,25
TIKI,dien-gia-dung,274165500,"Máy Lọc Không Khí Xiaomi Mi Air Purifier 4 Kết Nối App Điên Thoại Phù Hợp Không Gian 50 m2 - Hàng Chính Hãng",3859000,7269000,3410000,47
TIKI,dien-gia-dung,117141967,"Máy cạo râu Yandou 301 Sc-W301U, Và loại yandou màu vàng Sc-W316U Cạo khô không đau rát,pin sạc tiện lợi",18000,18000,0,0
TIKI,dien-gia-dung,158595860,"Đầu Lọc Nước Tại Vòi Nhỏ Gọn Cấp Nước Sạch Và An Toàn Cho Gia Đình KONKA - Hàng Nhập Khẩu",269000,435000,166000,38
TIKI,dien-gia-dung,126260026,"Tông Đơ Cắt Tóc Chấn Viền Cao cấp Salon và Gia Đình TH-8002",84000,84000,0,0
TIKI,dien-gia-dung,171470149,"Máy Cạo Râu Tiện Dụng Kemei 2026,Dao Cạo Râu Tích Hợp Pin 1400 mAh Công Suất 5W, Đèn Led Hiện Dung Lượng Pin, Lưỡi Cắt Titatium, Động Cơ Hạn Chế Tiếng Ồn - HÀNG CHÍNH HÃNG",321000,682000,361000,53
TIKI,dien-gia-dung,34281542,"Quạt Đứng Toshiba F-LSA10(K)VN (50W) - Hàng Chính Hãng",893000,1050000,157000,15
TIKI,dien-gia-dung,11477863,"Quạt treo 2 dây Senko ( Hàng Chính Hãng ) TC1626",320000,320000,0,0
TIKI,dien-gia-dung,106303361,"Máy lọc không khí mini chính hãng Airko WP-AU12L / sản phẩm thiết yếu cho ô tô, văn phòng",699000,1900000,1201000,63
TIKI,dien-gia-dung,37535371,"Lò Vi Sóng Sharp R-209VN-SK (20 lít) - Hàng Chính Hãng",1340000,1560000,220000,14
TIKI,dien-gia-dung,2174695,"Nồi chưng cất yến Homepro HP-7M 700ml - Hàng chính hãng",529000,529000,0,0
TIKI,dien-gia-dung,87890602,"Bếp điện từ Xiaomi Mijia DCL002CM Youth Version 2 - Hàng Nhập Khẩu",815000,815000,0,0
TIKI,dien-gia-dung,72299914,"Máy Vắt Cam Lock&Lock EJJ236 (700ml) - Hàng chính hãng",233000,400000,167000,42
TIKI,dien-gia-dung,113932107,"Máy Ép Chậm Olivo SJ210 [CHÍNH HÃNG] Làm Kem, Ép Rau Củ Quả, Ép Đậu Nành 3 Trong 1, Ép Kiệt Bã 99% Thiết Kế Đột Phá, Dễ Dàng Vệ Sinh",2680000,2680000,0,0
TIKI,dien-gia-dung,107087960,"Ấm Đun Siêu Tốc Lock&Lock 2 Lớp Ruột Bình Bằng Thép Không Gỉ EJK738 (1.7L) - Hàng Chính Hãng, Bảo Hành 12 Tháng- Tặng Kèm Cọ Rửa Và Ống Hút",459000,837000,378000,45
TIKI,dien-gia-dung,126515191,"Máy May Mini Cầm Tay - GDHN Loại Tốt",89999,89999,0,0
TIKI,dien-gia-dung,181667508,"Quạt đứng Midea SAD35EZ màu cà phê Phiên bản mới 2022 của quạt cây Midea SAD35EA 3 Mức gió tự tăng giảm theo nhiệt độ phòng Có điều khiển từ xa Hàng Chính Hãng",1665000,1740000,75000,4
TIKI,dien-gia-dung,114773096,"Cao su non, băng tan, keo lụa cuốn ren ống nước, cuốn ren co nối, tê máy lọc nước (Cuộn 10 mét) - Hàng chính hãng",15000,15000,0,0
TIKI,dien-gia-dung,60710348,"Siêu sắc thuốc điện tự động ngắt Fujika K7, cống suất 450W, dung tích 3L, tự động ngắt-hàng chính hãng",224000,224000,0,0
TIKI,dien-gia-dung,253328282,"Nồi Kho Thịt, Nồi Chưng Yến, Nồi Nấu Chậm BEAR SUBE003 - Bản Tiếng Việt Kèm Khay Hấp Và 5 Thố Dung Tích 2.5 Lít Công Suất 380 W- Hàng Chính Hãng",1239000,2279000,1040000,46
TIKI,dien-gia-dung,43818387,"Bếp Từ Dương Đôi Teka DS3502-P (3500W) - Hàng Chính Hãng",2490000,4899273,2409273,49
TIKI,dien-gia-dung,185717517,"Nồi áp suất điện đa năng Tefal 6 lít CY601868 - Hàng Chính Hãng",1880000,2980000,1100000,37
TIKI,dien-gia-dung,403455,"Kẹp Nướng Sandwich Tiross TS514 (750W) - Hàng Chính Hãng",524000,590000,66000,11
TIKI,dien-gia-dung,191925968,"Dây cấp và dây thải máy lọc nước Nano Geyser, Dây phi 10 và phi 6, Giá 1 mét - Hàng Chính Hãng",7000,12000,5000,42
TIKI,dien-gia-dung,48269559,"Tông Đơ Cắt Tóc Cho Bé, Trẻ Em Codol 531 TẶNG Bộ Kéo Cắt Tóc + Áo Choàng Cắt Tóc + Lược Cắt Tóc (Dày-Thưa) - Tăng Đơ Hớt Tóc Gia Đình Cho Người Lớn Và Bé Sơ Sinh Máy Chạy Êm Lưỡi Có Thể Thay",299000,299000,0,0
TIKI,lam-dep-suc-khoe,3282871,"Gel rửa mặt tạo bọt làm sạch & giảm nhờn cho da dầu nhạy cảm La Roche-Posay Effaclar Purifying Foaming Gel (400ml)",324000,650000,326000,50
TIKI,dien-gia-dung,58057114,"Máy xay sinh tố Philips HR2223/00 - Hàng Chính Hãng",1370000,1950000,580000,30
TIKI,lam-dep-suc-khoe,544425,"Cân Sức Khỏe 120kg Nhơn Hòa (Nhiều màu) - Giao màu ngẫu nhiên - Hàng Chính Hãng",378000,378000,0,0
TIKI,dien-gia-dung,82605269,"Khay Silicone Dành Cho Nồi Chiên Không Dầu Và Lò Vi Sóng Lock&amp;Lock CKB002BLU - Màu",200000,405000,205000,51
TIKI,lam-dep-suc-khoe,37869185,"Máy massage xung điện - bộ 4 miếng dán",85998,85998,0,0
TIKI,lam-dep-suc-khoe,14423711,"Tấm thảo dược thay thế của đai chườm lưng cắm điện - Hapaku",128000,160000,32000,20
TIKI,dien-gia-dung,192074791,"Nồi hấp điện Dung tích 15 Lít, công xuất 800W, thiết kế sang trọng hiện đại",430993,430993,0,0
TIKI,lam-dep-suc-khoe,147043572,"Xịt Thơm Miệng Befresh Cho Hơi Thở Thơm Mát Chỉ Trong 3 Giây Dung Tích 10ml",49000,75900,26900,35
TIKI,lam-dep-suc-khoe,112728673,"Bọt vệ sinh nam giới Oniiz 100ml",120000,120000,0,0
TIKI,dien-gia-dung,692114,"Nồi Lẩu Điện Lock&Lock EJP331BLK (5 lít) - Hàng chính hãng",709000,1400000,691000,49
TIKI,lam-dep-suc-khoe,192831802,"Tinh dầu nguyên chất Bạc Hà 24Care/ Sả chanh/ Quế/ Oải hương/ Bưởi/ Cam/ Hoa Lài/ Quýt/ Tràm Huế/ Hoa Hồng/ Lavender/ Ngọc Lan Tây/ Tràm Trà/ Sả Java/ Trà Xanh/ Gỗ Hồng/ Hoa Anh Đào",345000,345000,0,0
TIKI,lam-dep-suc-khoe,129868878,"Combo Dầu Gội X-Men Nước hoa Wood 650G và Sữa Tắm X-Men Nước hoa Wood 650G",382000,382000,0,0
TIKI,dien-gia-dung,73281375,"Máy phun sương tạo độ ẩm không khí Deerma DEM-F628 Hàng Chính Hãng",439000,599000,160000,27
TIKI,lam-dep-suc-khoe,173224731,"Máy phun sương mini tạo ẩm CWELL, tích hợp đèn LED đèn ngủ nhiều màu, 3 chế độ phun sương mịn,  dung tích cực lớn 2L",219000,299000,80000,27
TIKI,lam-dep-suc-khoe,108535259,"Bao cao su Sagami Exceed 2000 - Thiết kế 3D - Một lần thắt - Hộp 12 chiếc",120000,120000,0,0
TIKI,lam-dep-suc-khoe,631049,"Dung dịch dưỡng ẩm tối ưu Hada Labo Advanced Nourish Lotion dùng cho da dầu 170ml",168000,208000,40000,19
TIKI,lam-dep-suc-khoe,1362445,"Sữa Rửa Mặt Cetaphil Gentle Skin Cleanser (125ml)",137000,140000,3000,2
TIKI,lam-dep-suc-khoe,12082922,"Tinh chất hàu Oyster Plus Goodhealth 30v",309000,309000,0,0
TIKI,lam-dep-suc-khoe,116148009,"Dụng Cụ Lấy Ráy Tai, Bộ Ngoáy Tai 6 Chiếc KUNBE, Chất Liệu Inox Cao Cấp Giúp Vệ Sinh Tai An Toàn, Chuyên Nghiệp",29000,32000,3000,9
TIKI,dien-gia-dung,271046144,"Bếp gas âm Fujipan FJ-8910V, Đánh lửa IC, Chén đồng nguyên khối - Hàng chính hãng",915000,915000,0,0
TIKI,lam-dep-suc-khoe,96620654,"GINKO 5 HOẠT HUYẾT NĂM CÁNH SEN Giúp Tăng Cường Tuần Hoàn Máu Não, Giảm Nguy Cơ Hình Thành Cục Máu Đông, Mệt Mỏi, Đau Đầu, Mất Ngủ, Hoa Mắt, Chóng Mặt, Nhức Mỏi Vai Gáy",180000,180000,0,0
TIKI,lam-dep-suc-khoe,107985508,"Bộ ba Tsubaki Premium Phục hồi ngăn rụng tóc & Bảo Vệ Tóc Trước Tác Hại Của Tia UV (Gội Xả 490ml/chai + Dầu dưỡng tóc 50ml)",687000,687000,0,0
TIKI,lam-dep-suc-khoe,35526560,"Nước Rửa Mặt Neutrogena Dịu Nhẹ 100ml",75000,100000,25000,25
TIKI,lam-dep-suc-khoe,247286696,"Dầu Gội Dược Liệu Thái Dương 3 (500ml, Hương Hoa Đào)",115000,115000,0,0
TIKI,lam-dep-suc-khoe,179717787,"Toner giảm mụn dịu da Acnes Blemish Control Toner 100ml",77000,85000,8000,9
TIKI,lam-dep-suc-khoe,176756454,"Cân Điện Tử Sức Khoẻ Thông Minh Mặt Vuông Kính Cường Lực Chịu Lực 180Kg Deli - Phù Hợp Gia Đình Trường Học -  Nhiều Màu Sắc - Hàng Chính Hãng - E86120",159000,322200,163200,51
TIKI,lam-dep-suc-khoe,48579668,"Bao cao su Sagami Original 0.02 cao cấp, siêu mỏng (Hộp 12 chiếc)",500000,500000,0,0
TIKI,lam-dep-suc-khoe,105621214,"Bộ Bao Cao Su Durex Kingtex 3 Hộp 12 Bao",357000,588000,231000,39
TIKI,lam-dep-suc-khoe,470430,"Kem Dưỡng Giảm Mụn, Ngừa Thâm, Thông Thoáng Lỗ Chân Lông La Roche-Posay Effaclar Duo+ 40ml",360000,480000,120000,25
TIKI,lam-dep-suc-khoe,35226725,"Tinh chất ngừa mụn thâm The Ordinary Niacinamide 10% + Zinc 1",228000,265000,37000,14
TIKI,lam-dep-suc-khoe,106541128,"Tinh chất dưỡng tóc KOKO Cocayhoala - Ngăn rụng tóc - Kích thích mọc tóc - Giúp tóc mềm mượt - 100ml",209000,209000,0,0
TIKI,lam-dep-suc-khoe,13416097,"Nhuộm Tóc Dược Liệu Thái Dương (5 Gói)",90000,120000,30000,25
TIKI,dien-gia-dung,530774,"Bếp Hồng Ngoại Sunhouse SHD6011 (2000W) - Đen- hàng chính hãng",522958,522958,0,0
TIKI,lam-dep-suc-khoe,50618604,"Bao cao su Okamoto 0.01 Hydro Polyurethane (PU). Bao cao su Nhật Bản siêu mỏng chỉ 0.01mm bằng 1/6 độ dày sợi tóc, cho cảm nhận truyền nhiệt nhanh (Hộp 4 Cái) ",149000,149000,0,0
TIKI,lam-dep-suc-khoe,144228451,"Khẩu Trang 4D Kiếu Dáng Hàn Quốc KF94 (10 Cái / Túi), kháng Khuẩn, Chống Bụi, Màu Trắng - Đạt Các Chứng Chỉ ISO 13485, ISO 9001, CE, FDA, TGA.",15000,15000,0,0
TIKI,lam-dep-suc-khoe,74640666,"Dầu Gội Dược Liệu Thái Dương 7Plus (Chai 100ml)",75000,75000,0,0
TIKI,lam-dep-suc-khoe,247999867,"Gôm xịt tóc tạo kiểu siêu cứng, giữ nếp lâu Mugens Hair Spray Hàn Quốc 300ml + Móc khóa",145000,155000,10000,6
TIKI,lam-dep-suc-khoe,52280562,"Kem chống nắng nâng tông Skin Aqua Tone up Mint Green cho da trắng có khuyết điểm đỏ, dạng tinh chất Sunplay Skin Aqua Tone Up UV Essence Mint Green SPF 50+ PA++++ 50g",161000,199000,38000,19
TIKI,lam-dep-suc-khoe,34480145,"Combo 2 Hộp Miếng Dán Mụn Cóc Loại Bỏ Mụn Cóc Tại Nhà An Toàn Hiệu Quả - Hộp 6 miếng",110000,110000,0,0
TIKI,lam-dep-suc-khoe,55895699,"Bigsize - Kem tan mỡ bụng Truesky S Body Cream chiết xuất quế gừng an toàn và hiệu quả 200g",280000,280000,0,0
TIKI,lam-dep-suc-khoe,135029845,"Gel Rửa Mặt Dịu Nhẹ Làm Sạch Sâu Neutrogena Hydro Boost Cleanser Water Gel - Dung tích 145ml",265000,350000,85000,24
TIKI,lam-dep-suc-khoe,3179511,"Sữa Tắm White Conc Body Nhật Bản Dưỡng Da Trắng Hồng, 360ml",179000,233100,54100,23
TIKI,lam-dep-suc-khoe,58916736,"Lăn Khử Mùi ETIAXIL Détranspirant Traitement Aisselles Peaux Sensibles 15ml (Dành Cho Da Nhạy Cảm) + Quà Tặng",320000,320000,0,0
TIKI,lam-dep-suc-khoe,14694900,"Xà Phòng Cải Thiện Thâm Mông Pelican Hip Care Soap nội địa Nhật",113000,115920,2920,3
TIKI,lam-dep-suc-khoe,55615437,"Tẩy Da Chết Tế Bào Gốc Thực Vật Làm Sạch Sâu Dịu Nhẹ Dưỡng Ẩm Trắng Da Chống Nhăn Cho Da Nhạy Cảm Cellkey-Scien White Peeling Gel (80ml)",297500,350000,52500,15
TIKI,lam-dep-suc-khoe,11956889,"Kem Nứt Gót Dưỡng Ẩm, Giảm Đau, Làm Lành Nhanh Vùng Nứt Gót Chân Oriss - Dưỡng Ẩm Vượt Trội Suốt 24h - tuýp 30g ",45000,57000,12000,21
TIKI,lam-dep-suc-khoe,170402456,"Combo 10 Gói Khẩu trang Bông Bạch Tuyết KF94 4 lớp trắng (10 cái/gói)",200000,200000,0,0
TIKI,thiet-bi-kts-phu-kien-so,198126604,"Miếng Lót Chuột Cỡ Lớn, Pad Chuột Cỡ Lớn Bằng Da Cao Cấp 40cmx80cm, Tấm Lót Chuột Thảm Da Trang Trí Bàn Làm Việc VinBuy - Hàng Chính Hãng",116000,180000,64000,36
TIKI,thiet-bi-kts-phu-kien-so,58618226,"Đầu Chuyển 2 Chấu Sạc iPad, MacBook HR",39900,39900,0,0
TIKI,thiet-bi-kts-phu-kien-so,12516512,"Ốp lưng silicon chống sốc cho iPhone XS MAX hiệu Likgus Crashproof giúp chống chịu mọi va đập  - Hàng chính hãng",79998,79998,0,0
TIKI,thiet-bi-kts-phu-kien-so,179930667," Giá đỡ màn hình Human Motion T9-1H Xám - Hàng Chính Hãng",1750000,1750000,0,0
TIKI,thiet-bi-kts-phu-kien-so,141924087,"Đầu Ngòi thay thế cho bút Kai dành cho Apple Pencil 1/ Pencil 2 - Nhiều Mẫu Đầu Ngòi 2.0 3.0 3.5_ Hàng Chính Hãng",56000,60000,4000,7
TIKI,thiet-bi-kts-phu-kien-so,177992767,"Bao Da Samsung Galaxy Tab S7 Fe Kèm Bàn Phím Có Bàn Di Chuột TouchPad Hiệu Dux Ducis-Hàng Chính Hãng",1150000,1150000,0,0
TIKI,thiet-bi-kts-phu-kien-so,188308313,"Case Ốp Bảo Vệ Hình Heo Fitting Cho Airpods 1/2/ Airpods Pro/ Airpod 3- Hàng chính hãng",75050,79000,3950,5
TIKI,thiet-bi-kts-phu-kien-so,42477176,"Ốp lưng dành cho Samsung Galaxy A70 mẫu Tai nghe",49000,80000,31000,39
TIKI,thiet-bi-kts-phu-kien-so,14690977,"Tai nghe S1 HiFi lõi kép siêu bass",25000,50000,25000,50
TIKI,thiet-bi-kts-phu-kien-so,10691668,"Loa Bosston Bluetooth 2.1 T3500-BT - Hàng chính hãng",339000,339000,0,0
TIKI,thiet-bi-kts-phu-kien-so,135807323,"Bộ Bàn Phím Và Chuột Không Dây Hibow Colourlock - Hàng chính hãng",280000,280000,0,0
TIKI,thiet-bi-kts-phu-kien-so,108464527,"Đế sạc không dây Mophie 2in1 Stand Plus - Hàng chính hãng",1900000,1900000,0,0
TIKI,thiet-bi-kts-phu-kien-so,55850146,"Giá đỡ nhôm nguyên khối hai khe kẹp dựng đứng dành cho Laptop Macbook Ipad Surface",332500,350000,17500,5
TIKI,thiet-bi-kts-phu-kien-so,26166346,"Dây Cáp Dài 2m Chuyển Đổi USB 2.0 Ra Mini USB",30000,30000,0,0
TIKI,thiet-bi-kts-phu-kien-so,138182934,"Miếng Lót phím Đen Silicone bảo vệ bàn phím dành cho Macbook chống bụi bẩn, chống nước",99000,99000,0,0
TIKI,thiet-bi-kts-phu-kien-so,10179466,"Cáp chuyển đổi type C sang jack 3.5 Baseus Cable Yiven Type-C male To 3.5 male Audio Cable M01",110000,119000,9000,8
TIKI,thiet-bi-kts-phu-kien-so,192706063,"Ốp chống sốc dành cho iPhone 11, 11 Pro, 11 Pro Max silicon trong suốt kèm ngăn ví đựng thẻ",15500,15500,0,0
TIKI,thiet-bi-kts-phu-kien-so,4601663,"Thẻ nhớ 8g full dung lượng",69000,69000,0,0
TIKI,thiet-bi-kts-phu-kien-so,142238866,"Tai Nghe Nhét Tai Có Dây Earldom E45 Jack 3.5mm Có Micro Đàm Thoại - Hàng chính hãng",35000,35000,0,0
TIKI,thiet-bi-kts-phu-kien-so,133878527,"Kính cường lực Nillkin CP+ PRO cho Xiaomi 11T - 11T Pro FULL viền đen - Hàng nhập khẩu",139000,139000,0,0
TIKI,thiet-bi-kts-phu-kien-so,199828,"Bàn phím không dây Logitech K400 Plus - có touchpad để kết nối PC đến TV, nút Media tùy chỉnh, phù hợp Laptop/ TV/ Tablets - Màu",648000,648000,0,0
TIKI,thiet-bi-kts-phu-kien-so,47280931,"Ốp lưng dẻo mỏng dành cho iPhone X / iPhone XS - Màu đen",37000,37000,0,0
TIKI,thiet-bi-kts-phu-kien-so,89209810,"USB Bluetooth 5.0 HJX 001 CHUYỂN LOA THƯỜNG THÀNH LOA BLUETOOTH loại 1",27400,27400,0,0
TIKI,thiet-bi-kts-phu-kien-so,127180726,"Ốp case cho macbook siêu sang - Hàng chính hãng - XANH THAN - Macbook Air 13.3 inch đời 2017 về trước",222000,222000,0,0
TIKI,thiet-bi-kts-phu-kien-so,159061767,"Ốp Lưng Chống Bẩn Tích Hợp Ring Holder Dành Cho IPhone 11 / 11Pro / 11Promax / 12 / 12Pro / 12 Promax / 12 Mini - Chân Đế Giá Đỡ Xoay 360 Độ, Kèm Dây Đeo Tay, Tương Thích Đế Sạc Không Dây",75000,75000,0,0
TIKI,thiet-bi-kts-phu-kien-so,43264527,"Bao da kèm bàn phím Logitech Slim Folio dành cho iPad Pro 11 | 12.9 inch (2018) - kết nối Bluetooth, pin 3 tháng/lần sạc - Hàng chính hãng",2590000,2590000,0,0
TIKI,thiet-bi-kts-phu-kien-so,91369253,"Combo 2 Kính xem phim 3D tivi phân cực",110500,110500,0,0
TIKI,thiet-bi-kts-phu-kien-so,43380656,"Ốp lưng da cao cấp dành cho iPhone 11 - Màu nâu",149000,199000,50000,25
TIKI,thiet-bi-kts-phu-kien-so,167433819,"Chuột không dây Logitech Signature M650L màu trắng- Hàng chính hãng",798000,798000,0,0
TIKI,thiet-bi-kts-phu-kien-so,72215260,"Thanh Led RGB Crystal Aura Sync đồng bộ Hub + Sync với main 3Pin 5V cho máy tính",120000,120000,0,0
TIKI,thiet-bi-kts-phu-kien-so,103677742,"Micro Không dây Bluetooth Karaoke - Hàng Chính Hãng",1595000,3190000,1595000,50
TIKI,thiet-bi-kts-phu-kien-so,133138478,"Bàn phím cơ DAREU A87 Cherry Switch ( Childhood,summer,Dream,Swallow ) - Hàng chính hãng",1799000,1799000,0,0
TIKI,thiet-bi-kts-phu-kien-so,32291496,"ốp lưng cho iphone 11 chống sốc - chính hãng Xundd",98000,98000,0,0
TIKI,thiet-bi-kts-phu-kien-so,160919813,"Micro Thu Âm Cao Cấp CV Cắm cổng USB, Độ Nhậy Cao, Chống ồn, Livestream, Hát Karaoke, quay video, ghi âm, Vlog, Chơi game, Học Online trò chuyện qua Zoom, MSN, SKYPE Tương thích máy tính để bàn, Laptop, MAC OS- Hàng chính hãng",880000,880000,0,0
TIKI,thiet-bi-kts-phu-kien-so,134360930,"Ốp Lưng dành cho iPhone 13 Pro/13 Pro Max RINGKE Fusion Design - Hàng Chính Hãng",350000,350000,0,0
TIKI,thiet-bi-kts-phu-kien-so,73163677,"Giá Đỡ Laptop Máy Tính Bảng Điện Thoại 2 Trong 1 Hợp Kim Nhôm Chống Trơn Trượt, Trầy Xước Hàng Chính Hãng Tamayoko",440000,450000,10000,2
TIKI,thiet-bi-kts-phu-kien-so,76104803,"Ốp lưng chống sốc Gear4 D3O Rio Snap 4m hỗ trợ sạc Magsafe cho iPhone 12 mini/12/12 Pro/12 Pro Max",1200000,1200000,0,0
TIKI,thiet-bi-kts-phu-kien-so,2774881,"Sim 4G/5G Vinaphone 5GB/tháng trọn gói 1 năm miễn phí - Hàng chính hãng - Mẫu ngẫu nhiên",419000,419000,0,0
TIKI,thiet-bi-kts-phu-kien-so,104870906,"Loa treble kèn 350 kèm phễu và tụ",220000,220000,0,0
TIKI,thiet-bi-kts-phu-kien-so,76089893,"GIÁ ĐỠ LAPTOP ĐỂ BÀN GẤP GỌN CÓ TÚI ĐỰNG",21800,21800,0,0
TIKI,do-choi-me-be,116727410,"Sữa Hữu Cơ Miwako Nhập Khẩu Malaysia Hộp 700g Vị Gạo, Sữa Hạt Dinh Dưỡng Cho Bé Biếng Ăn Tiêu Hóa Kém Thấp Còi",507000,675000,168000,25
TIKI,do-choi-me-be,52664603,"GỐI ÔM BÀ BẦU CHỮ U Zcare - màu tím sang trọng",619000,619000,0,0
TIKI,do-choi-me-be,27655440,"Dung dịch làm sạch canxi vách kính tắm Smart - TK",200000,200000,0,0
TIKI,do-choi-me-be,77032298,"Bài Tây Poker Copag 100% Plastic Chính Hãng Siêu Bền",90000,90000,0,0
TIKI,lam-dep-suc-khoe,172303081,"Gel lột mụn hút sạch mụn cám, mụn đầu đen YOSHI 200gr",65000,65000,0,0
TIKI,do-choi-me-be,43388390,"Bộ đồ thú Khủng Long xanh liền thân lông mịn Pijama dành Cho Người Lớn và Trẻ Em Đầy Đủ Các Kích Cỡ kiểu dáng Động Vật Hoạt Hình Cosplay",189000,189000,0,0
TIKI,lam-dep-suc-khoe,1687621,"Kem chống muỗi Rohto Metholatum Remos Hương Cam 70g",23100,27000,3900,14
TIKI,do-choi-me-be,24495867,"Bột Thông Tắc Bồn Cầu, Thông Tắc Cống Sifa Đa Năng Siêu Nhanh 200g",27000,27000,0,0
TIKI,lam-dep-suc-khoe,134591513,"Lăn khử mùi dành cho nam Aquaselin 50ml",290000,290000,0,0
TIKI,do-choi-me-be,77052616,"Mũ cục bông cho bé hàng QC ( 0-12m) MD160",139000,139000,0,0
TIKI,lam-dep-suc-khoe,176790842,"Túi chườm nóng lạnh đa năng dung tích 500ml, túi chườm ấm bụng giảm đau bụng kinh nguyệt dành cho bạn nữ",89000,89000,0,0
TIKI,lam-dep-suc-khoe,76053234,"Combo 2 Sữa Tắm L'amont En Provence Cherry Blossom (Hoa Anh Đào) Shower Gel 1000ml",480000,480000,0,0
TIKI,do-choi-me-be,46132344,"Phao Bơi Chống Lật Đỡ Cổ Sắc Màu Siêu Cute Cho Bé Siêu An Toàn PB01",28000,28000,0,0
TIKI,lam-dep-suc-khoe,74973204,"Máy Rửa Mặt Mini Massage Tích Hợp Sóng Âm Giúp Làm Sạch Sâu Da, Nâng Cơ Mặt, Sáng Da, Trẻ Hóa Làn Da - Máy Rửa Mặt Chính hãng VinBuy",135000,300000,165000,55
TIKI,do-choi-me-be,2705073,"Vỉ 6 viên tẩy và làm thơm toilet siêu tiện lợi Hando",65000,65000,0,0
TIKI,lam-dep-suc-khoe,10072103,"Gel Hút Mụn Đầu Đen Than Hoạt Tính - OHIO ỐC SÊN NEW DAY",32000,32000,0,0
TIKI,do-choi-me-be,142212910,"Lều xông hơi tự bung chui đầu tại nhà chống thấm nước ( giao màu ngẫu nhiên)",198000,198000,0,0
TIKI,lam-dep-suc-khoe,84875620,"Tinh Dầu Hoa Nhài 30ML Nguyên Chất, Nhập Khẩu - Tinh Dầu Hoa Lài TIDAMO (Jasmine) Có Kiểm Nghiệm, Hương Thơm Dịu Nhẹ Quý Phái - Xông Thơm Phòng, Thư Giãn và Tốt Cho Sức Khỏe",74800,176000,101200,58
TIKI,lam-dep-suc-khoe,56218973,"Bộ 5 kem đánh răng Colgate ngừa sâu răng răng chắc khỏe 225g/tuýp tặng bàn chải đánh răng lông tơ nhập khẩu Thái Lan",210000,210000,0,0
TIKI,do-choi-me-be,104155217,"Khẩu trang em bé Pigeon",91000,180000,89000,49
TIKI,do-choi-me-be,2790305,"Gel gừng thảo dược, massage tan mỡ bụng, săn chắc eo Wonmom 70g",212000,212000,0,0
TIKI,do-choi-me-be,125393656,"Set đồ chơi Xúc xắc, lục lạc, kèn, trống Toyshouse dành cho bé từ sơ sinh TH1220-733A giúp bé phát triển thính giác",79000,110000,31000,28
TIKI,lam-dep-suc-khoe,12081510,"Kem Thoa Giãn Tĩnh Mạch Hỗ Trợ Giảm Đau, Sưng, Phù Chân Vascovein (tuýp 50g)",150000,150000,0,0
TIKI,lam-dep-suc-khoe,67555393,"Dung dịch vệ sinh nam dịu nhẹ lành tính thành phần tự nhiên mùi hương nam tính chai vòi nhấn 150ml - LOLI & THE WOLF",149000,149000,0,0
TIKI,do-choi-me-be,91861978,"Nhà Lắp Ghép Thông Minh Nhà Giấy Carton Lắp Ráp Cho Bé _ Hộp Quà Kỳ Bí",87400,92000,4600,5
TIKI,do-choi-me-be,100512902,"Set 5 dây cột tóc xinh xắn cho bé gái",29500,29500,0,0
TIKI,do-choi-me-be,188835460,"Sữa bột CaloSure Gold – dinh dưỡng dành cho người cao tuổi 900G",529000,529000,0,0
TIKI,do-choi-me-be,40863685,"Đai Đỡ Bụng Bầu Cho Mẹ Bầu Chính Hãng Amalife - Nhiều size",109000,109000,0,0
TIKI,do-choi-me-be,112947411,"Hít nền quây cũi nhựa 10 miếng",25000,25000,0,0
TIKI,lam-dep-suc-khoe,53296092,"Sữa chống nắng Shiseido GSC The Perfect Protector 50ml",1250000,1250000,0,0
TIKI,lam-dep-suc-khoe,149467412,"Tinh Dầu Ngọc Lan Tây Homer 100ML - Tinh Dầu Thiên Nhiên Nhập Khẩu Nguyên Chất Giúp Giảm Stress, Khử Khuẩn và Xua Đuổi Côn Trùng, Sử Dụng Hiệu Quả với Máy Xông Tinh Dầu",85000,85000,0,0
TIKI,lam-dep-suc-khoe,22052325,"Sữa rửa mặt cho nam Oxy sạch sâu mát lạnh dạng kem Oxy Perfect Wash 100g",67000,82000,15000,18
TIKI,lam-dep-suc-khoe,24910578,"Son kem lì Bbia Last Velvet Lip Tint Version 3 5g (5 màu)",150000,290000,140000,48
TIKI,lam-dep-suc-khoe,76133761,"[HỘP - FAMAPRO 5D BABY] - khẩu trang y tế trẻ em kháng khuẩn 3 lớp Famapro 5D Baby (10 cái/ hộp) - 1 HỘP",9900,9900,0,0
TIKI,lam-dep-suc-khoe,72924805,"Máy Xông Tinh Dầu Hiệu Ứng Ánh Sáng 3D Cực đẹp, Máy Khuếch Tán Tinh Dầu Chuyên Dụng Xông Tinh Dầu Và Đèn LED 3D Trang Trí Phòng",388000,776000,388000,50
TIKI,do-choi-me-be,109454010,"Thảm đàn Piano cho bé  Thảm nằm chơi nhạc hình thú ngộ nghĩnh cho bé",128999,128999,0,0
TIKI,lam-dep-suc-khoe,47809115,"Đai Chống Gù Lưng Có Nẹp Cho Nam, Nữ và Trẻ Em",123000,123000,0,0
TIKI,lam-dep-suc-khoe,50331044,"Xà phòng rửa tay diệt khuẩn nano bạc Nano Vio 190ml - ít bọt, không triclosan, hương thơm tinh dầu dịu nhẹ",49500,99000,49500,50
TIKI,lam-dep-suc-khoe,1529993,"Xịt khử mùi dưỡng trắng hương nước hoa Refre Whitening PerfumeSophis Hương Tinh Tế 30ml",56100,62000,5900,10
TIKI,do-choi-me-be,85827114,"Bộ hóa trang người nhện liền thân Homecoming cho bé trai",350000,350000,0,0
TIKI,lam-dep-suc-khoe,128125614,"Combo 6 Băng Vệ Sinh Diana Hàng Ngày Compact Gói 20 Miếng",98000,108000,10000,9
TIKI,lam-dep-suc-khoe,68250779,"Cà Gai Leo Xạ Đen - Viên Uống Bổ Gan, Giải Độc Gan, Tăng Cường Chức Năng Gan (Hộp 60 Viên)",185000,185000,0,0
TIKI,lam-dep-suc-khoe,205080549,"Viên uống tăng cường sinh lý nam giới Powergra (Super Gold Magic) - Vỉ 1 viên",220000,220000,0,0
TIKI,lam-dep-suc-khoe,146584853,"Bàn chải đánh răng điện FAIRYWILL D7 Công nghệ sóng siêu âm 5 Chế độ làm sạch 3 Đầu thay thế đặc biệt Hàng Chính Hãng",284050,299000,14950,5
TIKI,lam-dep-suc-khoe,117793839,"Tăm nước cầm tay H2ofloss HF-2 phiên bản nâng cấp được phân phối độc quyền với nút mở bình nước tiện lợi, tặng kèm 7 đầu tăm, củ sạc nguồn thấp",459000,849000,390000,46
TIKI,do-choi-me-be,95010190,"Đồ chơi xếp hình, lắp ráp Qman 1720 - Cuộc xung đột bờ biển  (235 mảnh ghép)",199000,199000,0,0
TIKI,lam-dep-suc-khoe,161368381,"Dung dịch tẩy tế bào chết 2% BHA Paula's Choice Skin Perfecting 2% BHA Liquid Exfoliant",279300,399000,119700,30
TIKI,do-choi-me-be,154703056,"Áo yếm máng dài tay Cotton chống thấm nước cho bé tập ăn, tập vẽ Mastela",49200,49200,0,0
TIKI,do-choi-me-be,40369453,"Gối đi xe máy nhồi bông hình con chó",83000,83000,0,0
TIKI,lam-dep-suc-khoe,1600039,"Combo 6 Băng Vệ Sinh Diana Siêu Thấm Siêu Mỏng 0.1 (Gói 8 Miếng)",124000,144000,20000,14
TIKI,do-choi-me-be,181455505,"Thùng 48 hộp IQLac Colostrum Biếng Ăn Suy Dinh Dưỡng Premium 110ml cho trẻ biếng ăn, thấp còi, suy dinh dưỡng từ 1 tuổi",508800,508800,0,0
TIKI,do-choi-me-be,141502205,"Bộ 3 thanh chắn giường chống kẹt, cao tới 105cm, 24 nắc điều chỉnh, hạ 1 góc KidAndMom BR02 mẫu mới nhất trượt lên xuống",1999000,1999000,0,0
TIKI,do-choi-me-be,119370022,"Combo 10 Tấm Lót Khử Mùi Bồn Tiểu & Lỗ Sàn ECODEALS P1 Fresher - Khử mùi gấp 3 sáp thơm - Mùi ngẫu nhiên",409000,475000,66000,14
TIKI,do-choi-me-be,176937904,"Medela - Trợ ti hỗ trợ cho trẻ bú, size S/M/L - Dùng cho các mẹ đầu ty bị nứt hoặc phẳng, tụt, ngắn - Giúp cho trẻ ngậm bú dễ dàng",495000,495000,0,0
TIKI,thiet-bi-kts-phu-kien-so,97036830,"Tai Nghe Gaming 2021 Chống Ồn Cao Cấp XSmart GH5 Gamer Pro Phiên Bản Nâng Cấp sendem S2 , Tặng Bộ Phụ Kiện Mic Rời - Hàng Chính Hãng",189000,189000,0,0
TIKI,lam-dep-suc-khoe,114056241,"Tinh bột nghệ Nano HNT 200g - Đã được kiểm nghiệm và công bố - 100% Nguyên chất - Nguyên liệu hữu cơ - Sản phẩm chính hãng - Uy tín - Chất lượng",169000,169000,0,0
TIKI,do-choi-me-be,127067531,"Siro Phát Triển Trí Não Cho Bé FITOBIMBI OMEGA JUNIOR Giúp Trẻ Thông Minh, Sáng Mắt Italia Chai 30ml",390000,390000,0,0
TIKI,do-choi-me-be,412776,"Tã Quần Cao Cấp Moony Nhật Bản Bé Trai XL38 (38 Miếng)",339000,466400,127400,27
TIKI,lam-dep-suc-khoe,86529842,"Hộp 10 miếng mặt nạ giảm mụn mờ thâm Caryophy Portulaca Mask Sheet 3IN1 22g x 10",500000,500000,0,0
TIKI,do-choi-me-be,137951929,"[Bé 6-10 Tuổi] Nón Kết Mũ Lưỡi Trai Cho Bé Trai Từ 6 7 8 9 10 Tuổi Vòng Đầu 53cm Hiphop Cá Tính NK47 - Doni House",80000,80000,0,0
TIKI,thiet-bi-kts-phu-kien-so,72127109,"Dây Cao Su Cho Galaxy Watch 3 41mm / 45mm (Dây Size 20mm và 22mm)",85000,85000,0,0
TIKI,do-choi-me-be,94655416,"Balo đi học hình siêu nhân 3D cho bé- Cặp siêu nhân nhện cao cấp cho bé- Balo in hình siêu nhân mẫu mới",169000,169000,0,0
TIKI,do-choi-me-be,19252574,"Combo 8 miếng mút chặn góc bàn chống va chạm bảo vệ bé",29000,29000,0,0
TIKI,do-choi-me-be,19841467,"Quây cũi kiêm nhà bóng",189000,189000,0,0
TIKI,thiet-bi-kts-phu-kien-so,210427335,"Takstar E300W- Tặng túi rút đựng máy trợ giảng - Máy Trợ Giảng Không Dây UHF, Kết Nối Bluetooth, Công Suất 10W Cho Giáo Viên, Bán Hàng- Hàng chính hãng",990000,990000,0,0
TIKI,lam-dep-suc-khoe,138662376,"Dung dịch vệ sinh Phụ nữ Gel X2 Nano Nghệ Đào Hồng Mềm Mại Lưu Hương 24h Cocayhoala - 150ml",199000,330000,131000,40
TIKI,thiet-bi-kts-phu-kien-so,59090334,"Pin Sạc Dự Phòng RAVPower 20000mAh Quick Charge 3.0 + PD 60W, In/Out Type-C, Sạc Được Macbook - RP-PB201 - Hàng Chính Hãng",1190000,1690000,500000,30
TIKI,thiet-bi-kts-phu-kien-so,135347317,"Bao Da Cover Cho Máy Tính Bảng Lenovo Tab P11 / P11 Plus 11 Inch TB-J606 / TB-J607 Hỗ Trợ Smart Cover",139000,139000,0,0
TIKI,do-choi-me-be,145678526,"Bộ Pijama Lụa Dài Tay Cho Bé Từ 6-28kg MOON HOUSE, Bộ Lụa Họa Tiết Gấu Cho Bé Trai Và Bé Gái Mặc Nhà Cực Yêu",125000,125000,0,0
TIKI,thiet-bi-kts-phu-kien-so,121242259,"Chuột có dây Dell MS116-Hàng chính hãng",88000,88000,0,0
TIKI,thiet-bi-kts-phu-kien-so,6411193,"Cáp chuyển đổi mini HDMI đực sang HDMI cái dài 25CM UGREEN 20137 - Hàng Chính Hãng",89000,89000,0,0
TIKI,thiet-bi-kts-phu-kien-so,158461967,"Tai nghe bluetooth, tai nghe chụp tai mèo đáng yêu có mic đàm thoại và đèn LED headphone bluetooth dùng được cho cả điện thoại, laptop, máy tính 5Tech hàng chính hãng",189000,189000,0,0
TIKI,thiet-bi-kts-phu-kien-so,31602057,"Tai Nghe Nhét Tai Dùng Cho Các Dòng Điện Thoại OPPO âm thanh trung thực âm bass mạnh mẽ độ bền cao",22700,22700,0,0
TIKI,thiet-bi-kts-phu-kien-so,193771445,"Ốp Lưng dành cho Samsung Galaxy Z Flip 4 5G RINGKE Slim - Hàng Chính Hãng",274000,274000,0,0
TIKI,lam-dep-suc-khoe,105821846,"Tinh Dầu Treo Xe Homer 7ML - Khử Mùi Xe Hơi, Treo Thơm Phòng, Treo Tủ - Tinh dầu treo Sả chanh/ Bạc Hà/ Quế",8000,8000,0,0
TIKI,thiet-bi-kts-phu-kien-so,79600205,"Thiết Bị Chuyển Đổi Ethernet Adapter ROBOT EA10 USB 2.0 to LAN Tốc Độ  10/100Mbps - Hàng chính hãng",199000,199000,0,0
TIKI,lam-dep-suc-khoe,122092245,"[+Tặng mũ trùm] BỘ DẦU GỘI XẢ PASIORI TM COLLAGEN & BIOTIN TRẮNG PHỤC HỒI, MỀM MƯỢT NGĂN GÃY RỤNG MỌC TÓC ITALY 1000ML*2 [MẪU MỚI]",390000,390000,0,0
TIKI,thiet-bi-kts-phu-kien-so,35716768,"Cáp chuyển USB ra HDMI có âm thanh UTH1080 - FullHD (Đen)",178990,178990,0,0
TIKI,do-choi-me-be,755471,"Cờ Domino Ngà Nhỏ Liên Hiệp Thành KDNN",66000,66000,0,0
TIKI,thiet-bi-kts-phu-kien-so,111726388,"Đầu bút thay thế ngòi cao cấp dành cho Apple Pencil 1, 2 - Apple Pencil Tips_ Hàng Chính Hãng",58000,64000,6000,9
TIKI,lam-dep-suc-khoe,580507,"Lăn Khử Mùi Romano Attitude 50ml - 1412046",56000,68000,12000,18
TIKI,thiet-bi-kts-phu-kien-so,191809663,"Sạc dự phòng không dây từ tính Remax RPP-281 dung lượng 10000mAh kèm cáp sạc nhanh 2 chiều tiện lợi - Hàng chính hãng",753500,990000,236500,24
TIKI,lam-dep-suc-khoe,186305097,"Gối Kê Gáy, Cổ Thảo Dược Hapaku - Làm Nóng Bằng Lò Vi Sóng",198000,298000,100000,34
TIKI,thiet-bi-kts-phu-kien-so,58884030,"Giá đỡ kẹp điện thoại, máy tính bảng Vocal Stents để bàn đế tròn",116880,116880,0,0
TIKI,thiet-bi-kts-phu-kien-so,105613083,"Cáp loa 1 đầu jack 3.5 ra 2 đầu AV hoa sen dài 1.8M 3M 5M 10M 15M cao cấp (dây loa 1 ra 2)",28000,28000,0,0
TIKI,do-choi-me-be,68251375,"Nước rửa chén hữu cơ Bồ hòn Ecocare tinh dầu Quế 2000ml ",250000,250000,0,0
TIKI,thiet-bi-kts-phu-kien-so,14707617,"Bộ chuyển VGA to HDMI (Có Adapter)",62000,66200,4200,6
TIKI,lam-dep-suc-khoe,195937919,"[148 Mùi Hương] Tinh Dầu Thơm Phòng Trái Cây Thiên Nhiên Nhiệt Đới - Khử Mùi, Xông Thơm Phòng - Tinh Dầu Đào/ Chuối/ Táo Xanh/ Mơ/ Me/ Xoài/ Dưa Lưới/ Dưa Hấu (100ml)",275000,275000,0,0
TIKI,lam-dep-suc-khoe,1313887,"Kem chống nắng Skin Aqua dưỡng ẩm, dạng sữa dùng hàng ngày Sunplay Skin UV Moisture SPF 50, PA++++ 30g",88200,109000,20800,19
TIKI,thiet-bi-kts-phu-kien-so,167419581,"Tấm Da Lót Bàn Làm Việc Lót Chuột Văn Phòng",99000,99000,0,0
TIKI,thiet-bi-kts-phu-kien-so,58875726,"SIM 4G Mobifone VPB51 Tặng 500GB/Tháng",750000,750000,0,0
TIKI,thiet-bi-kts-phu-kien-so,182797700,"Miếng dán kính cường lực full màn hình cho điện thoại Xiaomi Redmi 10C, bảo vệ màn hình chống trầy xước",23787,23787,0,0
TIKI,thiet-bi-kts-phu-kien-so,72850683,"cáp USB Type-C ra Micro USB 2 đầu đực Ugreen 243CT50444US 1m màu đen hàng chính hãng",126000,126000,0,0
TIKI,thiet-bi-kts-phu-kien-so,159971506,"Bàn phím cơ Newmen GE87 TKL N-Box Outemu Switch - Hàng chính hãng",459000,459000,0,0
TIKI,thiet-bi-kts-phu-kien-so,91909097,"Bàn Phím Cơ chuyên GAME EDRA EK384 - Keycaps PBT - LED RGB - Hàng Chính Hãng",799000,799000,0,0
TIKI,lam-dep-suc-khoe,75528793,"Combo 3 Tinh Dầu Sả Chanh + Tinh Dầu Bạc Hà + Tinh Dầu Cam Ngọt - Tinh Dầu Xông Phòng Nguyên Chất Nhập Khẩu Giúp Thư Giãn, Đuổi Muỗi Và Thơm Phòng (3 chai 10ML)",118000,236000,118000,50
TIKI,thiet-bi-kts-phu-kien-so,89625320,"Cáp gộp Audio và mic ra 1 cổng 3.5mm",19000,19000,0,0
TIKI,do-choi-me-be,88002619,"Thanh chắn cửa, cầu thang 75-85cm Không khoan tường mẫu mới 2020",399000,399000,0,0
TIKI,thiet-bi-kts-phu-kien-so,37318109,"Miếng Lót Chuột Liên Minh Huyền Thoại 80 x 30 cm",38500,38500,0,0
TIKI,thiet-bi-kts-phu-kien-so,160418295,"Dock Sạc Dành Cho Samsung Galaxy Watch 4",199000,199000,0,0
TIKI,do-choi-me-be,9796292,"Combo 03 túi Nước Thơm Lau Sàn Mao Bao 1000ml - Gỗ Đàn Hương",120000,120000,0,0
TIKI,thiet-bi-kts-phu-kien-so,191719745,"Loa Bluetooth Marshall Willen Portable - Hàng chính hãng",2649000,2790000,141000,5
TIKI,lam-dep-suc-khoe,77749059,"Tinh Dầu Sả Chanh 50ML + Tinh Dầu Treo xe Treo Phòng Sả Chanh (Lemongrass) - Tinh Dầu Xông Phòng Sả Chanh Nguyên Chất TIDAMO Giúp Bảo Vệ Sức Khỏe, Kháng Khuẩn, Đuổi Muỗi Và Thư Giãn Tinh Thần",128000,256000,128000,50
TIKI,thiet-bi-kts-phu-kien-so,82033657,"Bao Da Case Cover Dành Cho iPad Mini 5/ iPad Pro 11 inch/ iPad Air 3 / iPad Pro 3/ iPad Air 4 / iPad 7/8 / iPad Pro 12.9 inch - Hàng Chính Hãng Có Khe Cắm Apple Pencil",99000,99000,0,0
TIKI,lam-dep-suc-khoe,174045175,"Kem chống nắng nâng tông Skin Aqua Tone up Latte Beige cho mọi tông da, dạng tinh chất Sunplay Skin Aqua Tone Up UV Essence Latte Beige SPF 50+ PA++++ 50g",161000,199000,38000,19
TIKI,lam-dep-suc-khoe,117257499,"Bộ 2 dầu gội Palmolive 600ml Sữa dừa và Keratin kết hợp quả ô liu 600ml",236000,236000,0,0
TIKI,thiet-bi-kts-phu-kien-so,112020137,"Tai nghe Samsung AKG giắc cắm Type C cho máy  Fold / Flip / Note 10, Note 20, S20, S21 - Hàng chính hãng",479000,479000,0,0
TIKI,thiet-bi-kts-phu-kien-so,101530842,"Pin Sạc Dự Phòng Xiaomi Redmi 20000mAh sạc nhanh 18W - Hàng chính hãng",550000,550000,0,0
TIKI,do-choi-me-be,249346935,"Bột canxi cá tuyết Fine Japan Nhật Bản (140g)",149000,149000,0,0
TIKI,thiet-bi-kts-phu-kien-so,130269035,"Củ sạc nhanh Baseus compact quick charger 3 cổng 2A1C 30W- hàng chính hãng",299000,299000,0,0
TIKI,thiet-bi-kts-phu-kien-so,6082263,"Bộ USB thu bluetooth cho dàn amly ra loa",41899,41899,0,0
TIKI,thiet-bi-kts-phu-kien-so,144278436,"Miếng dán cường lực trong suốt dành cho Samsung A03s/ A02s/ A12",15000,15000,0,0
TIKI,do-choi-me-be,103524399,"04 bộ tranh xếp hình 35 mảnh khổ A4 20x30cm – đồ chơi trí tuệ cho bé từ 2 tuổi – Combo 2",75000,100000,25000,25
TIKI,thiet-bi-kts-phu-kien-so,49625458,"Bút trình chiếu laser giảng dạy, thuyết trình không dây R400",117000,117000,0,0
TIKI,thiet-bi-kts-phu-kien-so,70820558,"Ốp cho Samsung Galaxy Note 10 Plus - Silicon trong suốt hãng GOR Hàng nhập khẩu",39000,39000,0,0
TIKI,thiet-bi-kts-phu-kien-so,77125504,"Bàn Phím Không Dây Đa Năng HiBow - Hàng Chính Hãng",190000,190000,0,0
TIKI,thiet-bi-kts-phu-kien-so,169925849,"Hộp Đựng Linh Kiện 36 Ngăn",42000,42000,0,0
TIKI,thiet-bi-kts-phu-kien-so,98262037,"GIÁ ĐỠ KẸP ĐIỆN THOẠI GẮN XE MÁY INOX C2 CHỐNG RUNG, CHỐNG CƯỚP GIẬT",39900,39900,0,0
TIKI,thiet-bi-kts-phu-kien-so,114699896,"Kê tay gỗ Óc Chó HyperWork Màu Nâu Đậm - Hàng Chính Hãng",221000,260000,39000,15
TIKI,thiet-bi-kts-phu-kien-so,40691443," Bộ Vệ Sinh Laptop, Máy Tính Bảng, Điện Thoại",14900,14900,0,0
TIKI,thiet-bi-kts-phu-kien-so,190824210,"Giá Đỡ Máy Tính, Laptop, Hợp Kim Nhôm Cao Cấp. Hỗ Trợ Tản Nhiệt Chống Mỏi Cổ, Vai, Gáy",147760,184700,36940,20
TIKI,thiet-bi-kts-phu-kien-so,105829753,"(Tặng túi đựng TOPK) Củ sạc nhanh Baseus mini 20W, hai cổng sạc USB và Type-C sạc nhanh cho iPhone, Samsung, Xiaomi, Huawei,...-Hàng chính hãng",175000,189000,14000,7
TIKI,thiet-bi-kts-phu-kien-so,152011359,"Bao Da Case Cover Dành Cho iPad Full Dòng Mini 1/2/3/4/5/6 - Air 1/2/3/4 - Gen 5/6/7/8/9 - Pro 11 Inch 2018/2020 - Pro 12.9 Inch",136800,159494,22694,14
TIKI,thiet-bi-kts-phu-kien-so,195781100,"Chuột không dây Gaming E-Dra EM6102w - Hàng chính hãng",172000,172000,0,0
TIKI,thiet-bi-kts-phu-kien-so,1570185,"Bảng Vẽ Wacom Intuos Pro Medium PTH-660",8890000,8890000,0,0
TIKI,thiet-bi-kts-phu-kien-so,196946349,"Ốp Lưng dành cho iPhone 14 / 14 Plus / 14 Pro / 14 ProMax Nillkin S.Frosted Shield Pro- Hàng chính hãng",189050,199000,9950,5
TIKI,thiet-bi-kts-phu-kien-so,16262699,"Bút Trình Chiếu laser PP-927",150000,175000,25000,14
TIKI,thiet-bi-kts-phu-kien-so,73837518,"Tai Nghe Không Dây True Wireless Nhét Tai – Hàng Chính Hãng",248000,500000,252000,50
TIKI,thiet-bi-kts-phu-kien-so,197387432,"Ốp Lưng MIPOW SOFT TPU CRYSTAL CLEAR Nguyên Liệu Đức (DROPTEST 1.8M, Chống Ố Vàng) dành cho iPhone 14 / iPhone 14 Plus/ iPhone 14 Pro/ iPhone 14 ProMax- Hàng chính hãng",228000,240000,12000,5
TIKI,thiet-bi-kts-phu-kien-so,53631890,"Miếng lót chuột, Pad chuột 90x40 cm Siêu rộng - Hàng chính hãng",69000,69000,0,0
TIKI,thiet-bi-kts-phu-kien-so,32208871,"Hub Chia Cổng USB Thành 4 Cổng Cao Cấp AZONE",28600,28600,0,0
TIKI,thiet-bi-kts-phu-kien-so,101843905," Giá Đỡ Điện Thoại livestream xem video Ổn Định Xoay 360 Độ dùng để Quay Phim Ghi Hình Đa Dụng",21999,21999,0,0
TIKI,thiet-bi-kts-phu-kien-so,25775437,"Bao Da Cover Cho Máy Tính Bảng Huawei MediaPad T3 10 (2017) Hỗ Trợ Smart Cover",129000,129000,0,0
TIKI,thiet-bi-kts-phu-kien-so,151521113,"Bút Trình Chiếu Nhỏ Gọn RAPOO XR200 - Hàng Chính Hãng",449000,449000,0,0
TIKI,thiet-bi-kts-phu-kien-so,109983015,"Cáp sạc iPhone Baseus Superior Series Fast Charging Data Cable (2.4A, 480Mbps, Fast charge, ABS/ TPE Cable) -  Hàng Chính Hãng ",79899,79899,0,0
TIKI,thiet-bi-kts-phu-kien-so,11886645,"Đế Tản Nhiệt Laptop N66 (2 quạt chạy cực êm)",118400,118400,0,0
TIKI,thiet-bi-kts-phu-kien-so,57511280,"Giá đỡ cho điện thoại máy tính bảng lắp sau ghế dùng cho ô tô xe hơi(xoay 360 độ, tiện dụng, phù hợp nhiều dòng xe)",143928,199900,55972,28
TIKI,thiet-bi-kts-phu-kien-so,70524690,"Giá Đỡ Máy Tính Laptop Macbook Hợp Kim Nhôm Cao Cấp Giúp Tản Nhiệt Có Thể Tháo Rời Hàng Chính Hãng Tamayoko",390000,600000,210000,35
TIKI,thiet-bi-kts-phu-kien-so,197653378,"Ốp lưng Trong Suốt dành cho Samsung Galaxy Z Flip 4 Chống Sốc, Chống Ố Vàng - Hàng chính hãng",109000,118999,9999,8
TIKI,thiet-bi-kts-phu-kien-so,107212953,"Giá Đỡ Máy Tính Bảng Ipad Stand 201 Đa Năng Điều Chỉnh Độ Cao Dành Cho Điện Thoại, Ipad",286598,530000,243402,46
TIKI,thiet-bi-kts-phu-kien-so,54485907,"Giá Đỡ Để Bàn Điện Thoại Di Động, Máy Tính Bảng, Ipad Hợp Kim Nhôm Hàng Chính Hãng Helios",29000,29000,0,0
TIKI,thiet-bi-kts-phu-kien-so,184297059,"Bao da dành cho SamSung Galaxy Tab A7 Lite T225/T220 chính hãng Onjess lưng silicone mềm - Hàng chính hãng",222000,222000,0,0
TIKI,thiet-bi-kts-phu-kien-so,68823687,"Giá Đỡ Để Bàn Máy Tính Bảng Ipad Điện Thoại (Lớn) Hợp Kim Nhôm Cao Cấp - Điều Chỉnh Góc Độ - Trục Kép- Gấp Lại Tiện Lợi Hàng Chính Hãng",388000,399000,11000,3
TIKI,thiet-bi-kts-phu-kien-so,63536208,"Túi chống nước điện thoại đi biển, bao đựng điện thoại chống nước cao cấp 4 lớp, đạt chuẩn chất lượng GoodFit GF202WP - Hàng chính hãng",79000,120000,41000,34
TIKI,thiet-bi-kts-phu-kien-so,123779650,"Cáp chuyển đổi HDMI To DVI 1.5m bọc lưới siêu bền",41900,41900,0,0
TIKI,thiet-bi-kts-phu-kien-so,105144403,"Ốp lưng chống sốc toàn phần dành cho iPhone 12 Mini / 12 / 12 pro / 12 Pro Max - Hàng chính hãng",9000,18000,9000,50
TIKI,thiet-bi-kts-phu-kien-so,120462495,"Loa vi tính 2.0 để bàn Leerfei E-350T Công Suất Lớn Dùng Cho Máy Vi Tính PC, Laptop, Tivi",85000,85000,0,0
TIKI,thiet-bi-kts-phu-kien-so,103660293,"Dây sạc type A To C PROLiNK GCA_40_01 dài 1M, sạc siêu nhanh 40W, dành cho iPad, Samsung, Huawei, Xiaomi - Hàng chính hãng",75000,110000,35000,32
TIKI,thiet-bi-kts-phu-kien-so,190703469,"Túi chống sốc 2 ngăn vải chống thấm đựng ổ cứng di động size 2.5inch, máy chụp hình du lịch, phụ kiện cáp sạc - Hàng chính hãng",54000,54000,0,0
TIKI,thiet-bi-kts-phu-kien-so,195305683,"Adapter Sạc ANKER PowerPort III Nano 20W Phiên Bản Marvel Giới Hạn - A2633 - Hàng Chính Hãng",400000,480000,80000,17
TIKI,thiet-bi-kts-phu-kien-so,15665489,"Dây Cáp Sạc Li.ght.ning Chuẩn M.F.i Cho i.Phone Anker Li.ght.ning PowerLine Select+ A8012 0.9m / A8013 1.8m - Hàng Chính Hãng",345000,360000,15000,4
TIKI,thiet-bi-kts-phu-kien-so,72793524,"Giá đỡ laptop tuỳ chỉnh góc nghiêng để phù hợp góc nhìn của bạn chất liệu hợp kim nhôm, hỗ trợ tản nhiệt tốt cho máy tính laptop, macbook và máy tính bảng",63800,63800,0,0
TIKI,thiet-bi-kts-phu-kien-so,197620972,"Ốp lưng Trong Suốt dành cho Samsung Galaxy Z Fold 4 Chống Sốc, Chống Ố - Hàng chính hãng",96999,96999,0,0
TIKI,thiet-bi-kts-phu-kien-so,144534656,"Loa Thanh LG 2.1ch SP2 (100W) - Hàng chính hãng",1099000,1099000,0,0
TIKI,thiet-bi-kts-phu-kien-so,17038778,"Cáp Chuyển Đổi Từ USB-C Sang USB 3.0/HDMI-Type C",91000,99000,8000,8
TIKI,thiet-bi-kts-phu-kien-so,150937588,"Cáp Sạc Nhanh 20W Dành Cho iPhone Remax RC-171, Chuẩn TypeC to IP,  Sử Dụng Chip E-marker, Chống Sạc Quá Tải, Chống Gãy Cáp - Hàng Chính Hãng",120000,139000,19000,14
TIKI,thiet-bi-kts-phu-kien-so,113835505,"Giá Đỡ Máy Tính Bảng, Ipad, Điện Thoại - Chất Liệu Hợp Kim Nhôm Cao Cấp - Hàng Chính Hãng Tamayoko",390000,450000,60000,13
TIKI,thiet-bi-kts-phu-kien-so,186199392,"Loa bluetooth 5TECH BS2 hàng chính hãng, loa mini cầm tay di động nghe nhạc cực hay hỗ trợ cắm thẻ nhớ, USB dành cho điện thoại, máy tính...",399000,399000,0,0
TIKI,thiet-bi-kts-phu-kien-so,58393093,"Loa Bluetooth 60W công suất lớn Super Bass chống nước IPX5 pin 6600MAH sạc nhanh Type C công nghệ AI Hàng Chính Hãng PKCB",1250000,2500000,1250000,50
TIKI,thiet-bi-kts-phu-kien-so,25248696,"Combo Bộ Vệ Sinh 4 Món + Tặng Kèm Hút Bụi Mini Cho Bàn Phím",29000,29000,0,0
TIKI,do-choi-me-be,74956654,"Dụng Cụ Dập Lỗ Núm Ty FARLIN - BF-112",135000,135000,0,0
TIKI,do-choi-me-be,14536554,"Bộ 10 tấm Thảm xốp cho bé ECOBABY, thảm xốp đạt tiêu chuẩn Mỹ và Châu Âu -  kích thước 1 tấm 30x30cm, độ dày khoảng 1cm - Hình học",94900,94900,0,0
TIKI,do-choi-me-be,77702037,"Đồ chơi xếp hình Qman 42101 - Tàu hỏa biến hình (305 mảnh ghép)",179000,199000,20000,10
TIKI,do-choi-me-be,192650435,"Bộ 2 chai Sữa Tắm Gội Trẻ Em Lactacyd Baby Gentle Care Bảo Vệ Dịu Nhẹ Cho Làn Da Nhạy Cảm 500ml/chai",384000,384000,0,0
TIKI,do-choi-me-be,119706870,"Dầu gội dịu lành cho bé Cetaphil Baby Shampoo 200ml",170000,170000,0,0
TIKI,do-choi-me-be,152532293,"Đồ Chơi ghép hình 4 mùa - Mùa Hè DK81075",95200,136000,40800,30
TIKI,do-choi-me-be,1347577,"Phấn Gạo Chống Hăm, Rôm, Sảy, Da Khô Hương Dịu Nhẹ ReisCare Extra Mild (50g)",64900,64900,0,0
TIKI,do-choi-me-be,146276825,"Bộ chăn gối đa năng Siro Hero Team",360000,360000,0,0
TIKI,do-choi-me-be,61819456,"Nước rửa chén hữu cơ Bồ hòn Ecocare - 100% thực vật, không hóa chất, tinh dầu khử mùi, chăm sóc da tay, tiết kiệm nước 30% - Chai 500ml - Chanh gừng",71000,71000,0,0
TIKI,do-choi-me-be,103545051,"04 bộ tranh xếp hình 35 mảnh khổ A4 20x30cm – đồ chơi trí tuệ cho bé từ 2 tuổi – Combo 7",75000,100000,25000,25
TIKI,do-choi-me-be,184132975,"[Kèm Video] Mắt Kính Trẻ Em MK02 Cao Cấp Chống UV400 + Chống gãy Cho Bé Trai Bé Gái (Tặng Kèm Hộp Đựng Kính Hình Ô Tô)",99000,99000,0,0
TIKI,do-choi-me-be,272415224,"Gối chữ U cho bé sơ sinh Molli, chống giật mình chống méo đầu, có dây rút điều chỉnh 3 đầu giúp bé sơ sinh ngủ ngon",149000,149000,0,0
TIKI,do-choi-me-be,109780055,"Đồ chơi gỗ cho bé Tháp xếp chồng gỗ 7 sắc cầu vồng ",28900,28900,0,0
TIKI,do-choi-me-be,121098358,"Bảng Vẽ Thông Minh Alilo Magic LCD Writing Tablet MFXHB - 13.5 inch - Đồ chơi giáo dục cho bé",690000,690000,0,0
TIKI,do-choi-me-be,125370223,"combo 10 nút bịt góc cạnh bàn silicon an toàn cho bé",12000,12000,0,0
TIKI,do-choi-me-be,170487028,"Khăn Lau Hạ Sốt 2Y+ Oribebe Cho Bé Giúp Hạ Nhiệt Giảm Sốt Hộp 4 Túi x 6 Khăn",126000,195000,69000,35
TIKI,do-choi-me-be,53995256,"Sét 100 dây buộc tóc len cho bé gái (chọn mầu) HD24",40000,40000,0,0
TIKI,do-choi-me-be,122801510,"Mũ gội đầu cho bé có bịt tai. Mũ tắm gội cho bé. Mũ chắn nước cho bé.",18999,18999,0,0
TIKI,do-choi-me-be,47134922,"Đai Chống Gù Lưng Cho Trẻ Em Chất Liệu Đai Bằng Thun Co Dãn 4 Chiều Thiết Kế Cực Thông Thoáng, Rất Dễ Chịu Và Thoải Mái Khi Mặc Sản Phẩm Dành Cho Bé Trai Và Cả Bé Gái",135000,135000,0,0
TIKI,do-choi-me-be,172000892,"Tã Dán Siêu Thấm Caryn Gói Siêu Tiết Kiệm M40 (40 Miếng)",359000,359000,0,0
TIKI,do-choi-me-be,48438770,"Combo Bộ Bài Tarot Bói Smith Waite Tarot Cao Cấp và Khăn Trải Bàn Tarot",119000,119000,0,0
TIKI,do-choi-me-be,111841806,"Sữa Nutrinidrink vị Vani/ vị Neutral lon 400g",379500,379500,0,0
TIKI,do-choi-me-be,272297911,"Gối cho bé 2-10 tuổi, cotton hàn 3D hoạt tiết sinh động, gối mềm mát giúp bé ngủ ngon",52000,52000,0,0
TIKI,do-choi-me-be,146630598,"Đệm Toilet ngồi đi vệ sinh , giúp  thu nhỏ bồn cầu trẻ em Cleverbees - Hàng chính hãng",99000,99000,0,0
TIKI,do-choi-me-be,182739931,"Kính Bơi Trẻ Em KBT02 MayHomes Bảo Vệ Mắt Và An Toàn Cho Bé Trai Bé Gái",45000,45000,0,0
TIKI,do-choi-me-be,8309763,"Bộ Quần Áo Trẻ Em In Hình Khủng Long  (Size",139000,240000,101000,42
TIKI,do-choi-me-be,130362263,"SET 5 LEGGING LỬNG/ QUẦN LỬNG QUA GỐI THUN COTTON 4 CHIỀU HOẠ TIẾT CHO BÉ GÁI HÀNG XUẤT DƯ ĐẸP 9-41KG",189000,189000,0,0
TIKI,do-choi-me-be,34499390,"Bộ 12 Miếng Bọc Cạnh Bàn,Tủ An Toàn Cho Bé",34395,34395,0,0
TIKI,do-choi-me-be,182463735,"Gấu bông gối ôm chó dài - Gấu bông cao cấp siêu dễ thương - Thú bông đồ chơi ngộ nghĩnh",130000,130000,0,0
TIKI,do-choi-me-be,113232978,"Quần thể dục 3 sọc cho bé trai, đồ thể thao nam nữ các cấp, vải thun co giãn, thương hiệu Amazing",71000,114000,43000,38
TIKI,do-choi-me-be,171666751,"[Nhiều màu] Chó bông xinh xắn biết đi, biết sủa, biết gật đầu",59000,59000,0,0
TIKI,dien-gia-dung,188785423,"Máy Xay Sinh Tố Mini Cầm Tay Sử Dụng Pin Sạc Cổng USB, Máy Xay Mini 6 Lưỡi Siêu Tiện Lợi - Hàng chính hãng MINIIN (Giao màu ngẫu nhiên)",178000,199000,21000,11
TIKI,dien-gia-dung,48952752,"Máy tạo ẩm cá nhân BONECO U50 Dùng Cho Xe Hơi/Xe Đẩy Em Bé/Bàn Làm Việc - Hàng nhập khẩu",1250000,1250000,0,0
TIKI,do-choi-me-be,139030241,"Bộ Bài Hừng Hực 52 Lá Tư Thế Mệnh Lệnh Tình Ái Bedroom Commands Trò Chơi Cực Bốc Dành Cho Các Cặp Đôi",110000,110000,0,0
TIKI,do-choi-me-be,38288512,"COMBO 2 HỘP KHỬ MÙI TỦ LẠNH THAN HOẠT TÍNH",19943,19943,0,0
TIKI,do-choi-me-be,57758472,"Đồ Bơi Bé Gái Màu Hồng Dễ Thương BB029 MayBlue Chất Liệu Bền Đẹp, Khóa Kéo Phía Trước",175750,185000,9250,5
TIKI,dien-gia-dung,21177085,"Bếp Ga Mini Du Lịch INOX",125000,125000,0,0
TIKI,dien-gia-dung,173251811,"Máy xay thịt Kangaroo KG12T (1.2 Lít) - Hàng chính hãng",777000,1200000,423000,35
TIKI,do-choi-me-be,9793660,"Combo 02 chai Nước Tẩy Nhà Tắm Mao Bao 600ml",82000,100000,18000,18
TIKI,do-choi-me-be,172342121,"Đồ bộ bé trai chất liệu thun dày mịn mát in hình 3D hoạt hình cực ngầu, sắc nét, được các bé trai yêu thích, thời trang, set, quần áo, bộ đồ, đồ bé trai từ 8kg-28kg",77000,77000,0,0
TIKI,dien-gia-dung,178549512,"Quạt Mini Tích Điện Đeo Cổ Thời Trang Besti Y01,  3 Tốc Độ Gió Siêu Mát, Chạy Siêu Êm, Dung Lượng Pin 2000mAh, Phù Hợp Khi Chạy Bộ, Đi Du Lịch , Văn Phòng, Đi Chơi- Hàng Chính Hãng",220000,220000,0,0
TIKI,dien-gia-dung,448841,"Máy Sấy Tóc Panasonic PAST-EH-ND11-A645 - Hàng Chính Hãng",272000,300000,28000,9
TIKI,do-choi-me-be,167858009,"LEGO CITY Xe Thám Hiểm NASA Mặt Trăng 60348",1092000,1092000,0,0
TIKI,do-choi-me-be,195867309,"Đèn Ngủ Hình Bướm Nhiều Màu",45000,45000,0,0
TIKI,dien-gia-dung,56225103,"Quạt bàn đảo 4 Tấc chuyển hướng điện cao cấp Senko BD1410 ( Hàng Chính Hãng )- Giao màu ngẫu nhiên",465000,465000,0,0
TIKI,dien-gia-dung,146630136,"Nồi lẩu mini, ca nấu mì, Nồi Lẩu Điện Đa Năng Mini 2 Tầng Cao Cấp Núm Xoay 2 Nấc Nhiệt Tặng Kèm Giá Hấp 1,8L - Chính Hãng dododios - Logo ngẫu nhiên trên thân nồi, ca nấu mỳ đa năng mini",109000,109000,0,0
TIKI,dien-gia-dung,115243711,"COMBO 3 LÕI LỌC NƯỚC SỐ 1-2-3 (PP - CTO - PP) - HÀNG CHÍNH HÃNG ĐẠI VIỆT",120000,120000,0,0
TIKI,do-choi-me-be,93152375,"Combo Tiết Kiệm: Nước rửa bình sữa Arau Baby 450 - Mẫu Mới, Hàng Có Tem Phụ Chính Hãng",255000,255000,0,0
TIKI,dien-gia-dung,149178837,"Máy Xay Sinh Tố Mini Cầm Tay 300ml 4 Lưỡi Dao Thép Không Gỉ Có Pin Tích Hợp Sạc USB Bugu BG-JS2 - Hàng Chính Hãng",271000,329000,58000,18
TIKI,dien-gia-dung,262758706,"Máy cạo râu 3 lưỡi Panasonic ES-SL41-S453 - Hàng Chính Hãng",1590000,1599000,9000,1
TIKI,dien-gia-dung,88085663,"LƯỠI DAO THÔNG MINH CỦA MÁY XAY THỊT ĐA NĂNG",32999,32999,0,0
TIKI,dien-gia-dung,68419791,"Tông đơ cắt tóc Xiaomi Enchen Boost - Enchen Boost Hair Clipper - Hàng Nhập Khẩu",189000,299000,110000,37
TIKI,dien-gia-dung,51626369,"Tông đơ bấm viền cao cấp kemei 1949 vỏ nhôm nguyên khối pin LITHIUM 1400mah-hãng phân phối",350000,369000,19000,5
TIKI,dien-gia-dung,59097386,"Quạt Lỡ Sắt Senko LS1630 - Màu Ngẫu Nhiên - Hàng Chính Hãng",385000,385000,0,0
TIKI,dien-gia-dung,116877695,"Nồi cơm điện Cuckoo 3 lít CR-1720/SIVNCV màu bạc - Hàng chính hãng",2090000,2410000,320000,13
TIKI,dien-gia-dung,205819654,"Máy vắt cam Mitomo VC-55Pro Bảo hành 3 năm xuất xứ thái lan",759000,1288999,529999,41
TIKI,dien-gia-dung,37131076,"Bình tạo nước icon kiềm Hydrogen 430ml",834000,834000,0,0
TIKI,dien-gia-dung,15252783,"Tông Đơ Cắt Tóc Hàn Quốc CODOL 531 TẶNG KÈM Bộ Kéo Cắt Tỉa Chuyên Nghiệp ",218997,218997,0,0
TIKI,dien-gia-dung,101995241,"Máy hàn miệng túi nilon, túi zip chuyên dụng vỏ nhựa 200x2 ( màu trắng)",298000,298000,0,0
TIKI,dien-gia-dung,187641895,"Quạt tích điện mini để bàn, quạt tích điện mini gấp gọn, quạt tích điện mini cao cấp Super Q18 có 3 chế độ làm mát, có thể xoay 180 độ sử dụng trong nhiều giờ, quạt mini, quạt sạc điện, quạt cầm tay",52999,52999,0,0
TIKI,dien-gia-dung,128116608,"Bếp Hồng Ngoại Lock&Lock EJI341 (Model 2021) - Hàng Chính Hãng",1199000,2000000,801000,40
TIKI,dien-gia-dung,130780467,"Máy hút bụi cầm tay sạc pin không dây SeaSy R6053 công suất mạnh 120W dùng cho gia đình hút bụi giường đệm, ghế ô tô - Hàng chính hãng",499000,499000,0,0
TIKI,dien-gia-dung,44371240,"Nồi cơm điện tử Panasonic SR-CL188WRA 1.8 lít / SR-CL108WRA 1 lít - Hàng chính hãng",2300000,2300000,0,0
TIKI,dien-gia-dung,21327173,"Bếp Nướng Không Khói-Bếp Nướng Điện",168000,168000,0,0
TIKI,dien-gia-dung,162865713,"Quạt đứng Kangaroo KG725 (55W) - Hàng Chính Hãng",809000,1329000,520000,39
TIKI,dien-gia-dung,426242,"Nồi Tiềm Korea King KSC-30R (3L) - Hàng chính hãng",859000,859000,0,0
TIKI,do-choi-me-be,146634501,"Đồ Chơi Xếp Hình Các Loại Xe Và Robot Biến Hình 195 Chi Tiết Loại To",350000,350000,0,0
TIKI,dien-gia-dung,689250,"Ấm Đun Siêu Tốc LOCK EJK418SLV -Hàng Chính Hãng",469000,800000,331000,41
TIKI,dien-gia-dung,19755982,"Quạt tháp Tiross TS9182 (35W) - Hàng Chính Hãng",3160000,3990000,830000,21
TIKI,dien-gia-dung,77985981,"Máy Xay Thịt Cối Inox 3 Lít Midimori (800W) - Hàng Chính Hãng",529000,849000,320000,38
TIKI,dien-gia-dung,162841495,"Máy cạo râu khô và ướt Philips S1103/02 - Hàng Chính Hãng",664000,764000,100000,13
TIKI,dien-gia-dung,66727944,"Máy xay sinh tố cầm tay Philips HR2537 (650W) - Hàng chính hãng",1220000,1690000,470000,28
TIKI,dien-gia-dung,242406040,"Nồi Chiên Không Dầu, Nồi Chiên Hơi Nước KALITE STEAM STAR Tích Hợp 10 Chương Trình Nấu Dung Tích 15 Lít Công Suất 1800 W - Hàng Chính Hãng",3999000,7969000,3970000,50
TIKI,dien-gia-dung,185411479,"Bình Đun Siêu Tốc 2 Lớp Damas DK-6018 1.8L - Trang Bị Công Nghệ Giữ Nhiệt 3 Lớp Hiện Đại, Bộ Cảm Biến Nhiệt Đạt Chuẩn EU - Công Suất Lớn 1800W Sôi Nhanh Chỉ Trong 6 Phút - Thiết Kế Bề Mặt Bên Trong Bằng Thép Không Gỉ Inox 304 Cao Cấp - Hàng Nhập Khẩu",391000,700000,309000,44
TIKI,dien-gia-dung,172573484,"Quạt Treo Tường 3 Cánh Midea FW40-6H (Công Suất 55W - 3 Cấp Gió) - Hàng Chính Hãng",1170000,1170000,0,0
TIKI,dien-gia-dung,157241885,"Bộ lõi máy lọc nước KAROFI Smax hiệu suất cao HP 6.2 - Hàng chính hãng",889000,889000,0,0
TIKI,dien-gia-dung,140136287,"Máy Phun Sương Tạo Ẩm Mini Xông Hơi Nước 380ml KONKA KZ-HU0001(B) - Hàng Chính Hãng",135000,185000,50000,27
TIKI,dien-gia-dung,123433395,"Cánh quạt hộp cánh quạt tản sải cánh 300mm - 350mm-Giadung24h",32000,32000,0,0
TIKI,dien-gia-dung,1754771,"Bình thủy điện thép không gỉ Comet CM3217 3.4 Lít (Bạc) - Hàng Chính Hãng",829000,1100000,271000,25
TIKI,dien-gia-dung,248703729,"Nồi điện mini đa năng Bear 1.2L (kèm khay hấp) nồi lẩu điện mini, Anh Lam Store - Hàng chính hãng",386000,425000,39000,9
TIKI,thiet-bi-kts-phu-kien-so,50328769,"Tông đơ cắt tóc kemei 1997 chuyên nghiệp",599000,599000,0,0
TIKI,thiet-bi-kts-phu-kien-so,137599735,"Phụ kiện chổi cạnh, quét Deebot DN33, Dn320, Dn39, DN36, DN55, DN520, T5 Hero, T5 Max, Neo, T9, N8, T8 aivi, plus, power",20000,20000,0,0
TIKI,thiet-bi-kts-phu-kien-so,104662472,"Cây nước nóng lạnh Nhật Bản Fujihome WD5320E khóa vòi nóng, máy nước uống nóng lạnh mini tự ngắt tiết kiệm điện - Hàng Chính hãng",2000000,2000000,0,0
TIKI,thiet-bi-kts-phu-kien-so,70495040,"Đèn Khò Gas Namilux NH-T3091RN - Hàng Chính Hãng",149000,190000,41000,22
TIKI,thiet-bi-kts-phu-kien-so,41167735,"Bàn Ủi Hơi Nước Đứng Bluestone GSB-3911 (1800W) - Hàng Chính Hãng",1899000,1899000,0,0
TIKI,thiet-bi-kts-phu-kien-so,13818028,"Máy ép chậm SAVTM JE31 250W (Đỏ) - Hàng nhập khẩu",1044000,2000000,956000,48
TIKI,thiet-bi-kts-phu-kien-so,193888020,"Máy khử mùi khử trùng nhà vệ sinh, vật nuôi, phòng bếp Hiệu Quả- Hàng Nhập Khẩu",399000,399000,0,0
TIKI,thiet-bi-kts-phu-kien-so,127031344,"Máy Nướng Bánh Mì Kẹp BlueStone SBB-2333 (650W) - Hàng Chính Hãng",599000,799000,200000,25
TIKI,thiet-bi-kts-phu-kien-so,27380245,"Dụng Cụ Xay Cà Phê Cổ Điển",125000,125000,0,0
TIKI,thiet-bi-kts-phu-kien-so,125737508,"Máy hút chân không thực phẩm Vacuum Sealer tặng 10 túi",95000,95000,0,0
TIKI,thiet-bi-kts-phu-kien-so,25001149,"Bóng đèn hồng ngoại sưởi gia cầm gà vịt ấp trứng 150W",39000,39000,0,0
TIKI,thiet-bi-kts-phu-kien-so,1368775,"Nồi Nấu Cháo Đa Năng BBCooker BS35 (3.5L) - Hàng chính hãng",568000,568000,0,0
TIKI,thiet-bi-kts-phu-kien-so,174162760,"Máy Tạo Kiểu Tóc PHILIPS BHS530 - Hàng Chính Hãng",1499000,1899000,400000,21
TIKI,thiet-bi-kts-phu-kien-so,74386218,"ĐÈN KHÒ GAS NAMILUX TS1719RN ( SẢN PHẨM HỢP TÁC XUẤT KHẨU ASAHI SEISAKUSHO - JAPAN )",99000,120000,21000,18
TIKI,thiet-bi-kts-phu-kien-so,68736683,"Máy Cạo Râu Tiện Dụng KM 2024 - Tặng Kèm Đầu Dao Cạo",199000,215000,16000,7
TIKI,thiet-bi-kts-phu-kien-so,60175360,"Quạt Sạc Tích Điện Gấp Gọn Có Chức Năng Phun Sương 3 Chế Độ Gió Tự Nhiên Có Chế Độ Quay Tự Động",599000,599000,0,0
TIKI,thiet-bi-kts-phu-kien-so,34618044,"Quạt Lồng Sắt Mini Đê Bàn Cực Mát (Màu Ngẫu Nhiên) - Sạc Bằng Cồng USB",51500,51500,0,0
TIKI,thiet-bi-kts-phu-kien-so,115833922," Lọc bụi của máy hút bụi Black&Decker  PV1820/PV1420/PV1020/PV1200 N566707- Hàng chính hãng",46000,46000,0,0
TIKI,thiet-bi-kts-phu-kien-so,189601101,"Máy Xay Thịt 2 lưỡi dao kép BlueStone CHB-5135 ( 300W- 1,2 Lít ) - Hàng Chính Hãng",715000,799000,84000,11
TIKI,thiet-bi-kts-phu-kien-so,188844803,"Tấm nhôm cản mỡ 23 x 26cm, lưới lọc mỡ nhôm máy hút mùi kính cong",165000,165000,0,0
TIKI,thiet-bi-kts-phu-kien-so,188884166,"Quạt Đeo Cổ Parrot USB Mini Tích Điện Không Cánh Tiện Lợi, Thời Trang, Dáng Thể Thao",68000,68000,0,0
TIKI,thiet-bi-kts-phu-kien-so,220659100,"Nồi Áp Suất Điện Siêu Tốc Đa Năng MASUTO 15 IN 1 MS-AF6/ LG-06A Công Nghệ Nhật Bản Nấu Nhanh Hơn 80% Áp Suất Thường Dung Tích 6 Lít Công Suất 1000W - Hàng Chính Hãng",1899000,3699000,1800000,49
TIKI,thiet-bi-kts-phu-kien-so,110152711,"Bếp gas du lịch hồng ngoại Namilux PM1817AS - HÀNG CHÍNH HÃNG NAMILUX (MP)",370000,370000,0,0
TIKI,thiet-bi-kts-phu-kien-so,74238494,"Quạt cầm tay tiện lợi gắn tai thỏ Damas N10 - Thiết kế dễ thương - Phù hợp tiêu chuẩn hiện đại (Giao màu ngẫu nnhiên)",153000,250000,97000,39
TIKI,thiet-bi-kts-phu-kien-so,13410712,"Quạt treo điều khiển từ xa TR1628 - Hàng chính hãng",525000,525000,0,0
TIKI,thiet-bi-kts-phu-kien-so,14767917,"Lõi Lọc R.O Sunhouse Số 2 SHRLL2 - Hàng Chính Hãng",84000,148000,64000,43
TIKI,thiet-bi-kts-phu-kien-so,64450283,"Bộ Lọc Tại Vòi Ceramic Cao Cấp ZSW-010A / 010B, Lọc trực tiếp tại vòi nước, Dể sử dụng và bảo trì thiết lọc, Lọc cặn bẩn có hại trong nước như clo và diệt khuẩn, Thiết kệ hiện đại với nhiều đầu kết nối đa năng",106000,106000,0,0
TIKI,thiet-bi-kts-phu-kien-so,274184213,"Chính Hãng - Lõi Lọc Nước RO Số 3 Lõi PP 10" 1 Micro  Đại Việt",40000,40000,0,0
TIKI,thiet-bi-kts-phu-kien-so,463515,"Máy Làm Tỏi Đen TIROSS TS904 - Hàng chính hãng",1270000,1490000,220000,15
TIKI,thiet-bi-kts-phu-kien-so,20576851,"Máy Xay Sinh Tố Mini",71890,71890,0,0
TIKI,thiet-bi-kts-phu-kien-so,647177,"Bình Đun Siêu Tốc Tiger PCD-A10W (1 lít) - Màu Đồng",1659000,2450000,791000,32
TIKI,thiet-bi-kts-phu-kien-so,137599541,"Phụ kiện chổi giữa, chổi chính dành cho Robot hút bụi lau nhà DN33 DN55 T5 T8 T9 N8 Ozmo 900 920 950",80000,80000,0,0
TIKI,thiet-bi-kts-phu-kien-so,41650012,"Tông Đơ Cắt Tóc 27C Siêu Hot",165000,165000,0,0
TIKI,thiet-bi-kts-phu-kien-so,523883,"Máy Xay Sinh Tố Cầm Tay DAEWOO DEB-JZ150 (150W) - Trắng Xanh - Hàng chính hãng",280000,398000,118000,30
TIKI,thiet-bi-kts-phu-kien-so,25746162,"Quạt Điện Mini 12V Có Chân Kẹp Chuyên Dụng Trên Xe Ô Tô ",158000,158000,0,0
TIKI,thiet-bi-kts-phu-kien-so,176545146,"Hộp Cơm Cắm Điện Hâm Nóng Besti 2 Tầng 4 Khay Inox Cao Cấp Không Gỉ, Hộp Cơm Cắm Điện Văn Phòng Sang Trọng Đa Năng, Tiện Lợi Dễ Sử Dụng - Hàng Chính Hãng",290000,290000,0,0
TIKI,thiet-bi-kts-phu-kien-so,51066185,"Máy Cạo Râu Mini Siêu Bền, tặng kèm bao da nam tính - SCW301U",83000,83000,0,0
TIKI,thiet-bi-kts-phu-kien-so,51337072,"Bộ 3 túi đựng bụi MODEL 19-3100N dùng cho máy hút bụi STANLEY SL19117, SL19116, SL19116P- Hàng chính hãng",320000,320000,0,0
TIKI,thiet-bi-kts-phu-kien-so,19842648,"Quạt Tích Điện Mini Cầm Tay 3 Tốc Độ Gió (có dây sạc)",38900,38900,0,0
TIKI,thiet-bi-kts-phu-kien-so,456061,"Lò Vi Sóng Có Nướng Sharp R-G302VN-S - 23 Lít - Hàng chính hãng",2330000,2640000,310000,12
TIKI,lam-dep-suc-khoe,57519012,"Siro thảo dược hỗ trợ giảm ho, long đờm, nhuận phế EUGICA SYRUP (Hộp 30 gói x 5 ml)",59000,65000,6000,9
TIKI,lam-dep-suc-khoe,95127416,"Tinh Dầu Cam Ngọt Homer 100ml - Chính Hãng, Đạt Chuẩn Kiểm Định Cao Cấp - Tinh Dầu Xông Thơm Phòng, Thư Giãn, Khử Mùi hiệu quả",60000,60000,0,0
TIKI,lam-dep-suc-khoe,22103020,"The Ordinary AHA 30% + BHA 2% Peeling Solution - Giải Pháp Hỗ Trợ Giảm Vết Thâm, Da Sần Mụn, Lỗ Chân Lông 30ml",285000,350000,65000,19
TIKI,lam-dep-suc-khoe,53445636,"Nước Rửa Tay Lifebuoy Bảo Vệ Vượt Trội 10 - 4kg",299000,299000,0,0
TIKI,lam-dep-suc-khoe,630793,"Kem chống nắng Skin Aqua trang điểm tạo nền trắng mịn & đều màu dạng sữa Sunplay Skin Clear White CC Milk SPF 50, PA++++ 25g",117000,145000,28000,19
TIKI,lam-dep-suc-khoe,150016863,"Set 50 cái khẩu trang y tế KF94 Kháng Khuẩn, Chống Bụi Mịn, Hàng Cao Cấp",48000,80000,32000,40
TIKI,lam-dep-suc-khoe,60684152,"Dầu Gội Hà Thủ Ô 2in1 Dành Riêng Cho TÓC BẠC Và RỤNG TÓC Cocayhoala Chai Lớn 450g Tiết Kiệm Hơn 1,5 lần",256000,450000,194000,43
TIKI,lam-dep-suc-khoe,12084610,"Kem Dưỡng Ẩm Cho Da Khô Và Nhạy Cảm Eucerin Lipo Balance (50ml)",199000,269000,70000,26
TIKI,lam-dep-suc-khoe,117147637,"Sữa rửa mặt Simple giúp cấp ẩm, da trông khỏe và mịn màng - cho da khô nhạy cảm 150ml [CHÍNH HÃNG ĐỘC QUYỀN] [MỚI]",98100,132000,33900,26
TIKI,lam-dep-suc-khoe,158762755,"Bọt vệ sinh nam giới Oniiz - Dung dịch vệ sinh nam tạo bọt 100ml",120000,120000,0,0
TIKI,lam-dep-suc-khoe,176672117,"Sữa rửa mặt ngăn ngừa mụn dạng gel Acnes Gentle Wash 100g",55400,70000,14600,21
TIKI,lam-dep-suc-khoe,57898727,"Khẩu Trang Y Tế Than Hoạt Tính TDCare 4 Lớp (40 Cái/Hộp)",39000,55000,16000,29
TIKI,lam-dep-suc-khoe,25917940,"Gel Cải Thiện Sẹo Và Vết Thâm Ngứa Trẻ Em Hiruscar Kids 10G",225000,245000,20000,8
TIKI,lam-dep-suc-khoe,144324214,"Cồn Sát Khuẩn 90 độ Vĩnh Phúc Có Vòi Xịt",39800,39800,0,0
TIKI,lam-dep-suc-khoe,385568,"Bao cao su Durex Fetherlite Hộp 3 Bao",61000,69000,8000,12
TIKI,do-choi-me-be,2989999,"{ Lắp Là Dùng } Sim 5G Thái Lan 10 Ngày 50GB Và 100 Phút Gọi Thái Lan - Mẫu ngẫu nhiên",165000,165000,0,0
TIKI,do-choi-me-be,142323009,"Dây Cáp DisplayPort 2 Đầu Đực Dài 2M 1.2 Phân Giải 8K 60hz Tốc Độ 32.4Gbps CHOETECH XDD01 - Hàng Chính Hãng",229000,390000,161000,41
TIKI,do-choi-me-be,181922008,"Case Silicon Dành Cho Airpods Pro In Hình Tai Nghe-Kèm Móc Khóa_ Hàng Chính Hãng",65550,69000,3450,5
TIKI,lam-dep-suc-khoe,185260738,"Cây nặn mụn - nặn mụn đầu đen và các loại mụn 2 đầu",12000,19000,7000,37
TIKI,lam-dep-suc-khoe,67017650,"Combo 6 Băng vệ sinh Diana Siêu thấm Cool Fresh Siêu mỏng Cánh gói 8 miếng",126000,138000,12000,9
TIKI,do-choi-me-be,33744638,"Bàn di chuột, miếng lót chuột, mouse pad RGB size 80x30, 90x40",124000,160000,36000,23
TIKI,do-choi-me-be,195300886,"Cáp Sạc ANKER PowerLine+ II USB-C to Lightning - Phiên Bản Marvel - A9548 - Hàng Chính Hãng",396000,550000,154000,28
TIKI,lam-dep-suc-khoe,53923837,"Tinh chất dưỡng the Ordinary Hyaluronic Acid 2 % + B5",268000,285000,17000,6
TIKI,do-choi-me-be,186817879,"Loa máy trợ giảng Aporo T30 UHF, công suất 20W không dây cao cấp (gồm 3 micro)- Hàng chính hãng",850000,850000,0,0
TIKI,lam-dep-suc-khoe,81517203,"Máy Massage Mặt Làm Đẹp Da 5 in 1 Photon Nóng Và Lạnh EMS Giúp Nâng Cơ Mặt, Rửa Sạch Sâu, Tăng Cường Hấp Thụ Và Khóa Giữ Tinh Chất Dưỡng Da Kèm Máy Massage Mắt Loại Quầng Thâm ",1388000,1388000,0,0
TIKI,lam-dep-suc-khoe,111937524,"Betaclor® Austria Viên đặt phụ khoa, Giải Pháp Toàn Diện Bệnh Phụ Khoa: Viêm Phụ Khoa, Nấm Candida, Tăng Tiết Dịch Nhầy Bôi Trơn. Viên Đặt Se Khít Tái Tạo Phục Hồi Niêm Mạc, Ngừa Teo Hoá, Cân Bằng pH Lợi Khuẩn. Nhập Khẩu Nguyên Hộp Austria Châu Âu",289000,339000,50000,15
TIKI,lam-dep-suc-khoe,108535216,"Bao cao su Sagami Superthin - Mỏng - Kiểu truyền thống - Hộp 2 chiếc",32000,35000,3000,9
TIKI,lam-dep-suc-khoe,26115522,"Viên uống Bổ Sung Kẽm DHC ZinC Nhật Bản",188000,210000,22000,10
TIKI,do-choi-me-be,74891073,"giá kê laptop/macbook hợp kim nhôm gập gọn, tùy chỉnh độ cao tầm nhìn, đế tản nhiệt laptop",66700,66700,0,0
TIKI,lam-dep-suc-khoe,77700776,"Cân sức khoẻ cơ học Tanita HA680 Nhật Bản,Cân Tanita, chính hãng nhật bản,cân cơ học,cân chính hãng,cân nhật bản,cân sức khoẻ y tế,cân sức khoẻ gia đình,cân sức khoẻ cao cấp,cân120kg,cân 130kg,Cân sức khoẻ mini",496000,750000,254000,34
TIKI,do-choi-me-be,5987217,"Cáp HDMI 2.0 hỗ trợ 3D, 4K dài 5m UGREEN HD118 40412 - Hàng chính hãng",210000,273000,63000,23
TIKI,lam-dep-suc-khoe,631519,"Serum chấm mụn chuyên biệt cho da mụn ở tuổi trưởng thành Acnes 25+ Facial Serum 20ml",105000,110000,5000,5
TIKI,do-choi-me-be,98687501,"Kính Cường Lực  Chống Nhìn Trộm Iphone Full Màn 6_6s_6plus_6splus_7plus_8plus_X_Xs_Xsmax_11_11pro_11pro max",26000,52000,26000,50
TIKI,do-choi-me-be,178031593,"Tai Nghe Không Dây HUQU F.808 Âm Thanh Sống Động Chân Thực, Đường Truyền Ổn Định - Hàng chính hãng ",560500,590000,29500,5
TIKI,lam-dep-suc-khoe,212981943,"Keo Dán Móng Tay Loại Xịn Chuyên Dùng Cho Tiệm Nail, Dùng Gia Đình Với Chất Lượng Vượt Trội",33000,33000,0,0
TIKI,do-choi-me-be,17903752,"Bao Da Cover Máy Đọc Sách Dành Cho Kindle Paperwhite Gen 4 (10th) Hoa Văn",130000,130000,0,0
TIKI,lam-dep-suc-khoe,56229532,"Đai Chống Gù Lưng Tiêu Chuẩn Đức ANDEGO - Đai Định Hình Cột Sống, Chỉnh Tư Thế Lưng Cao Cấp - Phù Hợp Với Mọi Độ Tuổi - Chữa Hiệu Quả Chứng Gù Lưng, Lưng Tôm, Cong Vẹo Cột Sống - Phân Phối Chính Hãng",155000,155000,0,0
TIKI,do-choi-me-be,140742956,"Sạc nhanh AUKEY PA-Y30S PD 30W - Hàng chính hãng",268000,268000,0,0
TIKI,lam-dep-suc-khoe,1521643,"Xịt Khoáng Avène Thermal Spring Water 100715921 (300ml)",339000,424000,85000,20
TIKI,lam-dep-suc-khoe,158772428,"Máy massage mini cầm tay CTFAST-720: Mát xa 6 cấp độ, hỗ trợ maassage chuyên sâu, giảm đau cơ, cứng khớp hiệu quả nhanh chóng, đi kèm 4 đầu chuyên dụng - Quà tặng cho sức khỏe",415000,549000,134000,24
TIKI,lam-dep-suc-khoe,92454199,"Máy xông tinh dầu mẫu mới công nghệ hiện đại mã máy DK-BN NEW - Hình Bí ngô viền trắng - Hàng nhập khẩu - chế độ phun mạnh - khuếch tán tinh dầu trong không gian rộng",192000,349000,157000,45
TIKI,do-choi-me-be,193005797,"Đồng hồ Thông minh 25 GAME Y8S gắn thẻ nhớ 32G Nghe nhạc Lắp Sim gọi Điện thoại không cần App Quản lý Hàng nhập khẩu",1000000,1000000,0,0
TIKI,do-choi-me-be,167596574,"HÀNG CHÍNH HÃNG-  Kính cường lực Kingkong iP hộp sắt, không hộp WEKOME cho IP 6 Plus 7 8 X XS Max 11 12 Pro 13 13pro 13 PROMAX",20998,41996,20998,50
TIKI,do-choi-me-be,35278834,"Hàng Chính Hãng- Loa Máy Vi Tính SADA V-196, Hỗ Trợ Đèn Led, Âm Thanh Siêu Trầm",196000,196000,0,0
TIKI,do-choi-me-be,119450638,"Kệ để màn hình máy tính, laptop Dovaty KM3",138000,138000,0,0
TIKI,lam-dep-suc-khoe,56794260,"Bộ 3 kem đánh răng Colgate ngừa sâu răng răng chắc khỏe 225g/ tuýp tặng bàn chải lông tơ cao cấp Thái Lan",173000,173000,0,0
TIKI,lam-dep-suc-khoe,75523734,"Combo 3 Tinh Dầu Sả Chanh + Tinh Dầu Bạc Hà + Tinh Dầu Vỏ Quế - Tinh Dầu Thiên Nhiên Xông Phòng Cao Cấp Giúp Thư Giãn, Đuổi Muỗi Và Thơm Phòng (3 chai 10ML)",74000,176000,102000,58
TIKI,do-choi-me-be,195888467,"Miếng Lót Chuột Mouse Pad Kích Thước 26x21cm Dùng Trong Văn Phòng Học Tập Mẫu Hoạt Hình Anime Chibi",37050,39000,1950,5
TIKI,do-choi-me-be,114100979,"Chuột Không Dây Không Ồn E-DRA EM603W (Silent Switch) - Hàng Chính Hãng",85000,85000,0,0
TIKI,lam-dep-suc-khoe,21155024,"Dầu hấp ủ tóc siêu mượt Karseell Maca Essence Repair Collagen (dạng túi) 500ml",180500,190000,9500,5
TIKI,do-choi-me-be,68354444,"Tai nghe Bluetooth F9 TWS pin trâu sạc nhanh, chống nước",61000,79000,18000,23
TIKI,lam-dep-suc-khoe,70662253,"Kem Chống Nắng Không Màu Kiểm Soát Dầu La Roche-Posay Anthelios XL Dry Touch Gel-Cream SPF 50+ UVB & UVA (50ml)",420000,560000,140000,25
TIKI,lam-dep-suc-khoe,181097570,"Tinh Chất Dưỡng Sáng Da Laneige Radian-C Vitamin Spot Serum 10g",729000,750000,21000,3
TIKI,lam-dep-suc-khoe,183558378,"Xịt Khử Mùi Hôi Nách SAKITO LANCEJ - Khử Mùi Hôi Nách, Hôi Chân, Thâm Nách, Ra Mồ Hôi Nách - Thành Phần Từ Thiên Nhiên | Dung Tích 50ml - HÀNG CHÍNH HÃNG",90000,180000,90000,50
TIKI,do-choi-me-be,59306865,"Tai nghe KZ ZSN Pro X - Bản nâng cấp tốt hơn, đẹp hơn có micro - Hàng chính hãng",389000,389000,0,0
TIKI,do-choi-me-be,21316309,"Chuột quang không dây Fuhlen A09 - Hàng Chính Hãng",139000,139000,0,0
TIKI,lam-dep-suc-khoe,141470343,"Cold wax an lành - Wax lông - Tẩy lông - Tặng 50 tờ giấy và 2 que wax",90000,90000,0,0
TIKI,lam-dep-suc-khoe,93514280,"Máy Massage Cầm Tay Đa Năng Cao Cấp KINGTECH LUX-900 - Mát Xa Toàn Thân, Chuyên Sâu Cho Lưng, Cổ, Vai, Gáy Cánh Tay - Chính Hãng",1100000,1750000,650000,37
TIKI,do-choi-me-be,81613252,"Micro Karaoke Bluetooth cao cấp PKCB Chính Hãng",990000,2300000,1310000,57
TIKI,do-choi-me-be,143860118,"Sạc dự phòng 20000mAh sạc nhanh không dây 15W Remax RPP-207 sạc nhanh 22.5W QC3.0 - Hàng chính hãng",619550,900000,280450,31
TIKI,do-choi-me-be,157490476,"Bút Vệ Sinh Tai Nghe Bluetooth 3 Trong 1 Cao Cấp MIFAN - Làm sạch bụi bẩn trong hộp đựng, loa, cổng sạc, điện thoại - Hàng chính hãng",100000,100000,0,0
TIKI,do-choi-me-be,53547999,"Miếng lót chuột hình tròn siêu dễ thương - Hàng chính hãng",12000,12000,0,0
TIKI,do-choi-me-be,74498670,"Bộ sạc nhanh 20W USB Type C Baseus Super SI Quick Charger QC3.0 cho iPhone 12 (1C, 20W, Chân dẹt) - Hàng chính hãng",142898,142898,0,0
TIKI,do-choi-me-be,153821917,"Đồng hồ Thông minh Gọi Video Call 4G, GPS, Wifi Chống nước Định vị Chuẩn AMA Watch LT36 có 3 màu Đen Hồng Xanh Hàng nhập khẩu",1050000,1050000,0,0
TIKI,lam-dep-suc-khoe,63793228,"Máy Khuếch Tán Tinh Dầu Siêu Âm Loại Lớn có Đèn LED đổi màu Và Remote Điều Khiển Cao Cấp",169000,338000,169000,50
TIKI,lam-dep-suc-khoe,175814174,"Khẩu Trang Y Tế Hàn Quốc KF94 Chính Hãng ANYGUARD, Lọc Bụi Mịn lên tới PM 2.5, 4 Lớp Ngăn 99% Vi Khuẩn, An Toàn Cho Da Nhạy Cảm (Hộp 20 Chiếc), Dành Cho Người Lớn",130000,130000,0,0
TIKI,do-choi-me-be,418620,"Bộ Bàn Phím Và Chuột Có Dây Logitech MK200 - Hàng Chính Hãng",298000,298000,0,0
TIKI,do-choi-me-be,144803533,"Chuột không dây bluetooth Logitech POP Mouse - Hàng chính hãng",579000,579000,0,0
TIKI,do-choi-me-be,109988967,"Chuột không dây HXSJ T15 wireless 2.4G tự sạc pin siêu mỏng không gây tiếng ồn chuyên dùng cho Máy tính, pc, Laptop, Tivi - Hàng chính hãng",179000,349000,170000,49
TIKI,do-choi-me-be,73406907,"Tai Nghe Không Dây Chống Nước Ipx5, Tai Nghe Nhét Tai Mini Bluetooth PKCB - Hàng Chính Hãng",250000,500000,250000,50
TIKI,do-choi-me-be,112734786,"Giá Đỡ Để Bàn Dành Cho Máy Tính Bảng, Ipad T003 - Chất Liệu Hợp Kim Nhôm Cao Cấp Hàng Chính Hãng Tamayoko",279000,279000,0,0
TIKI,lam-dep-suc-khoe,52216318,"Combo 3 Kem Đánh Răng Closeup Dạng Gel Trắng Răng Diamond Attraction Ngay Sau 1 Lần Chải 100G/Tuýp",117000,117000,0,0
TIKI,do-choi-me-be,158641574,"[xả hàng cuối năm]Tai nghe nhét tai có Mic Texet-Crossloop E3169 hàng nhập khẩu",90000,90000,0,0
TIKI,do-choi-me-be,178735823,"Tai Nghe Nhét Tai Đa Năng HuQu HQ-ProX6 Kiêm Sạc Không Dây Cho Điện Thoại Di Động -Hàng Chính Hãng",750500,790000,39500,5
TIKI,do-choi-me-be,272420302,"Cáp sạc thay thế cho các dòng đồng hồ Garmin Fenix 7, Fenix 6, Fenix 5, Forerunner 955, 945, 935, 245, 265, 255, 45, 645, Instinct, Viviactive 3, Venu/ Garmin Epix Gen 2- Hàng Chính Hãng",71000,79000,8000,10
TIKI,do-choi-me-be,47466797,"Đầu cắm cho sạc Macbook, Ipad dạng 2 chấu chân dẹt",28000,28000,0,0
TIKI,do-choi-me-be,45608421,"Bao Da Cover Dành Cho Apple Ipad 10.2 Inch 2019 Vân Da Tuần Lộc",133900,133900,0,0
TIKI,do-choi-me-be,114271326,"Tai nghe Bluetooth F9 Pro V5.0 cảm biến vân tay",59000,79000,20000,25
TIKI,do-choi-me-be,45464404,"Đồng hồ báo thức điện tử thông minh để bàn mini DH89",52000,52000,0,0
TIKI,do-choi-me-be,214802387,"Quạt tản nhiệt MEMO DL05 - Thiết bị hạ nhiệt gaming dành cho điên thoại siêu lạnh, hiển thị nhiệt độ, LED RGB, Kẹp thu vào 2 chiều - Hàng Nhập Khẩu",219000,250000,31000,12
TIKI,dien-gia-dung,116875360,"Bộ lọc nước thô đầu nguồn 3 cấp lọc 10 inch by Scitech - Hàng chính hãng",590000,590000,0,0
TIKI,dien-gia-dung,43926404,"Máy hút bụi công nghiệp dạng nhỏ Sumika K20, Màu Vàng, 20L, 1600W, Có thể hút nước, Motor Ametek của Mỹ, Tầng lọc HEPA, Dây điện dài 10m, Thùng chứa Thép không gỉ - Hàng Chính Hãng",1550000,2100000,550000,26
TIKI,dien-gia-dung,137599677,"Phụ kiện màng lọc dành cho Robot hút bụi  T5 Hero, Max, Power, T8, T9, N8, N5, Ozmo 920, Ozmo 950",20000,20000,0,0
TIKI,dien-gia-dung,151544862,"Phụ kiện thay thế cho robot hút bụi lau nhà tự đổ rác Neabot N2 và N2 lite",60000,60000,0,0
TIKI,dien-gia-dung,50693514,"LÕI LỌC TOSHIBA F-1643-PP- Hàng chính hãng",160000,160000,0,0
TIKI,dien-gia-dung,126996485,"Máy hàn miệng túi dập tay, đường hàn rộng 2mm dài 200/250/300/400(mm)",199000,199000,0,0
TIKI,dien-gia-dung,139732276,"Máy Làm Sữa Đậu Nành, Sữa Hạt Lock&Lock EJS226 (1.3L) Hệ Thống Gia Nhiệt Tự Động Và Chống Tràn - Hàng Chính Hãng Tặng Combo Ống Hút + Cọ Rửa",1860000,3384000,1524000,45
TIKI,dien-gia-dung,8420031,"Bếp Điện Từ Đôi Kangaroo KG498N (3100W) - Hàng chính hãng",2230000,4720000,2490000,53
TIKI,dien-gia-dung,193013426,"Quạt Cầm Tay Mini Tích Điện Teement, Có Giá Đở Điện Thoại, Sạc USB Di Động Tiện Lợi - Hàng Chính Hãng",99000,99000,0,0
TIKI,dien-gia-dung,171856533,"Máy Xay Thịt 2 Lưỡi Kép BlueStone CHB-5145 (2 Lít) - Hàng chính hãng",715000,1299000,584000,45
TIKI,dien-gia-dung,262606222,"Bình Đun Nước Đa Năng, Bình Pha Trà Thông Minh BEAR YSH-C15Q5 Dung Tích 1.5 Lít Công Suất 1000 W - Hàng Chính Hãng",1199000,2199000,1000000,45
TIKI,dien-gia-dung,178462957,"Máy ép tóc Philips HP8401/00 - Sử dụng dễ dàng - An toàn - Chính hãng",655000,655000,0,0
TIKI,dien-gia-dung,123772063,"Máy Pha Cà Phê BEAR KFJ-A02N1 Pha Nespresso, Americano, Cappuccino Tạo Bọt Sữa Dễ Dàng Có Tạo Bọt Sữa Dung Tích 240 ML Công Suất 800 W - Hàng Chính Hãng",1349000,2689000,1340000,50
TIKI,dien-gia-dung,112020006,"Bộ phụ kiện kết nối bộ lọc thô, bộ lọc nước sinh hoạt 10 inch ren 13/21 - Hàng chính hãng",105000,105000,0,0
TIKI,dien-gia-dung,192894253,"Nồi Lẩu Điện Đa Năng OENON Chống Dính Vân Đá Tự Động Ngắt Điện Khi Đủ Nhiệt - Hàng Chính Hãng",439000,800000,361000,45
TIKI,dien-gia-dung,66878177,"Bản ủi hơi nước - Bàn là hơi nước cầm tay TLK - BL02 công suất 1500w dung tích 280ml (Hàng Chính Hãng)",688000,688000,0,0
TIKI,dien-gia-dung,20046513,"Quạt treo tường remote Senko Hàng Chính Hãng - TR1428 - Giao màu ngẫu nhiên",490000,490000,0,0
TIKI,dien-gia-dung,273217576,"Máy Vắt Cam Lock&Lock EJJ231 (40W) - Hàng chính hãng",249000,452000,203000,45
TIKI,dien-gia-dung,58570537,"Máy vắt cam 0.7lit LB389 Lebenlang (Hàng nhập khẩu)",209000,380000,171000,45
TIKI,dien-gia-dung,171874399,"Máy ép chậm KIPOR KP-SJ595 - Chân đế chống rung lắc - Tặng lưới làm kem - Động cơ đồng nguyên chất công suất lớn -Hàng chính hãng",2592000,3899000,1307000,34
TIKI,dien-gia-dung,144162573,"[Loại Tốt] Máy Hút Chân Không KhoNCC Hàng Chính Hãng - Đa Năng Có Hàn Ép Miệng Túi Thực Phẩm - KLVQ-5233-MECK",219000,318000,99000,31
TIKI,dien-gia-dung,146365126,"Combo 2 Lẫy gài mở nắp nồi cơm điện tử 10NMF/18NMF",138000,138000,0,0
TIKI,dien-gia-dung,162841493,"Máy cạo râu khô và ướt Philips S1301/02 - Hàng Chính Hãng",755000,990000,235000,24
TIKI,dien-gia-dung,110255220,"Ấm đun nước siêu tốc Elmich Smartcook ICS-3859 (1.7 Lít) - Hàng chính hãng",299000,579000,280000,48
TIKI,lam-dep-suc-khoe,78509478,"Combo 3 Tinh Dầu Oải Hương + Tinh Dầu Bạc Hà + Tinh Dầu Vỏ Quế Nguyên Chất - Tinh Dầu TIDAMO Cao Cấp Xông Phòng Giúp Thư Giãn, Thơm Phòng Và Nâng Cao Sức Khỏe (3 chai 10ML)",118000,236000,118000,50
TIKI,dien-gia-dung,177482641,"Bộ Lọc Hepa Cho Máy Hút Bụi DAMAS XC628 - Hàng chính hãng",79000,150000,71000,47
TIKI,lam-dep-suc-khoe,44810580,"Bộ Dầu Gội Xả Hỗ Trợ Trị Rụng Tóc Kích Thích Mọc Tóc Weilaiya Tinh Chất Gừng Hà Thủ Ô Cao Cấp Ngăn Ngừa Rụng Tóc Lưu Thông Mạch Máu Hương Thảo Dược (Gội 400ml- Xả:250ml)- Sản Phẩm Chính Hãng",550000,685000,135000,20
TIKI,dien-gia-dung,77200428,"Máy Xay Thịt Cối Thủy Tinh Lock&Lock Meat Chopper EJM156BLK 1 Lít - Hàng Chính Hãng, 4 Lưỡi Dao Cho Lực Nghiền Mạnh, Công Suất 400W",499000,1000000,501000,50
TIKI,dien-gia-dung,179372625,"Máy Ép Chậm Hurom H310A - Hàng Chính Hãng",6140000,8900000,2760000,31
TIKI,dien-gia-dung,135217240,"Đầu lọc nước 5 thỏi trực tiếp tại vòi",99000,99000,0,0
TIKI,dien-gia-dung,444670,"Bàn Ủi Khô Electrolux EDI2004 - Trắng Xanh - Hàng chính hãng",330000,370000,40000,11
TIKI,dien-gia-dung,70823166,"Máy Duỗi Tạo Kiểu Tóc Panasonic EH-HV11-P645 - Hàng Chính Hãng",633000,710000,77000,11
TIKI,lam-dep-suc-khoe,878393,"Tỏi Kim Cương Đông Á túi 500g- Tỏi đen cô đơn SX theo công nghệ Nhật Bản -Kiểm nghiệm chất lượng bởi Bộ Y Tế, Intertek",495000,560000,65000,12
TIKI,dien-gia-dung,141479794,"Máy hút bụi cầm tay mini không dây",295000,295000,0,0
TIKI,lam-dep-suc-khoe,12146976,"EUCERIN GEL RỬA MẶT DÀNH CHO DA NHỜN MỤN EUCERIN PROACNE CLEASING 200ML",276000,369000,93000,25
TIKI,lam-dep-suc-khoe,11588613,"[HSD 12/2024] Kẹo dẻo Vitamin C vị cam, tăng đề kháng, giảm cảm cúm, sáng da NAT C YUMMY GUMMYZ (Hộp 25 gói x 2 viên) (Hộp 50 viên)",118000,140000,22000,16
TIKI,dien-gia-dung,73912559,"Bếp nướng điện Lebenlang LBG8588 - Thương hiệu của CHLB Đức",999000,999000,0,0
TIKI,lam-dep-suc-khoe,204009169,"Dung dịch vệ sinh nam Bergami for Man - Ngăn mùi suốt 12h",65000,100000,35000,35
TIKI,lam-dep-suc-khoe,58530142,"Kem Dưỡng Trắng Da Ban Đêm Oribe Dưỡng Ẩm Làm Mờ Thâm Nám Làm Mờ Tàn Nhang 30g",280000,320000,40000,13
TIKI,dien-gia-dung,94997508,"Máy Là, Ép, Uốn Tóc Cao Cấp TẶNG KÈM 02 Lược Chải Tóc Đa Năng 3 Trong 1 Cao Cấp Sang Trọng - Dùng Cho Salon Tóc & Tại Nhà – Chính Hãng VinBuy",233000,450000,217000,48
TIKI,lam-dep-suc-khoe,201816436,"Bàn Chải Điện Halio Sonic Whitening Toothbrush Pro",1079000,1550000,471000,30
TIKI,lam-dep-suc-khoe,7690641,"Thiên Môn Bổ Phổi Bình Đông – Giúp giảm ho, Bổ phổi – Chai 280ml",74000,74000,0,0
TIKI,dien-gia-dung,138514272,"Máy lọc không khí Lock&lock Air purifier ENP124WHT (50W) Màu trắng - Hàng chính hãng",5200000,8860000,3660000,41
TIKI,dien-gia-dung,393735,"Nồi Cơm Điện Midea CM06SA (0.6 Lít) - Hàng Chính Hãng",474000,599000,125000,21
TIKI,dien-gia-dung,102084954,"QUẠT SẠC TÍCH ĐIỆN BẰNG CỔNG CẮM USB DP 7626 - CÓ ĐÈN ĐỂ BÀN TIỆN DỤNG",230900,230900,0,0
TIKI,lam-dep-suc-khoe,124229151,"Bao Cao Su LifeStyles Love Time Cao Cấp Kéo Dài Thời Gian Hộp 3 bao",42000,50000,8000,16
TIKI,lam-dep-suc-khoe,271473752,"Mầm đậu nành điều hòa nội tiết Healthy Care Super Lecithin 100 viên",234000,265000,31000,12
TIKI,lam-dep-suc-khoe,82721610,"Máy Tăm Nước LocknLock Oral Irrigator ENR111BLU - Màu Xanh Dương",1120000,1584000,464000,29
TIKI,lam-dep-suc-khoe,158849015,"Xịt thơm miệng Nerman Cool Smile 2 hương Ice Coffee & Lemon Ice 10ml/chai",169000,210000,41000,20
TIKI,dien-gia-dung,135753939,"Quạt Mini Đeo Cổ - Quạt Đeo Cổ Mini USB gió siêu mát thế hệ mới giải cứu mùa hè",63505,63505,0,0
TIKI,lam-dep-suc-khoe,85701615,"KỀM CẮT DA INOX",165000,165000,0,0
TIKI,lam-dep-suc-khoe,91864374,"Set 5 Cây Son Kem Lì VONGEE Mịn Mượt Như Nhung Và Không Khô Môi",59000,95000,36000,38
TIKI,lam-dep-suc-khoe,1313881,"Kem chống nắng Skin Aqua dưỡng trắng & dưỡng ẩm, dùng hàng ngày dạng gel Sunplay Skin Aqua Silky White Gel Eco Việt Nam SPF 50, PA++++ 30g",88200,109000,20800,19
TIKI,lam-dep-suc-khoe,158091977,"Tinh Dầu Hoa Nhài TIDAMO 100ML Nhập Khẩu, Có Kiểm Nghiệm, Hương Thơm Dịu Nhẹ Quý Phái - Tinh Dầu Hoa Lài (Jasmine) Xông Thơm Phòng, Thư Giãn và Tốt Cho Sức Khỏe",193800,398000,204200,51
TIKI,lam-dep-suc-khoe,15520057,"Tinh chất chống lão hóa Hada Labo Pro Anti Aging α Lifting Essence 30g",259000,322000,63000,20
TIKI,lam-dep-suc-khoe,109691576,"Máy rửa mặt sóng âm Xiaomi inFace MS2000pro (Gen 2) - Hàng chính hãng",349000,349000,0,0
TIKI,lam-dep-suc-khoe,25444067,"Son kem lì Bbia Last Velvet Lip Tint - 25 Final Note 5g (màu cam nâu đất)",150000,290000,140000,48
TIKI,lam-dep-suc-khoe,157993488,"Gel Tẩy Tế Bào Chết Thông Minh Ngăn Ngừa Mụn, Caryophy Smart Peeling Gel",450000,450000,0,0
TIKI,lam-dep-suc-khoe,13933311,"Kem Nghệ Dưỡng Da Mụn Thorakao 7g ",31000,31000,0,0
TIKI,lam-dep-suc-khoe,12056666,"Lăn Khử Mùi Etiaxil Detranspirant Traitement Aisselles Peaux Normales 15ml (Dành cho da thường)",179000,179000,0,0
TIKI,dien-gia-dung,173425151,"Nồi Nấu Chậm 0,8L Bear SUBE001 Đa Năng Nấu Cháo, Chưng Yến Bản Quốc Tế - Hàng Chính Hãng",400000,448000,48000,11
TIKI,lam-dep-suc-khoe,89128457,"Máy mài gót chân USB kèm đầu mài (giao màu ngẫu nhiên )",73000,157653,84653,54
TIKI,lam-dep-suc-khoe,50308042,"Goodhealth Oyster Plus Tinh Chất Hàu 60 Viên - Tăng Cường Sinh Lý - Cải Thiện Chất Lượng Tinh Trùng - Hàng Chính Hãng New Zealand",348000,499000,151000,30
TIKI,lam-dep-suc-khoe,140174824,"Khẩu Trang Y Tế Cao Cấp 4D SUN CLOUD (Hộp 20 Cái) - 99% Lọc Khuẩn, Bụi, Virus, Ôm Khít Mặt, Không Đau Tai, Không Lem Son",34800,34800,0,0
TIKI,lam-dep-suc-khoe,81014564,"Sữa rửa làm dịu da mặt ngừa mụn Caryophy Portulaca 150ml",390000,390000,0,0
TIKI,lam-dep-suc-khoe,68176012,"Khẩu trang than hoạt tính GP Extreme (Mẫu mới, nhiều màu để lựa chọn)",50000,50000,0,0
TIKI,lam-dep-suc-khoe,28517939,"Viên uống Tinh Chất Hàu biển OB - Tăng cường sinh lý nam, Bổ Thận, Tăng Chất Lượng Tinh Trùng, hộp 30v",329000,379000,50000,13
TIKI,dien-gia-dung,177196981,"Lưỡi thay thế cho Máy cạo râu Enchen Blackstone",99000,99000,0,0
TIKI,lam-dep-suc-khoe,33606875,"Sữa rửa mặt trị mụn và se khít lỗ chân lông Paula’s Choice Clear Pore Normalizing Cleanser 177 ml",489000,579000,90000,16
TIKI,lam-dep-suc-khoe,78983485,"Combo 3 Kem đánh răng Closeup Trắng Răng Tự Nhiên Acai Berry detox 230 g",123000,153000,30000,20
TIKI,lam-dep-suc-khoe,153597872,"Son thỏi dưỡng môi trang điểm chất son satin Lip On Lip Glowy Satin 2.2g",134000,166000,32000,19
TIKI,lam-dep-suc-khoe,170066594,"Combo 3 Hộp Khẩu trang Bông Bạch Tuyết 3 lớp trắng (50 cái/hộp)",177000,177000,0,0
TIKI,lam-dep-suc-khoe,138773725,"￼Bộ 4 lô Cuốn Tóc Xoăn Dính loại lớn, giá tốt - giao màu ngẫu nhiên ",30000,40000,10000,25
TIKI,lam-dep-suc-khoe,7331189,"Son Dưỡng Môi DHC Lip Cream 1,5g",182000,199000,17000,9
TIKI,lam-dep-suc-khoe,129521118,"Kem Dưỡng Da Mờ Thâm Nám, Tàn Nhang Fixderma Skarfix-TX Cream 15g",220000,275000,55000,20
TIKI,lam-dep-suc-khoe,184042484,"Combo Sữa Rửa Mặt và Serum Mugung Dưỡng da 24k xóa thâm nám chống lão hóa chứa Vitamin C,E, collagen",400000,400000,0,0
TIKI,lam-dep-suc-khoe,1313877,"Kem chống nắng Sunplay cho bé từ 6 tháng tuổi và da nhạy cảm, dạng sữa Sunplay Baby Mild SPF 35, PA++ 30g",79000,97000,18000,19
TIKI,lam-dep-suc-khoe,19901553,"Máy Rửa Mặt Halio Sensitive Facial Device Dành Cho Da Nhạy Cảm - Sóng Âm Sạch Sâu, Kèm Hộp Treo",699000,849000,150000,18
TIKI,lam-dep-suc-khoe,141740797,"Kem đánh răng Colgate ngừa sâu răng tối đa 225g tặng bàn chải",58000,58000,0,0
TIKI,lam-dep-suc-khoe,36158810,"Bộ tắm trắng toàn thân Truesky gồm 1 kem ủ trắng toàn thân 100g và 1 kem dưỡng trắng toàn thân 100g",320000,320000,0,0
TIKI,lam-dep-suc-khoe,6583921,"Combo Sữa Tắm L'amont En Provence Shower Gel Hương Almond + Olive (500ml / Chai)",175000,280000,105000,38
TIKI,dien-gia-dung,26078293,"Quạt đứng Toshiba F-LSA10(H)VN (50W) - Xám - Hàng chính hãng",907000,1080000,173000,16
TIKI,lam-dep-suc-khoe,49310524,"Combo 2 tuýp  kem ngăn ngừa mụn thiên nhiên yoosun acnes  15g - XẸP MỤN NGAY, BAY THÂM SẸO ",79800,79800,0,0
TIKI,lam-dep-suc-khoe,2835905,"MỠ TRĂN NGUYÊN CHẤT 100ml triệt lông, bôi bỏng",88888,99000,10112,10
TIKI,lam-dep-suc-khoe,55108911,"Combo 2 Sữa Tắm Rose 500ml- L'amont En Provence",189000,298000,109000,37
TIKI,lam-dep-suc-khoe,89792676,"Dung Dịch Vệ Sinh Phụ nữ Lactacyd Odor Fresh Ngăn Mùi 24H 250ml",89000,89000,0,0
TIKI,lam-dep-suc-khoe,158138623,"Khẩu Trang KF94 4D SKY MASK Hàn Quốc - Chống Bụi Mịn Và Kháng Khuẩn (1 gói 10 cái) - Chọn màu",8800,8800,0,0
TIKI,lam-dep-suc-khoe,94098195,"Khẩu trang 4D kháng khuẩn Hello Mask Fashion - Premium",45900,45900,0,0
TIKI,lam-dep-suc-khoe,140586253,"INFLUPROP Austria, Nasal Spray Dung dịch xịt sương giúp hỗ trợ điều trị viêm xoang, viêm mũi,  phòng ngừa vi khuẩn, virus, tạo màng niêm mạc bảo vệ lành nhanh vết thương, dưỡng ẩm, chống ngạt sổ mũi, ngưng chảy dịch mũi. Nhập khẩu Châu Âu",199000,259000,60000,23
TIKI,lam-dep-suc-khoe,21024823,"Gel nghệ Nano siêu hấp thu Decumar New (20g) - Ngừa mụn, Giảm thâm sẹo, Kiểm soát nhờn",75000,75000,0,0
TIKI,lam-dep-suc-khoe,12114846,"Xịt họng thảo dược giúp giảm ho, đau rát họng EUGICA MOUTH SPRAY (Chai/10ml)",58000,65000,7000,11
TIKI,lam-dep-suc-khoe,74593902,"ComBo 10 Chiếc Khẩu Trang Trẻ Em KF94 - Form 3D Cao Cấp Chống Bụi Siêu Mịn 0.4um Anyguard Hàn Quốc Chính Hãng - 4 Lớp - 베이비 마스크 - Face Mask For Kids-ISO 9001:2015, ISO 13485:2016, QCVN 01:2017/BTC",59500,85000,25500,30
TIKI,lam-dep-suc-khoe,102751945,"Dầu gội Head&shoulders Clinical Strength Proven Relief 400ml - USA",299000,299000,0,0
TIKI,lam-dep-suc-khoe,2623229,"Sữa Rửa Mặt SVR Sebiaclear Gel Moussant  (50ml)",108000,145000,37000,26
TIKI,lam-dep-suc-khoe,57855825,"Kem Nền Che Khuyết Điểm Kiềm Dầu Mịn Nhẹ Chống Nắng DD Cream Oribe 25g",280000,320000,40000,13
TIKI,lam-dep-suc-khoe,20365497,"Dụng cụ massage Mũi xuất Nhật , nâng mũi tự nhiên, cánh mũi thon gọn SLine hotgirl",9000,9000,0,0
TIKI,lam-dep-suc-khoe,92159183,"Combo 2 hộp Bao cao su Durex Fetherlite Ultima 12 Bao",438000,608000,170000,28
TIKI,lam-dep-suc-khoe,190630654,"Sữa Rửa Mặt Dịu Nhẹ Cho Da Khô CeraVe SA Smoothing Cleanser 236ml",313000,330000,17000,5
TIKI,lam-dep-suc-khoe,75639107,"Nước súc miệng hàng ngày chiết xuất thiên nhiên giúp Ngăn ngừa vi khuẩn Ngăn ngừa màng bám Cải thiện viêm nướu, viêm nha chu AMFAGOLD Care DAILY USE 250ml",75000,75000,0,0
TIKI,lam-dep-suc-khoe,52637902,"Dầu Gội Sạch Gàu Antisol pH6.5 Chiết Xuất Dược Liệu Ngăn Ngừa Gàu, Rụng Tóc, Ngứa Da Đầu Tái Phát - Chai 240ml - Thương Hiệu iCare Pharma",283000,320000,37000,12
TIKI,lam-dep-suc-khoe,460386,"Sữa Tắm Lifebuoy Sạch Khuẩn Chăm Sóc Da Ngăn Ngừa Vi Khuẩn Lây Lan Với Ion Bạc+ Hỗ Trợ Cùng Đề Kháng Da Tự Nhiên Túi 800G",119000,119000,0,0
TIKI,lam-dep-suc-khoe,23368395,"Bộ 3 Cây Que Nặn Mụn Bằng Thép Cao Cấp Không Gỉ Gồm 5 Đầu Chuyên Dụng  Có Nhíp Gắp Cực Kì An Toàn (Full Box) - MP041",52600,52600,0,0
TIKI,lam-dep-suc-khoe,177424215,"Cân Điện Tử Sức Khoẻ Thông Minh Mặt Vuông Kính Cường Lực Chịu Lực Màu Đen Sang Trọng 180Kg Deli - Phù Hợp Gia Đình Trường Học - Hàng Chính Hãng - E86120",159000,322200,163200,51
TIKI,lam-dep-suc-khoe,116369227,"Khẩu trang 3D mask Long Hưng công nghệ Nhật Bản chống bụi mịn cao cấp hộp đóng 50 cái",48000,65000,17000,26
TIKI,lam-dep-suc-khoe,48209944,"Bộ sản phẩm tan mỡ bụng an toàn và hiệu quả Truesky gồm 1 kem tan mỡ bụng quế gừng 100g + 1 đại nịt bụng quấn nóng",250000,250000,0,0
TIKI,lam-dep-suc-khoe,118896592,"Nến thơm tinh dầu cao cấp không khói an toàn Candle Cup - ĐÀ LẠT - S - 100G (KG NẮP)",120000,120000,0,0
TIKI,lam-dep-suc-khoe,195210591,"Tinh dầu Bưởi Ngọt 24Care 100ML - Chiết xuất thiên nhiên, khử mùi, thơm phòng, thư giãn tinh thần",75000,75000,0,0
TIKI,lam-dep-suc-khoe,2075159,"Gel hỗ trợ điều trị Mụn Thâm Neocurma (20g)",118000,118000,0,0
TIKI,lam-dep-suc-khoe,654647,"Nước uống giải rượu, thải độc gan Alcofree lốc 3 chai x 50ml",125000,141000,16000,11
TIKI,lam-dep-suc-khoe,114230314,"Kem hỗ trợ giảm mụn Differin Cream 0.1% Adapalene tuýp 30 gram(Hàng nội địa Pháp)",299000,450000,151000,34
TIKI,lam-dep-suc-khoe,41523006,"Máy đo huyết áp điện tử bắp tay Sinoheart BA-801 Đức",255000,325000,70000,22
TIKI,lam-dep-suc-khoe,186633014,"Tinh Dầu Sả Chanh Tự Nhiên Nguyên Chất 10ml Hapaku",109000,120000,11000,9
TIKI,lam-dep-suc-khoe,7222235,"Kem chống nắng đa năng siêu nhẹ không bết dính Paula’s Choice Resist Super -Light Daily Wrinkle Defense SPF30 60ml",759000,950000,191000,20
TIKI,lam-dep-suc-khoe,173401401,"Máy Khuếch Tán Tinh Dầu Có Loa Bluetooth Nghe Nhạc Cực Hay, Máy Xông Tinh Dầu Chuyên Dụng, Có Remote Điều Khiển Và Đèn LED 7 Màu",287300,668000,380700,57
TIKI,lam-dep-suc-khoe,114467131,"Bộ dụng cụ lấy ráy tai chuyên nghiệp,dụng cụ lấy ráy tai người lớn,dụng cụ lấy ráy tai thông minh cho bé kèm dây đeo BaoAn- Nhiều mẫu lựa chọn -Hàng Chính Hãng - Màu hộp giao ngẫu nhiên",55900,69000,13100,19
TIKI,lam-dep-suc-khoe,164880017,"Viên uống tinh dầu bạc hà, thì là, cải thiện tiêu hóa, giảm đau bụng, khó tiêu, đầy hơi UNOMINT Mega We Care (10 viên)",50000,60000,10000,17
TIKI,lam-dep-suc-khoe,161451877,"Dung dịch vệ sinh mũi Nose Hygiene Spray",85000,85000,0,0
TIKI,lam-dep-suc-khoe,176571783,"Hoạt huyết dưỡng não - Hộp 100 viên bao đường - tuần hoàn não, Dược Đại Uy, từ đinh lăng, bạch quả",15000,49000,34000,69
TIKI,thiet-bi-kts-phu-kien-so,8286521,"Đế kẹp 2in1 điện thoại máy tính bảng tablet ipad gắn chân máy ảnh tripod",31900,31900,0,0
TIKI,lam-dep-suc-khoe,33761260,"Bao Cao Su Kéo Dài Thời Gian Quan Hệ và Có Gai Innova Đen - Hộp 3 Cái",39000,39000,0,0
TIKI,lam-dep-suc-khoe,105618884,"Tinh Dầu Xông Phòng Chai Lớn 100ML, Tự Chọn Mùi | Chính Hãng TIDAMO, Chiết xuất Tự Nhiên, Có Kiểm Nghiệm | Xông Thơm Phòng, Thư Giãn và Bảo Vệ Sức Khỏe",119000,356000,237000,67
TIKI,thiet-bi-kts-phu-kien-so,96466997,"Chuột Game Có Dây XSmart FREE WOLF V5 LED 7 màu cực đẹp chuyên gaming, siêu bền, chỉnh được dpi - Hàng Chính Hãng",129000,129000,0,0
TIKI,thiet-bi-kts-phu-kien-so,6917335,"Bình xịt khí nén vệ sinh bàn phím Macbook",100000,100000,0,0
TIKI,thiet-bi-kts-phu-kien-so,195444597,"Thẻ Nhớ MicroSDXC SanDisk Extreme V30 A2 128GB 190MB/s SDSQXAA-128G (New 2022) - Hàng Nhập Khẩu",315000,315000,0,0
TIKI,thiet-bi-kts-phu-kien-so,196675011,"Tai Nghe Dẫn Xương Huqu HQ-HS2 - Giảm Ồn Hiệu Quả - Hàng Chính Hãng .",780000,780000,0,0
TIKI,thiet-bi-kts-phu-kien-so,70895043,"      Sạc Dự Phòng 15000mAh Đa Năng 18W Remax RPP-20 - Hàng Chính Hãng",729000,729000,0,0
TIKI,thiet-bi-kts-phu-kien-so,173137800,"Thẻ Nhớ Micro SDXC Samsung Evo Plus U3 130MB/s 512GB New - Hàng Nhập Khẩu",850000,850000,0,0
TIKI,thiet-bi-kts-phu-kien-so,113078398,"Hộp Đựng Tai Nghe, Cáp Sạc, Pin Sạc Dự Phòng, Ổ Cứng, Cáp USB, Pin Dự Phòng – Túi Đựng Củ Sạc Điện Thoại Đồng Hồ Thông Minh Bảo Vệ Phụ Kiện Di Động LapTop Hàng Chính Hãng miDoctor",55000,55000,0,0
TIKI,thiet-bi-kts-phu-kien-so,120364526,"Chuột máy tính gaming SIDOTECH G5S chuyên chơi game Esport đèn Led Rgb / 6 Nút Bấm / DPI 3200 / tuổi thọ 30 triệu lần click cao thiết kế công thái học cho game thủ streamer FPS Moba lướt web thiết kế làm việc văn phòng tương  - Hàng chính hãng",89000,89000,0,0
TIKI,thiet-bi-kts-phu-kien-so,47270547,"Ốp lưng dẻo mỏng dành cho iPhone 6 / iPhone 6s - Màu đen",45000,45000,0,0
TIKI,thiet-bi-kts-phu-kien-so,51716152,"Bao da caro nữ kiêm ví cao cấp",99000,179000,80000,45
TIKI,thiet-bi-kts-phu-kien-so,193638840,"Vang số chỉnh cơ Acnos Mi30 – Kết hợp 2 micro không dây UHF – Đầy đủ kết nối bluetooth, Optical (cổng quang), AUX – Thiết kế nhỏ gọn, sử dụng nguồn 5V dễ dàng di chuyển mọi nơi – Kết nối dễ dàng với mọi thiết bị âm thanh – Hàng chính hãng",1890000,1890000,0,0
TIKI,thiet-bi-kts-phu-kien-so,57842537,"Củ Sạc Nhanh Cho Iphone Hoco C80 - Hỗ trợ sạc nhanh 20W PD QC3.0 - Hàng Chính Hãng",139000,209000,70000,33
TIKI,thiet-bi-kts-phu-kien-so,67975846,"Giá đỡ kẹp điện thoại cho xe máy/ xe mô tô C2 - Chống trộm, chống rung lắc, dễ dàng lắp đặt - Hàng chính hãng",36600,36600,0,0
TIKI,thiet-bi-kts-phu-kien-so,33598239,"Ốp lưng chống sốc cho Samsung Galaxy Note 10 Plus hiệu Likgus Crashproof (siêu mỏng, chống chịu mọi va đập) - Hàng nhập khẩu",72706,145412,72706,50
TIKI,thiet-bi-kts-phu-kien-so,74257819,"Tai nghe Bluetooth M9, tai nghe không dây cảm ứng thông minh. âm thanh HiFi trung thực, màn hình hiển thị sắc nét, tích hợp thêm đèn pin soi sáng- Hàng nhập khẩu",230000,230000,0,0
TIKI,thiet-bi-kts-phu-kien-so,77232030,"Tai nghe gaming có Mic, LED AMOI PC68, Tai nghe chuyên game, Tai nghe siêu bass jack 3.5 cổng USB dùng cho PC/Laptop-Hàng chính hãng",170000,170000,0,0
TIKI,thiet-bi-kts-phu-kien-so,193054094,"Case Silicon dành cho Airpods 1,2/ Airpods Pro/ Airpods 3 Hình Mimion_ Hàng Chính Hãng",99000,99000,0,0
TIKI,thiet-bi-kts-phu-kien-so,195891910,"Miếng Lót Chuột Mouse Pad Tròn Dùng Trong Văn Phòng Học Tập Mẫu Hoạt Hình Cute",27550,29000,1450,5
TIKI,thiet-bi-kts-phu-kien-so,21561796,"Tay Cầm Chơi Game Xbox 360 - Trắng",190000,250000,60000,24
TIKI,thiet-bi-kts-phu-kien-so,100868879,"Dây Đeo Thay Thế Dành Cho Đồng Hồ Thông Minh Mi Watch Lite / Redmi Watch",110000,110000,0,0
TIKI,thiet-bi-kts-phu-kien-so,73188683,"Giá Đỡ Máy Tính, Laptop, iPad, Macbook Hợp Kim Nhôm Cao Cấp. Hỗ Trợ Tản Nhiệt Chống Mỏi Cổ, Vai, Gáy. Hàng Chính Hãng Tamayoko",279000,279000,0,0
TIKI,thiet-bi-kts-phu-kien-so,214154015,"Giá Đỡ Dành Cho Điện Thoại, Máy Tính Bảng Chất Liệu Hợp Kim Nhôm Cao Cấp Model T002 - Hàng Chính Hãng Tamayoko",249000,259000,10000,4
TIKI,thiet-bi-kts-phu-kien-so,74730315,"Tai Nghe Gaming Có Mic Rời xMOWI RX3 Dùng Được Cho Cả Máy Tính Và Điện Thoại - Hàng Chính Hãng",99000,139000,40000,29
TIKI,thiet-bi-kts-phu-kien-so,25739052,"Chuột Có Dây Genius DX-110 cổng USB (Màu Đen) - Hàng Nhập Khẩu",125000,125000,0,0
TIKI,thiet-bi-kts-phu-kien-so,15198599," Cục Sạc Pin Điện Thoại Đa Năng - màu ngẫu nhiên",25000,25000,0,0
TIKI,thiet-bi-kts-phu-kien-so,186907112,"[FREE 1 Tháng] Sim MAX DATA 4G VIETNAMOBILE 6GB/Ngày - 180GB/Tháng. Sản Phẩm Độc Quyền VIETNAMOBILE - SIMTHE.VN. Dùng Trên Toàn Quốc - Hàng Chính Hãng",79900,140000,60100,43
TIKI,thiet-bi-kts-phu-kien-so,73753804,"Combo RAVPower Củ Sạc Điện Thoại 2 Cổng 30W RP-PC132 + Dây Cáp Sạc Type-C To C RP-CB047 - Hàng Chính Hãng",399000,750000,351000,47
TIKI,thiet-bi-kts-phu-kien-so,160664361,"Bộ Hub QGeeM USB-C 4 trong1, 1xHDMI 4K, 1xUSB-C 100W PD Charger, 1xUSB 3.0, 1xUSB 2.0, tương thích với MacBook Pro, Dell XPS, iPad Pro, Type-C Adapter - Hàng Chính Hãng",243000,243000,0,0
TIKI,thiet-bi-kts-phu-kien-so,129728774,"Mút đệm tai nghe JBL Tune 500BT",141900,141900,0,0
TIKI,thiet-bi-kts-phu-kien-so,43349411,"Chuột gaming không dây cao cấp ( màu ngẫu nhiên )",59000,59000,0,0
TIKI,thiet-bi-kts-phu-kien-so,130170343,"Cáp Sạc Nhanh Type C SuperVOOC DL129 - Hàng Chính Hãng",133000,133000,0,0
TIKI,thiet-bi-kts-phu-kien-so,96224276,"Tai Nghe Phone Nhét Tai Nghe Nhạc Chơi Game XSmart QKZ AK2 Pro 2021 Mới Nhất Âm Thanh Super Bass, Dây Chống Rối, Có Mic Đàm Thoại Tương Thích Điện Thoại Máy Tính Bảng Laptop PC, Hàng Chính Hãng",99000,99000,0,0
TIKI,thiet-bi-kts-phu-kien-so,149653443,"Giá Đỡ Tản Nhiệt Laptop/ Máy tính bảng/ Ipad để bàn chất liệu hợp kim nhôm loại cao cấp nhất (Giao màu ngẫu nhiên) - Hàng Chính Hãng ",66100,66100,0,0
TIKI,thiet-bi-kts-phu-kien-so,95681214,"Adapter sạc Anker 4 cổng 63W / 45W GaN + PIQ 3.0 PowerPort Atom III Slim Tích Hợp USB Type-C - A2046 - Hàng chính hãng - Đen",1110000,1200000,90000,8
TIKI,thiet-bi-kts-phu-kien-so,90082542,"Tai nghe bluetooth Lanith F9 Pro 5.0 - Tai nghe nhét tai kết nối không dây phiên bản quốc tế - Âm bass êm và sâu, chip AIC chống gây chói tai - Thiết kế thời thượng, hiện đại - Hàng nhập khẩu - TAI0F9PRO",78000,149000,71000,48
TIKI,thiet-bi-kts-phu-kien-so,76474502,"[Loại Tốt] Bút Chỉ Laser Trình Chiếu Điều Khiển Không Dây Từ Xa KhoNCC-R400 2.4ghz Hàng Chính Hãng Dùng Khi Thuyết Trình PowerPoint - KLVQ-BTC-R400-200 (Đen)",206000,206000,0,0
TIKI,thiet-bi-kts-phu-kien-so,96230088,"Lót chuột XSmart đẹp, pad bàn di mouse 21 * 25cm độ dày 2mm đa dạng hình game, giao hàng ngẫu nhiên, may viền chắc chắn, Chính Hãng",9000,9000,0,0
TIKI,thiet-bi-kts-phu-kien-so,15232225,"Loa Vi Tính Mini D-02A 2.0",40510,40510,0,0
TIKI,thiet-bi-kts-phu-kien-so,52889826,"Tai Nghe Bluetooth Không Dây 5.0, AMOI F9, Cảm Ứng Vân Tay, Màn Led Báo Pin, Kháng Nước, Chống Ồn, Âm Thanh Cực Chất - Hàng Nhập Khẩu",64000,78000,14000,18
TIKI,dien-gia-dung,973086,"Quạt Treo Tường Điều Khiển Từ Xa Senko TR1428 (Remote) - Xám - Hàng chính hãng",530000,530000,0,0
TIKI,dien-gia-dung,173276828,"[Hàng Chính Hãng] Máy Xay Sinh Tố Công Nghiệp Uniblend UB-712 Đa Năng - Tiện Dụng",2499000,2950000,451000,15
TIKI,dien-gia-dung,161241966,"Máy xay sinh tố Panasonic MX-MG5351WRA - Hàng chính hãng",1370000,1620000,250000,15
TIKI,dien-gia-dung,253133968,"Nồi Chưng Yến, Nồi Tiềm Thuốc Bắc, Nồi Nấu Cháo Chậm BEAR SUBE002 Gồm 3 Thố Và Khay Hấp,Dung Tích 1.6 Lít Công Suất 200 W - Hàng Chính Hãng",879000,1559000,680000,44
TIKI,dien-gia-dung,171894493,"Máy cạo râu Philips PQ206/18 - Hàng chính hãng",399000,425000,26000,6
TIKI,dien-gia-dung,133650432,"Máy hút bụi cầm tay, máy hút bui trên xe oto Zilano D01",365000,365000,0,0
TIKI,dien-gia-dung,210402680,"Robot Hút Bụi Lau Nhà, Tự Động Giặt Sấy Giẻ, Tự Gom Rác Tự Động Thêm Nước DREAME S10/L10S Ultra, Tạo Bản Đồ Siêu Nhanh, Camera AI, Diện Tích Hoạt Động 200m2, Áp Suất 5300 Pa, Công Suất 75W - Hàng Chính Hãng",9059000,18119000,9060000,50
TIKI,dien-gia-dung,160094786,"Nồi Lẩu Điện Mini KONKA KDZG-8000L Ca Nấu Mì 2 Mức Công Suất, Thiết Kế Đẹp Mắt -HÀNG CHÍNH HÃNG",390000,590000,200000,34
TIKI,dien-gia-dung,273314720,"Bếp gas đơn mặt kính chén nhôm Fujishi FR-268N - Kính xanh - Hàng chính hãng",255000,255000,0,0
TIKI,dien-gia-dung,102007535,"Đầu Vòi Lọc Nước Xoay 360 Độ - Đầu Lọc Gắn Vòi Nước Bồn Rửa Chén Bát",12089,12089,0,0
TIKI,dien-gia-dung,112792230,"Máy cạo râu   Dao Máy Cạo Râu Yandou SCW 301U - Sử dụng pin sạc tiện dụng",82000,82000,0,0
TIKI,dien-gia-dung,53308239,"Máy Xay Thịt Inox Làm Giò Chả, Xay Cua, Xay Cá Midimori MDMR-1200 (1200W) – Hàng chính hãng",1479000,2500000,1021000,41
TIKI,dien-gia-dung,273314841,"Bếp gas đơn mặt kính chén đồng Fujishi FR-268D - Kính xanh - Hàng chính hãng",265000,265000,0,0
TIKI,dien-gia-dung,21980528,"Ấm sắc thuốc bắc điện NodaCook Bát Tràng tự động sắc thuốc không có mâm nhiệt kim loại bên trong ấm 3 lít màu đen - Hàng chính hãng",650000,925000,275000,30
TIKI,dien-gia-dung,165934869,"Nồi Nấu Đa Năng Lẩu Và Hấp 2 Trong 1 BEAR DZG-D80D2 10L Cao Cấp Công Suất 1200 W - Hàng Chính Hãng",1299000,2399000,1100000,46
TIKI,dien-gia-dung,88231301,"Máy hút bụi lau nhà cầm tay Xiaomi Roidmi X20 - Nhập khẩu và phân phối chính hãng, Bản quốc tế, bảo hành 24 tháng",8900000,8900000,0,0
TIKI,dien-gia-dung,127574637,"Máy Xay Thịt Cối Inox 304, 4 Lưỡi Dao Đa Năng, Công Suất 300W, Cối Xay Thịt, Tỏi, Ớt, Rau Củ Quả ",110600,110600,0,0
TIKI,dien-gia-dung,203246988,"Nồi hầm điện ninh cháo cách thủy nồi chưng yến MIDEA Đi kèm tô sứ cao cấp tiệt trùng bình sữa em bé bằng hơi nước Hàng chính hãng",1568000,1639000,71000,4
TIKI,dien-gia-dung,140587780,"Kẹp nướng sandwich Tiross TS9658 - Hàng chính hãng",658000,790000,132000,17
TIKI,dien-gia-dung,73089414,"Máy Hút Bụi Cầm Tay Karcher VC 4s - Hàng Chính Hãng",7151700,7690000,538300,7
TIKI,dien-gia-dung,529093,"Máy Sấy Quần Áo Tiross TS882 (1500W) - Xanh Dương - Hàng chính hãng",2160000,2900000,740000,26
TIKI,dien-gia-dung,126303703,"Máy ép trái cây Philips HR1863 - Hàng chính hãng",3330000,3750000,420000,11
TIKI,dien-gia-dung,115902466,"Lược Điện Chải Thẳng Tóc, Uốn Cụp Tóc Chuyên Nghiệp Tiện Lợi - Máy Uốn Tóc Siêu Tốc Hiện Đại Công Nghệ Hàn Quốc Mới Nhất",71154,74899,3745,5
TIKI,dien-gia-dung,192298202,"Nút nhựa sạc gas mini, 50 nút",38950,38950,0,0
TIKI,dien-gia-dung,107982411,"Nồi Cơm Điện Mini Nagakawa NAG0134 Hồng Trắng - Lòng niêu chống dính- 400W-1L - Hàng Chính Hãng",885000,1090000,205000,19
TIKI,dien-gia-dung,169925548,"Dây Cảm Biến Bếp Hồng Ngoại",8730,8730,0,0
TIKI,dien-gia-dung,366368,"Máy Xay Sinh Tố Comet CM9956 (1.25 Lít) - Hàng Chính Hãng",359000,579000,220000,38
TIKI,dien-gia-dung,11824785,"Nồi Cơm Điện Kangaroo KG823 (1.2 Lít) - Hàng chính hãng",679000,1170000,491000,42
TIKI,dien-gia-dung,73955526,"Máy Lọc Nước Pureit Lavita - CR5240 Chức Năng Làm Nóng Nhiều Cấp Độ Tích Hợp Công Nghệ RO+UV - Hàng Chính Hãng",8125000,12500000,4375000,35
TIKI,dien-gia-dung,181503535,"Quạt điện lưu thông không khí MIDEA Bản màu xanh model GAF20EQ Tạo dòng khí đối lưu thông gió trong phòng 3 Mức gió Hẹn giờ tắt Thiết kế 2 trong 1 Có điều khiển từ xa Hàng chính hãng",1905000,1990000,85000,4
TIKI,dien-gia-dung,112086581,"Máy HÚT BỤI KHÔNG DÂY nhỏ gọn SPEVI Cartoon thế hệ mới, Cổng sạc USB-Pin 1200MaH vệ sinh ôtô, máy tính, bàn phím, hút lông thú cưng, bàn làm việc",310000,310000,0,0
TIKI,dien-gia-dung,113045096,"Ấm Siêu Tốc 2 Lớp Cách Nhiệt Thái Lan 2.5L",73102,73102,0,0
TIKI,dien-gia-dung,51520868,"Nồi Chiên Đa Năng Đảo Chiều 360 độ Nagakawa NAG3301 (6 Lít) - Hàng chính hãng",1740000,4160000,2420000,58
TIKI,dien-gia-dung,730311,"Quạt Sàn Lifan S-18CN - Hàng chính hãng",625000,625000,0,0
TIKI,dien-gia-dung,114467195,"Máy pha cà phê Espresso Zamboo ZB-68CF - màu nâu ",990000,990000,0,0
TIKI,dien-gia-dung,92477737,"Máy vắt cam LEBENLANG model LBC388 600W-400ml Bảo hành 2 năm",1399000,1399000,0,0
TIKI,dien-gia-dung,86630316,"Quạt Trần trang trí tân cổ Châu Âu - Quạt Trần trang trí Phòng Khách, nhà hàng, khách sạn SLY8001",1697400,1697400,0,0
TIKI,dien-gia-dung,57496390,"Lò Vi Sóng Tráng Men Samsung Có Nướng 30L MG30T5018CK - Hàng Chính Hãng",3290000,4290000,1000000,23
TIKI,dien-gia-dung,36978258,"Máy hút bụi  Deerma DX115C  ( Hàng nhập khẩu )",445000,699000,254000,36
TIKI,dien-gia-dung,1919531,"Máy Pha Cà Phê Delonghi EC685.R - Hàng Chính Hãng",5200000,5200000,0,0
TIKI,thiet-bi-kts-phu-kien-so,359480,"Combo chuột phím có dây Logitech MK120 - Hàng chính hãng",214000,214000,0,0
TIKI,thiet-bi-kts-phu-kien-so,19989837,"Bình Xịt Bụi Khí Nén Air Duster Vệ Sinh Laptop Hàng Màu Xanh Cao Cấp - Khí Xịt Cực Mạnh",98000,98000,0,0
TIKI,thiet-bi-kts-phu-kien-so,2993273,"Sim Du Lịch 35 Nước Châu Âu Three-Mẫu ngẫu nhiên",479000,479000,0,0
TIKI,thiet-bi-kts-phu-kien-so,252906668,"Case Silicon dành cho Airpods 3/ Airpods Pro 2 Hình Rồng Răng Sún_ Hàng Chính Hãng",80750,85000,4250,5
TIKI,thiet-bi-kts-phu-kien-so,57345342,"Giá Đỡ Điện Thoại Bằng Kim Loại Đa Năng, Tùy Chỉnh Nhiều Góc Độ, Dành Cho Giải Trí, Livestream, Học Online",118000,118000,0,0
TIKI,thiet-bi-kts-phu-kien-so,171939157,"Lót chuột Logitech Mouse Pad - Đế cao su chống trượt, lướt dễ dàng, bề mặt chống đổ tràn, bền bỉ, nhỏ gọn - Hàng chính hãng - Màu",220000,220000,0,0
TIKI,thiet-bi-kts-phu-kien-so,115266252,"Bao Case Vỏ Bảo Vệ Silicone TPU Trong Suốt KAI cho Apple AirTag- Loại Bảo Vệ 2 Mặt_ Hàng Chính Hãng",43700,46000,2300,5
TIKI,thiet-bi-kts-phu-kien-so,25748826,"Đầu chuyển usb type-C ra USB 3.0 chính hãng Ugreen 50283",80000,80000,0,0
TIKI,thiet-bi-kts-phu-kien-so,7574741,"Bao Da Smart Case Gen2 TPU Dành Cho iPad Mini 1/ 2/ 3/ 4",121000,251984,130984,52
TIKI,thiet-bi-kts-phu-kien-so,183559913,"Micro có dây Nhật Bản  TOMAHAWK - Hàng nhập khẩu  - Hàng cao cấp Nhật Bản",250000,500000,250000,50
TIKI,thiet-bi-kts-phu-kien-so,150763505,"Bao Case Ốp Bảo Vệ Có Khóa Dành Cho Tai Nghe Galaxy Buds 2 Pro/ Buds 2/ Buds Pro/ Buds Live Chống Sốc Kai Switch Key Kèm Móc Treo_ Hàng Chính Hãng",150000,150000,0,0
TIKI,thiet-bi-kts-phu-kien-so,75477912,"Bộ Chuyển Đổi Cáp Ổ Cứng USB SATA III Đen (3.0) Có đèn báo tín hiệu tốc độ cao",128000,128000,0,0
TIKI,thiet-bi-kts-phu-kien-so,178737463,"Kính Cường Lực KingKong Full Màn Chính Hãng WEKOME Chống Vỡ Viền cho ĐT Hàng chính hãng",45000,45000,0,0
TIKI,thiet-bi-kts-phu-kien-so,55045867,"Miếng Lót Chuột Bàn Phím Trải Bàn Size Lớn Da PU Size 300 x 800 mm",130000,130000,0,0
TIKI,thiet-bi-kts-phu-kien-so,94304443,"Đồng Hồ Thông Minh AMA Watch Nam Nữ chống nước | Gọi điện thoại Xem tin nhắn Theo dõi Sức khỏe vận động Thiết kế nhỏ gọn Thời trang Hàng nhập khẩu",1258000,1258000,0,0
TIKI,thiet-bi-kts-phu-kien-so,157132867,"Ốp Lưng Silicon TPU trong suốt GOR cho iPhone 13 Mini / 13 / 13 Pro / 13 Pro Max - Hàng Chính Hãng",51000,70000,19000,27
TIKI,thiet-bi-kts-phu-kien-so,270493352,"Bàn phím cơ Gaming DAREU EK87 v2 (2 sides RGB strip, Black: Rainbow light , White: Single blue Backlight) - Hàng Chính Hãng",512050,539000,26950,5
TIKI,thiet-bi-kts-phu-kien-so,92922305,"Adapter Củ sạc nhanh 20W USB-C Power Adapter PD 3.0 -  Chuẩn Sock EU ( Chân Tròn )",64798,129596,64798,50
TIKI,thiet-bi-kts-phu-kien-so,192431673,"Vỏ Bút dành cho Apple Pencil 2 Retro Hình Bút Chì- Hàng Chính Hãng",160550,169000,8450,5
TIKI,thiet-bi-kts-phu-kien-so,359483,"Bàn Phím Không Dây Logitech K270 - Hàng Chính Hãng",469000,469000,0,0
TIKI,thiet-bi-kts-phu-kien-so,37655545,"Bao Da Cover Dành Cho Apple Ipad 10.2 Inch 2019 Hỗ Trợ Smart Cover",140000,140000,0,0
TIKI,thiet-bi-kts-phu-kien-so,24319638,"Dây Cáp Sạc Thay Thế Cho Đồng Hồ Thông Minh Garmin Forerunner 945 / 245 / Fenix ​​5X / Vivoactive 3 / Instinct / Fenix ​​5S / Approach S60",63000,63000,0,0
TIKI,thiet-bi-kts-phu-kien-so,104261141,"Chuột không dây chơi game HXSJ X801 thiết kế độc lạ Led RGB đổi màu click chống ồn DPI 1600 - Hàng chính hãng",259000,499000,240000,48
TIKI,thiet-bi-kts-phu-kien-so,114243462,"Giá Đỡ Máy Tính, Laptop Máy Tính Bảng Chất Liệu Hợp Kim Nhôm Cao Cấp Hỗ Trợ Tản Nhiệt Chống Mỏi Cổ, Vai, Gáy. Hàng Chính Hãng Tamayoko",600000,600000,0,0
TIKI,thiet-bi-kts-phu-kien-so,57900120,"Loa bluetooth mini 5.0 nhỏ gọn PKCB PF1002 - Hàng chính hãng",136000,400000,264000,66
TIKI,thiet-bi-kts-phu-kien-so,83982862,"Dây Cáp Sạc Type C to C Sạc Nhanh 60W, Dài 1m, Dây Dù Nylon Siêu Bền RAVPower RP-CB047 - Hàng Chính Hãng",129000,250000,121000,48
TIKI,thiet-bi-kts-phu-kien-so,177337039,"Chuột Có Dây HXSJ S200 - Hàng chính hãng",69000,129000,60000,47
TIKI,thiet-bi-kts-phu-kien-so,73261273,"Sim 4G Vinaphone Trọn Gói 1 Năm (Có 2Gb/ngày, 1000 phút nội mạng/tháng) - Hàng Chính Hãng",750000,750000,0,0
TIKI,thiet-bi-kts-phu-kien-so,73526371,"Bao Da Cover Nam Châm Dành Cho Apple Ipad Air 4 10.9 Inch 2020 Hỗ Trợ Pencil 2",250000,250000,0,0
TIKI,thiet-bi-kts-phu-kien-so,70847754,"Bộ 2 miếng kính cường lực Gor cho iPhone 12 Mini / 12 / 12 Pro / 12 Pro Max - Full Box - Gor - Hàng nhập khẩu",99000,99000,0,0
TIKI,thiet-bi-kts-phu-kien-so,47081914,"Hộp Túi Vải Đựng Phụ Kiện Công Nghệ Đa Năng Nhiều Ngăn Chống Thấm Nước Túi Phụ Kiện Du Lịch Cho Cáp Sạc Di Động, Sạc Dự Phòng, Điện Thoại, Tai Nghe, Thẻ Nhớ - Hàng Chính Hãng + Kèm 1 Mét Dây Gai Dính Tròn Buộc Gọn Cáp",72000,89000,17000,19
TIKI,thiet-bi-kts-phu-kien-so,54639263,"Bao Case Silicon Dành Cho Tai Nghe Apple Airpods Pro Có Móc Khóa Hàng Chính Hãng Helios",19000,19000,0,0
TIKI,thiet-bi-kts-phu-kien-so,13556522,"Đồng Hồ Hẹn Giờ 60 Phút Pomodoro Kim Loại",74000,74000,0,0
TIKI,thiet-bi-kts-phu-kien-so,56196502,"Chuột game có dây Logitech G102 Lightsync - Tùy chỉnh RGB, 6 nút lập trình, nhẹ, 8000 DPI, PC/Mac - Màu",440000,440000,0,0
TIKI,thiet-bi-kts-phu-kien-so,25554844,"Dây Đeo Thay Thế Cho Vòng Đeo Tay Thông Minh Xiaomi Mi Band 3 / Mi Band 4 Dẻo TPU - 2 màu",35000,35000,0,0
TIKI,thiet-bi-kts-phu-kien-so,129986551,"Tai Nghe Bluetooth Tai Mèo, Có Đèn LED Headphone - Tai Nghe Mèo Bluetooth Không Dây Dễ Thương Có Mic Đàm Hội Cao Cấp -  Tai Nghe Bluetooth Chụp Tai Không Dây - Hàng Chính Hãng Besti",130000,130000,0,0
TIKI,thiet-bi-kts-phu-kien-so,195445913,"Thẻ Nhớ MicroSDXC SanDisk Extreme V30 A2 256GB 190MB/s SDSQXAV-256G (New 2022) - Hàng Nhập Khẩu",570000,570000,0,0
TIKI,thiet-bi-kts-phu-kien-so,149248566,"Bao da iPad Gen 9 10.2 inch 2021 chính hãng Mutural kèm khay đựng bút - Hàng nhập khẩu",204000,339999,135999,40
TIKI,thiet-bi-kts-phu-kien-so,69931916,"Cáp HDMI to USB 3.0 Video Capture Earldom ET-W17 - Hỗ Trợ Live Stream, Ghi Hình Từ Điện Thoại, Camera, PS4, XBOX - Hàng Chính Hãng",330000,330000,0,0
TIKI,thiet-bi-kts-phu-kien-so,57108743,"Cáp sạc thay thế cho các dòng đồng hồ Garmin Fenix 6, Fenix 5, Forerunner 945, 935, Instinct, Viviactive 3, Venu",57000,57000,0,0
TIKI,thiet-bi-kts-phu-kien-so,97547734,"Giá Đỡ Để Bàn Điện Thoại Di Động, Máy Tính Bảng, Ipad Hợp Kim Nhôm Cao Cấp Hai Trục Xoay 180 Độ Chống Đổ Hàng Chính Hãng Tamayoko",390000,450000,60000,13
TIKI,thiet-bi-kts-phu-kien-so,112190913,"Dây Cáp chuyển Hdmi Sang Dvi-D 1080p",43530,43530,0,0
TIKI,thiet-bi-kts-phu-kien-so,169548885,"Chuột không dây Logitech B175 -Hàng chính hãng",165000,165000,0,0
TIKI,thiet-bi-kts-phu-kien-so,33142561,"Củ sạc HOCO 1A UH102 - Hàng nhập khẩu",20000,20000,0,0
TIKI,thiet-bi-kts-phu-kien-so,124702774,"Adapter Củ Sạc 40W 2 Cổng Type C PD 3.0 & QC 3.0 Nhỏ Gọn RAVPower RP-PC152 - Hàng Chính Hãng",499000,800000,301000,38
TIKI,thiet-bi-kts-phu-kien-so,182129885,"Bàn Phím Cơ Gaming Cao Cấp XSmart K1 Có 20 Chế Độ Nháy LED RGB Cực Đẹp, 104 Phím Full Size Sử Dụng Trục Cơ Red Switch Gõ Siêu Êm Bản Nâng Cấp Mới Nhất Tương Thích Với Các Dòng Máy Tính, Laptop, PC - Hàng Chính Hãng",549000,549000,0,0
TIKI,thiet-bi-kts-phu-kien-so,15432912,"Bộ 5 Dây Quấn Bảo Vệ Cáp Sạc Và Tai Nghe ",7000,7000,0,0
TIKI,thiet-bi-kts-phu-kien-so,136868821,"lót chuột văn phòng",23700,23700,0,0
TIKI,thiet-bi-kts-phu-kien-so,111050867,"Cáp sạc nhanh 2.4A và truyền dữ liệu cho android Remax Colorful Light RC-152m [Hàng chính hãng",112250,150000,37750,25
TIKI,thiet-bi-kts-phu-kien-so,91271958,"Giá, Kệ Dán Tường Để Sạc điện thoại, Remote Đồ Dùng Giá Đỡ Sạc Điện Thoại Có Móc Treo Giữ Dây Điện",6600,6600,0,0
TIKI,thiet-bi-kts-phu-kien-so,56799621,"Ốp lưng dẻo chống bụi dành cho iPhone 7 Plus / 8 Plus - Xanh rêu",49000,68000,19000,28
TIKI,thiet-bi-kts-phu-kien-so,536965,"Tai nghe chụp tai Logitech H111 - Hàng chính hãng",243000,243000,0,0
TIKI,thiet-bi-kts-phu-kien-so,38997194,"[Miếng dán màn hình] Kính cường lực chống nhìn trộm dành cho Iphone 6/7/8/X/11 6Plus 7Plus 8Plus XS MAX Iphone 11 Pro Max chất lượng",20000,39998,19998,50
TIKI,thiet-bi-kts-phu-kien-so,75397375,"Tai Nghe Chụp Tai Bluetooth Chống Ồn GS-H3 Cao Cấp, Headphone Bluetooth Chụp Tai Có Mic Đàm Thoại Tiện Lợi, Tai Nghe Bluetooth Không Dây Pin Cực Khỏe Bluetooth 5.0 Cao Cấp - Hàng Chính Hãng",220000,220000,0,0
TIKI,thiet-bi-kts-phu-kien-so,73992109,"USB Bluetooth 5.0 tốc độ 5Mbps Orico BTA-508 – Hàng Phân Phối Chính Hãng",109000,109000,0,0
TIKI,thiet-bi-kts-phu-kien-so,177085650,"Ốp lưng dẻo trong chống sốc dành cho SamSung Galaxy A13 4G, A53 5G, A23, A73, A33",12499,24998,12499,50
TIKI,thiet-bi-kts-phu-kien-so,63171394,"Miếng Lót Chuột Da 26x21 cm Màu Sắc Tinh Tế YORN - Hàng Nhập Khẩu",24000,24000,0,0
TIKI,thiet-bi-kts-phu-kien-so,59044820,"Thẻ nhớ MicroSD Kioxia 64GB Class 10 - Hàng Nhập Khẩu",113050,119000,5950,5
TIKI,thiet-bi-kts-phu-kien-so,161397226,"Miếng dán màn hình GOR cho Apple Watch Series 7 / Apple Watch Series 8 / Apple Watch Series 9 Size 41mm / 45mm (Hộp 3 Miếng) - Hàng Nhập Khẩu",119000,119000,0,0
TIKI,thiet-bi-kts-phu-kien-so,95998092,"Chuột bi xoay không dây ERGO M575 Wireless - Hàng Chính Hãng",938000,939000,1000,0
TIKI,thiet-bi-kts-phu-kien-so,11257847,"Dây Nguồn Dẹt 3 Chấu Cho Cục Sạc Laptop",17000,17000,0,0
TIKI,thiet-bi-kts-phu-kien-so,107971562,"Cáp âm thanh nối dài AUX 3.5mm Remax RL-L100/L200 - Hàng chính hãng",90000,100000,10000,10
TIKI,thiet-bi-kts-phu-kien-so,47271303,"Ốp lưng dẻo mỏng dành cho iPhone 6 Plus / iPhone 6s Plus - Màu đen",29500,29500,0,0
TIKI,thiet-bi-kts-phu-kien-so,166545922,"Dây Cáp Chuyển Đổi Type C To HDMI 4K 60Hz CHOETECH XCH-M180 Dây Nylon Dài 1.8M, Tương Thích Thunderbolt 3 Dành Cho Macbook, Kèm Cổng Type C Sạc Nhanh 60W - Hàng Chính Hãng",389000,750000,361000,48
TIKI,thiet-bi-kts-phu-kien-so,50253867,"Lót Chuột, Pad Chuột Bền Đẹp 80x30 cm - Hàng Chính Hãng",52000,52000,0,0
TIKI,thiet-bi-kts-phu-kien-so,71087453,"Củ Sạc Điện Thoại 2 Cổng USB-A và 2 Cổng Type-C PD 65W QC 3.0 RAVPower RP-PC136 - Hàng Chính Hãng",999000,1450000,451000,31
TIKI,thiet-bi-kts-phu-kien-so,165807250,"Tai Nghe True Wireless OPPO Enco Air 2 | Chống Ồn Thông Minh Ai | Màng Loa Mạ Titan 13.4mm | Hàng Chính Hãng",795000,1590000,795000,50
TIKI,thiet-bi-kts-phu-kien-so,118722616,"Chuột có dây LOGITECH B100 - Hàng chính hãng",65000,65000,0,0
TIKI,thiet-bi-kts-phu-kien-so,9843514,"Dây HDMI 10m Bọc Lưới Full HD",79900,79900,0,0
TIKI,thiet-bi-kts-phu-kien-so,65367594,"Dây đeo điện thoại/móc khóa/máy ảnh Ringke Lanyard Wrist Strap - Hàng Chính Hãng",104000,119000,15000,13
TIKI,thiet-bi-kts-phu-kien-so,379462,"Loa Vi Tính Microlab B51 - Hàng Chính Hãng",259000,259000,0,0
TIKI,thiet-bi-kts-phu-kien-so,88778005,"Dây Cao Su Thay Thế cho Samsung Galaxy Fit 2 (SM-R220)",29000,29000,0,0
TIKI,thiet-bi-kts-phu-kien-so,73166945,"Bàn phím không dây Bluetooth Logitech MX Keys - đa thiết bị, sạc nhanh, Mac/ PC - Hàng chính hãng",2459000,3499000,1040000,30
TIKI,thiet-bi-kts-phu-kien-so,73644584,"Dây Đeo Thay Thế Silicone Vòng Tay Thông Minh Mi Band 5 Mi Band 6 - Hàng Chính Hãng",33000,69000,36000,52
TIKI,thiet-bi-kts-phu-kien-so,176718538,"Pad Chuột Cỡ Lớn, Miếng Lót Chuột Gaming Cỡ Lớn 90x40, 120x60cm Thảm Nỉ Trải Bàn Làm Việc Phong Cách Decor Sang Trọng",80000,150000,70000,47
TIKI,thiet-bi-kts-phu-kien-so,42422432,"Giá đỡ nhôm, kệ đỡ laptop, đế tản nhiệt cho macbook, máy tính 9 nấc điều chỉnh độ cao",84400,84400,0,0
TIKI,thiet-bi-kts-phu-kien-so,119003179,"Chuột Không Dây DAREU LM115G SPARROW ARTIC White (Màu Trắng) - Hàng Chính Hãng",125000,125000,0,0
TIKI,thiet-bi-kts-phu-kien-so,17913419,"Tai nghe Moxpad X3 in-ear Monitor - Hàng chính hãng",440000,440000,0,0
TIKI,thiet-bi-kts-phu-kien-so,59482840,"Bộ Hub QGeeM đa năng 5 trong 1 dành cho MacBook Pro 13/15 Surface Go, USB C Adapter - Hàng chính hãng",276000,299000,23000,8
TIKI,thiet-bi-kts-phu-kien-so,96811310,"Tai nghe chụp tai máy tính GAMING XSmart MC Q9 có đèn LED đổi màu, mic đàm thoại, headphone chơi game trên laptop, pc - Hàng Chính Hãng",349000,349000,0,0
TIKI,dien-gia-dung,75649136,"(Loại Tốt) Bếp Vỉ Nướng Điện Không Khói BBG KhoNCC - Electric BarBecue Grill 2000W - KPD-BEPDKK-425 - Hàng Chính Hãng",259000,318000,59000,19
TIKI,dien-gia-dung,91252008,"Quạt hút thông gió phi 200 - Quạt hút gió đồng trục cấp khí tươi cho công trình nhà - Hàng chính hãng GDXLFJ siêu chống ồn",1900000,1900000,0,0
TIKI,dien-gia-dung,170852877,"Máy xay thịt đùn xúc xích lạp sườn 2500W",1250000,1250000,0,0
TIKI,dien-gia-dung,80931711,"MÁY HÀN MIỆNG TÚI MINI",22000,22000,0,0
TIKI,dien-gia-dung,58065295,"Bàn Ủi Hơi Nước Đứng Philips GC487/89 (1800W) - Hàng Chính Hãng",2299000,2299000,0,0
TIKI,dien-gia-dung,73856567,"Quạt Lửng Sharp Có Điều Khiển PJ-L40RV-LG - Hàng Chính Hãng",1119000,2000000,881000,44
TIKI,dien-gia-dung,97537040,"Máy xay mini, Máy nghiền bột ngũ cốc mini (xay hạt ngũ cốc, hạt gia vị, đồ khô...)",152041,152041,0,0
TIKI,dien-gia-dung,165106847,"Máy Hàn Miệng Túi Thực Phẩm Mini Đa Năng Tiện Lợi - Hàng Loại 1 - Chính Hãng MINIIN",74000,74000,0,0
TIKI,dien-gia-dung,559054,"Đèn Sưởi Phòng Tắm Sunhouse SHD3812 (550W)- Hàng chính hãng",585000,989000,404000,41
TIKI,dien-gia-dung,74537187,"Siêu Sắc Thuốc 3L ,Ấm Sắc Thuốc Tự Động Fujika K5 Lòng Ấm Tráng Men Chịu Nhiệt Cao Màu Đen Họa Tiết Kí Tự- Hàng Chính Hãng",342000,456000,114000,25
TIKI,dien-gia-dung,55442805,"Máy Lọc Nước Pureit Casa G2 Công Suất Lớn Lọc Nguyên Khối Tích Hợp Công Nghệ RO+MF - Hàng chính hãng",5625000,7500000,1875000,25
TIKI,dien-gia-dung,449043,"Máy Ép Trái Cây Sunhouse SHD5520 (260W) - Đỏ - Hàng chính hãng",729000,1160000,431000,37
TIKI,dien-gia-dung,164587236,"Robot hút bụi lau nhà Ecovacs Deebot X1 OMNI – Trợ lý ảo YIKO – Lực hút Max 5000Pa– Bản Quốc Tế - Hàng Chính Hãng",17790000,31900000,14110000,44
TIKI,dien-gia-dung,136034816,"Nồi Chiên Không Dầu Dung Tích Lớn - Nồi Chiên Không Dầu Chống Dính Cao Cấp",446223,446223,0,0
TIKI,dien-gia-dung,100948032,"NỒI Ủ KHALUCK.HOME KL-710 5L",759000,999000,240000,24
TIKI,dien-gia-dung,77774257,"Quạt Trần  Có Đèn LED,  Có Điều Từ Xa Động Cơ DC 2 Chiều Gió - Công Xuất 90W ",1590000,1590000,0,0
TIKI,dien-gia-dung,127060997,"Quạt bàn B4 Senko B1616 - Màu ngẫu nhiên - Hàng Chính Hãng",355000,355000,0,0
TIKI,dien-gia-dung,36370154,"Bếp chiên nhúng ZL81 6 lít - hàng nhập khẩu",501600,528000,26400,5
TIKI,dien-gia-dung,56029960,"Nồi cơm điện nắp gài 1Lit Fujika FJ-CM10, công suất 400W, lồng men chống dính, màu ngẫu nhiên-Hàng chính hãng",300000,300000,0,0
TIKI,dien-gia-dung,74190397,"Máy khâu bao mini - Máy khâu bao tải cầm tay GK9-2",1085000,1085000,0,0
TIKI,dien-gia-dung,188445944,"Máy Cạo Râu Và Tỉa Lông Mũi Mini Cầm Tay Cạo Êm Chống Thấm Nước, Sạc USB Tiện Lợi, Động Cơ Mạnh Mẽ",135000,135000,0,0
TIKI,dien-gia-dung,57456756,"Máy Lọc Nước RO Hydrogen Ion Kiềm Kangaroo KG100ES 7 Lõi - Hàng Chính Hãng",4000000,12790000,8790000,69
TIKI,dien-gia-dung,178462956,"Máy sấy tóc Philips BHD350/10 - Sấy khô tóc mạnh mẽ",895000,895000,0,0
TIKI,dien-gia-dung,86552638," Ca Nấu Mì, Nấu Cơm Đa Năng Có Tay Cầm 1,8L - Nồi Lẩu Điện Mini Kèm Giá Hấp INOX + 1 Khay Luộc Trứng",130296,130296,0,0
TIKI,dien-gia-dung,48314361,"Máy sấy tóc công suất lớn 2200W, 2 chiều nóng lạnh - tặng 05 phụ kiện",95000,95000,0,0
TIKI,dien-gia-dung,24352990,"Máy Xay Sinh Tố Đa Năng Sunhouse SHD5322 (220W - 1.25 Lít) - Đỏ - Hàng Chính Hãng",665000,1214000,549000,45
TIKI,dien-gia-dung,188990495,"Máy Hút Mùi Classic Ecalite EH-CL700T (Ngang 70cm) - Công Suất Hút Mạnh 750m3/h - Điều Khiển Cảm Ứng Và Cử Chỉ - Hàng Chính Hãng",2745000,5490000,2745000,50
TIKI,dien-gia-dung,129623981,"Nồi Nấu Cháo Chậm - Nồi Hầm Cách Thủy Dung Tích 1L, Lòng Nồi Bằng Sứ Giữ Nhiệt Tốt Hơn - Nồi Chưng Yến, Hầm Canh... - Loại Tốt",267000,275999,8999,3
TIKI,dien-gia-dung,178462962,"Máy sấy tóc Philips BHD300/10 - Chính hãng",755000,755000,0,0
TIKI,dien-gia-dung,55520530,"Máy hút ẩm gia dụng chính hãng Dorosin 618C (40m2)/Công suất hút ẩm 18 lít /ngày - Cảm biến điện tử thông minh - Độ ồn thấp",4520000,4520000,0,0
TIKI,dien-gia-dung,17010845,"Quạt hút thông gió 2 chiều âm tường Senko Hàng Chính Hãng H150 30W",295000,295000,0,0
TIKI,dien-gia-dung,71506728,"Phụ kiện robot hút bụi Mi Robot Vacuum-Mop P Filter (màng lọc HEPA) - Hàng chính hãng",190000,190000,0,0
TIKI,dien-gia-dung,84760244,"Máy xay sinh tố cầm tay đa năng tai thỏ xinh xắn ( 50W - 330ml )",207338,218250,10912,5
TIKI,dien-gia-dung,164396485,"Bàn Là Hơi Nước Cầm Tay Gấp Gọn - Bàn Ủi Hơi Nước SEKA Cao Cấp An Toàn Tiện Dụng - Hàng chính hãng",299000,340000,41000,12
TIKI,dien-gia-dung,114894205,"Máy hút bụi giường nệm Bear CMY-B03M1 diệt khuẩn UV-C, công nghệ khí nóng làm khô và kết hợp tinh dầu thơm, hàng chính hãng",1250000,1250000,0,0
TIKI,dien-gia-dung,22641863,"Quạt đèn trần giấu cánh kiểu mới",1450000,1450000,0,0
TIKI,dien-gia-dung,119363102,"Nồi chưng yến cách thủy, nấu cháo, nồi hầm đa năng dung tích 800ml PHIÊN BẢN TIẾNG VIỆT",548000,548000,0,0
TIKI,dien-gia-dung,250737261,"Máy Xay Cà Phê, Máy Xay Hạt Thực Phẩm Khô Đa Năng BEAR MDJ – A02G3 Chế Độ Xay Cực Êm Dung Tích 200 ML Công Suất 200 W- Hàng Chính Hãng",639000,1199000,560000,47
TIKI,dien-gia-dung,105257987,"Bình Thủy Điện SHARP KP-B28SV-OC (2.8 Lít) - Hàng Chính Hãng",839000,839000,0,0
TIKI,dien-gia-dung,91565152,"Máy Lọc Không Khí ULTTY SKJ-CR021 Dạng Quạt, Chế Độ Làm Mát 9 Cấp, Bộ Lọc HEPA H13 Loại Bỏ 99,97% Bụi Mịn, Vi Khuẩn, Virut - Màu Đen - Hàng Chính Hãng",4580000,5850000,1270000,22
TIKI,lam-dep-suc-khoe,3844939,"Cao Hồng Sâm Sobeak 6 Năm Tuổi Hàn Quốc (240g x 2 hũ)",650000,650000,0,0
TIKI,lam-dep-suc-khoe,108928188,"Bộ Sản Phẩm Dưỡng Tóc và Ngăn Rụng Tóc Thiên Nhiên Hoàn Hảo Từ Thorakao: Combo 2 Chai Dầu Gội và Xả Hoa Bưởi 400ml + 1 Chai Lotion Tinh Dầu Bưởi 150ml ",348800,348800,0,0
TIKI,lam-dep-suc-khoe,75436781,"Son kem lì Bbia Last Velvet Lip Tint Version 8 5g (5 màu)",150000,290000,140000,48
TIKI,lam-dep-suc-khoe,176910167,"Bộ 24 móng tay giả cao cấp MJ069 (Kèm keo+ dũa móng tay+ miếng dán móng tay)",25000,25000,0,0
TIKI,lam-dep-suc-khoe,22983097,"Sáp tạo kiểu tóc nam cứng mờ Aurane Cool Stylish Clay 80ml",135000,135000,0,0
TIKI,lam-dep-suc-khoe,8729465,"Tẩy Tế Bào Da Chết Chiết Xuất Từ Than Hoạt Tính ARRAHAN CHARCOAL PEELING GEL (180ml)",62000,62000,0,0
TIKI,lam-dep-suc-khoe,58601328,"Viên uống Vitamin tổng hợp cho Nam - One a day Men's Multivitamin 300 viên mẫu mới",590000,590000,0,0
TIKI,lam-dep-suc-khoe,74989524,"Máy Xông Tinh Dầu Cao Cấp + Tinh Dầu Sả Chanh Nguyên Chất Nhập Khẩu, Máy Khuếch Tán Tinh Dầu Chuyên Dụng, Họa Tiết Sang Trọng và Đèn LED Biến Đổi Màu Cực Đẹp (họa tiết ngẫu nhiên)",287300,676000,388700,58
TIKI,lam-dep-suc-khoe,10278480,"Nước uống collagen giúp sáng da, dạ dày khỏe Blossomy lốc 03 chai x 50ml",165000,165000,0,0
TIKI,lam-dep-suc-khoe,247965266,"Collagen cho nam Youtheory Mỹ hỗ trợ sức khỏe tổng thể cho:xương khớp, da, móng, gân, dây chằng, cơ bắp, tim mạch và tăng sức đề kháng-Massel Official",627000,1254000,627000,50
TIKI,lam-dep-suc-khoe,95975019,"Nước Uống Tăng Lực Hồng Sâm Won KGC Cheong Kwan Jang 100ml x 10 Chai",280000,300000,20000,7
TIKI,lam-dep-suc-khoe,6738207,"Máy Đo Huyết Áp Cổ Tay Omron - HEM-6161",799900,1280000,480100,38
TIKI,lam-dep-suc-khoe,58214750,"Khẩu trang y tế 4D 4 lớp cao cấp Hamita - Bịch 1 cái - ISO13485, Dấu CE - Sử dụng giấy kháng khuẩn cao cấp Mealtblown, hiệu quả lọc kháng khuẩn giữ nguyên 99.9% sau 5 lần giặt",9000,9000,0,0
TIKI,lam-dep-suc-khoe,271299398,"Collagen Neocell Types 1 & 3 Mỹ Hỗ trợ cang da, giảm nhăn da, giúp da, tóc, móng tay và khớp khỏe mạnh từ bên trong ra ngoài - Massel Official",681000,1362000,681000,50
TIKI,lam-dep-suc-khoe,911351,"Kem Hỗ Trợ Giảm Mụn Ngừa Thâm Liền Sẹo Ori'be Chiết Xuất Tảo Nâu Từ Pháp Tuýp 20g",55000,55000,0,0
TIKI,lam-dep-suc-khoe,174509075,"[COMBO 3 HỘP] Kẹo ngậm Viatux Extra Vietnat giảm ho khàn tiếng - 30 viên/ hộp",90750,90750,0,0
TIKI,lam-dep-suc-khoe,89204299,"Cao dán hồng sâm Hàn Quốc",49000,80000,31000,39
TIKI,lam-dep-suc-khoe,195559389,"Kem dưỡng cấp ẩm ban đêm Neutrogena® Hydro Boost Hyaluronic Acid Night Cream 50g",330000,440000,110000,25
TIKI,lam-dep-suc-khoe,108535212,"Bao cao su Sagami Miracle - Thiết kế 3D - Ôm khít - Size 49 mm - Hộp 10 chiếc",95000,120000,25000,21
TIKI,lam-dep-suc-khoe,128756250,"MUSK KHẨU TRANG Y TẾ 5 LỚP N95 / FFP2 Nhập Khẩu Châu Âu Turkey, Phòng Tránh Lây Nhiễm Vi Khuẩn, Virus, Bệnh Hô Hấp, Hoá Chất, Phòng Thí Nghiệm, Bệnh Viện, Môi Trường Y Tế, Bụi Khuẩn Độc Hại. LỌC VI KHUẨN, VIRUS 99%. Hộp 10 Chiếc Màu Trắng",99000,160000,61000,38
TIKI,lam-dep-suc-khoe,262899667,"Glucosamine 1500mg Chondroitin 1200mg Kirkland Signature  - Phục hồi sụn khớp, Giảm đau nhức xương khớp và Hỗ trợ sự vận động linh hoạt hiệu quả - QuaTangMe Extaste",655000,1310000,655000,50
TIKI,lam-dep-suc-khoe,116418824,"Gel ngừa mụn Nano THC Decumar 20gr làm sáng da mụn viêm thâm",120000,120000,0,0
TIKI,lam-dep-suc-khoe,55506863,"Hộp 50 cái khẩu trang y tế 4 lớp VN Number One",30000,30000,0,0
TIKI,lam-dep-suc-khoe,127515106,"Hỗ trợ mọc tóc Natrol Biotin Beauty giúp tóc mọc nhanh dài, dày hơn, làn da rạng rỡ và móng tay chắc khỏe - OZ Slim Store",313000,646000,333000,52
TIKI,lam-dep-suc-khoe,20649902,"Kem Chống Nắng Cho Mọi Loại Da Cell Fusion C Laser Sunscreen 100 SPF 50+/PA+++ (50ml)",345000,450000,105000,23
TIKI,lam-dep-suc-khoe,70052293,"Combo máy khuếch tán/ máy xông tinh dầu Lorganic bình hoa FX2057 + tinh dầu bạch đàn chanh Lorganic (10ml) LGN0366",600000,600000,0,0
TIKI,lam-dep-suc-khoe,188767619,"Dầu gội phủ bạc Mochi Nhật Bản (Lược chải & vòi nhấn). Dầu gội nhuộm tóc thảo dược ngay tại nhà",249000,249000,0,0
TIKI,lam-dep-suc-khoe,112998207,"Son Môi M.O.I Nhung Lì Sgirl SUMMER EDITION Hồ Ngọc Hà (2021)",199000,299000,100000,33
TIKI,lam-dep-suc-khoe,152097308,"Bông tẩy trang ipek thỗ nhĩ kì 130 miếng",26900,39800,12900,32
TIKI,lam-dep-suc-khoe,4613079,"Thực phẩm chức năng Giấm Đen Giảm Cân Orihiro Nhật Bản 216 Viên",164000,189000,25000,13
TIKI,lam-dep-suc-khoe,59130762,"Lược Tròn Tạo Phồng ,Uốn Cụp Kiểu Hàn Quốc- Đa Năng",22000,30000,8000,27
TIKI,lam-dep-suc-khoe,7677552,"Thực phẩm bảo vệ sức khỏe Viên dầu cá Kirkland Signature Fish Oil 1000mg từ Mỹ, bổ sung Omega-3, DHA và EPA - 400 Viên",776000,1552000,776000,50
TIKI,lam-dep-suc-khoe,68005401,"Combo 2 Sữa tắm nước hoa dưỡng da Enchanteur Charming 650gr/ Chai",313000,392000,79000,20
TIKI,lam-dep-suc-khoe,58880438,"Nhiệt Kế Hồng Ngoại , Đo Không Tiếp Xúc - Cảnh Báo Sốt -- Tặng Kèm 1 Cặp Pin ",173900,173900,0,0
TIKI,lam-dep-suc-khoe,4423491,"Thực Phẩm Chức Năng Dầu Cá Omega 3 Orihiro Nhật Bản 180 Viên",324000,352800,28800,8
TIKI,lam-dep-suc-khoe,15149797,"Bàn Lăn Chân Gỗ Massage 6 Hàng ( 31 X 24 X 10 Cm)",178000,178000,0,0
TIKI,lam-dep-suc-khoe,12084496,"Gel Rửa Mặt Trị Mụn Loại Bỏ Nhờn Ngừa Mụn Eucerin (200ml)",276000,369000,93000,25
TIKI,lam-dep-suc-khoe,112976646,"Tinh Dầu Khuếch Hương DAILY COMMA Crystal Hologram Diffuser 100ML (MẪU MỚI NHẬP KHẨU)",135000,270000,135000,50
TIKI,lam-dep-suc-khoe,76110606,"Gương trang điểm để bàn cao cấp gương soi di động bằng gỗ xoay gập tiện lợi phong cách châu Âu - Tặng 1 băng đô trang điểm vải nhung màu ngẫu nhiên",25000,25000,0,0
TIKI,lam-dep-suc-khoe,74625269,"Gel chấm mụn, mờ thâm Oxy Anti-Acne Spot Gel 10g",74000,78000,4000,5
TIKI,the-thao-da-ngoai,163852970,"Mồi Câu Giả Cá Mồi Mềm 2 Lưỡi Mồi Cá Câu Lure, Mồi Câu Cá",22100,22100,0,0
TIKI,the-thao-da-ngoai,57383103,"Bộ đánh lửa sinh tồn mini cho những chuyến dã ngoại (tặng kèm còi chuyên dụng)",45000,45000,0,0
TIKI,the-thao-da-ngoai,149606586,"Mồi cắm câu cá , trắm , chép , rô phi , trôi",16600,16600,0,0
TIKI,the-thao-da-ngoai,139936481,"BỘ MỒI HƠI 6 CON MỒI SIÊU NHẠY CÁ KÈM PHỤ KIỆN CHUYÊN CÂU LURE, LÓC, RÔ, MƯƠNG",120000,120000,0,0
TIKI,the-thao-da-ngoai,272297441,"Sữa hổ trợ tăng cân tăng cơ Muscle Mass Gainer Chocolate 5,4kg + tặng Bình lắc",1650000,1650000,0,0
TIKI,the-thao-da-ngoai,163801652,"Trục Câu Đài Bộ Dây Câu Đơn Câu Đài Buộc Sẵn Cước Tàng Hình Dài 3m6 - 7m2",4700,4700,0,0
TIKI,the-thao-da-ngoai,149591136,"  Bộ Phụ Kiện Câu Đài_Bộ Phụ Kiện Làm Trục,Thẻo Câu Đài_ Đồ Câu Cá ",32000,32000,0,0
TIKI,the-thao-da-ngoai,5061787,"Túi chống nước Ocean Pack Sportslink",78000,86000,8000,9
TIKI,the-thao-da-ngoai,36229722,"Gậy Bẻ Cơ Tay Lò Xo Tập Cơ Tay Power Twister 30 Kg PT30",46498,46498,0,0
TIKI,the-thao-da-ngoai,33399458,"Dây Kéo Lưng Trợ Lực Cổ Tay Tập Gym Bản Cải Tiến Aolikes Lifting Straps AL-7633 (1 Đôi) ",175000,175000,0,0
TIKI,the-thao-da-ngoai,896407,"Túi Đeo Bụng Đựng Điện Thoại Tập Thể Dục Đại Việt Sport (39 x 10 cm) - Màu Ngẫu Nhiên ",120000,145000,25000,17
TIKI,the-thao-da-ngoai,141827877,"DỒ CÂU LINH NGỌC xả hàng Vó Bắt Tôm, Cua, Cá, Tép.. ĐỒ CÂU LINH NGỌC",39987,39987,0,0
TIKI,the-thao-da-ngoai,162519554,"DÂY NHẢY CAO CẤP ADIDAS ADRP-13011",347000,359000,12000,3
TIKI,the-thao-da-ngoai,173844720,"quả bóng bàn DHS hộp 6 quả",75000,75000,0,0
TIKI,the-thao-da-ngoai,189591573,"Combo 3 Đôi Vớ Xỏ Ngón Thể Thao Chạy Bộ  Đạp Xe Leo Núi Aonijie E4802 Chất Liệu Coolmax  Thoáng Khí",524000,524000,0,0
TIKI,the-thao-da-ngoai,52257480,"Bộ đồ tập gym - thể thao nam Freesize dưới 70kg -HM2020",90000,90000,0,0
TIKI,the-thao-da-ngoai,142251473,"Quần legging thể thao nam ngắn Devops CÓ TÚI form ôm lưng thun cao bó cơ combat tập gym đá bóng yoga",180000,180000,0,0
TIKI,the-thao-da-ngoai,72869927,"Bóng tập Yoga Nửa Gai + Nửa Trơn 3D -65cm Cao Cấp 1200Gram – Tặng kèm bơm( Hàng Cao Cấp Chính hãng)",135000,240000,105000,44
TIKI,the-thao-da-ngoai,57154950,"Con lăn tập cơ bụng 1 bánh - màu ngẫu nhiên",169000,169000,0,0
TIKI,the-thao-da-ngoai,195524317,"Võ phục võ cổ truyền dành cho người lớn và trẻ em",200000,200000,0,0
TIKI,the-thao-da-ngoai,141637623,"Siêu Khuyến Mãi 1 kg Bi Sắt 6mm, 7mm, 8mm - Đồ câu 24h - Cần Câu Top1 VN",41900,41900,0,0
TIKI,the-thao-da-ngoai,141075138,"Đầu Kim Bơm Bóng Đá Cao Cấp, Bơm Bóng Rổ, Bơm Bóng Chuyền, Bơm Bóng Ném - Cứng Cáp, Thiết Kế Vừa Vặn Các Loại Bóng",5000,5000,0,0
TIKI,the-thao-da-ngoai,163742920,"Cần Câu Lure Dyawa Carbon Cần Câu Cá Máy Ngang Và Máy Đứng Chống Xoắn Cao Cấp",186000,186000,0,0
TIKI,the-thao-da-ngoai,156058625,"Mồi Câu Giả Tôm Mềm",22100,22100,0,0
TIKI,the-thao-da-ngoai,151676187,"CHÍNH HÃNG - ĐAI NẸP KHUỶU TAY NÂNG CAO Adv Sports Elbow - BONBONE NHẬT BẢN - Hỗ trợ chấn thương.",300000,500000,200000,40
TIKI,the-thao-da-ngoai,45852948,"Quần Thể Thao Nam Đen Sọc ONGTHUONG98 (Ống Thường)",75000,75000,0,0
TIKI,the-thao-da-ngoai,162167458,"Giày Bóng Rổ Thời Trang Thể Thao PEAK Taichi Colorful 6371 E13747E",819000,1590000,771000,48
TIKI,the-thao-da-ngoai,151450936,"Túi Đeo Bụng, Đai Đeo Bụng Nam Nữ Đa Năng Đựng Điện Thoại Tập Gym Chạy Bộ, Đi Xe Đạp, Leo Núi Chơi Thể Thao Tiện Lợi",22106,31931,9825,31
TIKI,the-thao-da-ngoai,70564866,"Đèn Pin Đội Đầu 3 Bóng Led, 04 Chức Năng, Pin Sạc 9800Mah, 18650 4.2V - Hàng Chính Hãng",142600,155000,12400,8
TIKI,the-thao-da-ngoai,144405215,"Bóng Đôi Giãn Cơ, Massage Trị Liệu",69000,69000,0,0
TIKI,the-thao-da-ngoai,73173470,"Chai xịt chống mờ kính bơi, kính cận SAEKO - Chống bám hơi nước và sương mù AS04 - SHOP TOÀN CHÂU",135000,135000,0,0
TIKI,the-thao-da-ngoai,138706067,"Vợt Cá Carbon Vành Tròn Có thể thu gọn chuyên dụng câu đài vợt cá câu đài",130175,130175,0,0
TIKI,the-thao-da-ngoai,100369483," Quần đùi nam Fasvin Q21461.HN vải gió chun co giãn mềm mại thoải mái vận động",99000,198000,99000,50
TIKI,the-thao-da-ngoai,162522813,"Túi đựng cần câu 3 ngăn lớn và ngăn phụ chống thấm nước cao cấp Wago",279998,279998,0,0
TIKI,the-thao-da-ngoai,132777706,"Tấm tăng ,tấm trải ngồi lót lều hay che võng Rằn ri",99000,99000,0,0
TIKI,the-thao-da-ngoai,35324160,"Đệm Lót Mút Xốp Hỗ Trợ Gánh Tạ Squat Barbell Pad Valeo",125000,125000,0,0
TIKI,the-thao-da-ngoai,58723933,"ÁO SÁT NÁCH FITNESS THỂ THAO TẬP GYM - BÓNG RỔ CAO CẤP THUN LỖ KIM SZONE SA473",105000,105000,0,0
TIKI,the-thao-da-ngoai,190487966,"Túi Ngủ NH LW180",380000,380000,0,0
TIKI,the-thao-da-ngoai,156001889,"SALE LỚN ô dù đội đầu 2 tầng ô câu cá loại 1 siêu mát",48500,48500,0,0
TIKI,the-thao-da-ngoai,82484211,"Còi Thổi Báo Động Khẩn Cấp Khi Đi Cắm Trại, Dã Ngoại (Màu Ngẫu Nhiên)",6900,6900,0,0
TIKI,cross-border-hang-quoc-te,185329850,"Thắt lưng da bò CAMEL khóa tự động cho nam",457000,457000,0,0
TIKI,cross-border-hang-quoc-te,207005187,"CAMEL CROWN Cốc Titan Cắm Trại Bộ Đồ Ăn Du Lịch Ngoài Trời Thiết Bị Nấu Ăn Dã Ngoại Đi Bộ Đường Dài Du Lịch",788000,788000,0,0
TIKI,cross-border-hang-quoc-te,190320464,"Giày chạy bộ nam CAMEL CROWN Lớp Có đệm không trượt Chịu mài mòn Thở nhẹ",961000,961000,0,0
TIKI,cross-border-hang-quoc-te,226400334,"CAMEL Thể Thao Mùa Hè Mới Áo Thun Nữ Mỏng Là Áo Chạy Mỏng Khí Chất Gợi Cảm Thoáng Khí Thể Dục Từ Bi",376000,376000,0,0
TIKI,cross-border-hang-quoc-te,11534299,"It Ends With Us",359000,359000,0,0
TIKI,cross-border-hang-quoc-te,197231505,"CAMEL ngoài trời võng cắm trại dã ngoại giường lưới ký túc xá xích đu phòng ngủ hộ gia đình chống lật ghế treo học sinh ghế lười",663000,663000,0,0
TIKI,cross-border-hang-quoc-te,209568752,"Streetwear Casual Jogger Cargo Pants  Hiking Trousers Outdoor Gray_S",379000,379000,0,0
TIKI,cross-border-hang-quoc-te,204601749,"Vỏ Bọc Ghế Ngồi Bàn Ăn Co Giãn Dày Dặn Tiện Dụng Cho Gia Đình",238200,238200,0,0
TIKI,cross-border-hang-quoc-te,115902462,"Phích chuyển đổi sạc 3 chân - Giắc cắm điện chuyển đổi ổ 3 chấu thành 2 chấu",15000,15000,0,0
TIKI,cross-border-hang-quoc-te,17965475,"Steal Like an Artist: 10 Things Nobody Told You About Being Creative",438000,438000,0,0
TIKI,cross-border-hang-quoc-te,217614202,"Lều Tán Sơn Màu Bạc CAMEL Cắm Trại Ngoài Trời Lều Che Nắng Cắm Trại Chống Mưa Đi Dã Ngoại",1778000,1778000,0,0
TIKI,cross-border-hang-quoc-te,248885790,"Đồ bơi một mảnh CAMEL CROWN thời trang tùy chọn kích thước dành cho nữ",807000,807000,0,0
TIKI,cross-border-hang-quoc-te,205051050,"Áo Khoác Gió CAMEL Cho Nam Áo Áo Khoác Nam Mùa Đông Thể Thao Có Mũ Chống Gió Mùa Thu Nam Thường Ngày Áo Khoác Gió Chữ",1401000,1401000,0,0
TIKI,cross-border-hang-quoc-te,207966543,"Áo khoác nam CAMEL Mùa xuân và mùa thu áo khoác thể thao nam chống gió chống nước ngoài trời quần áo áo khoác leo núi quần áo",1530000,1530000,0,0
TIKI,cross-border-hang-quoc-te,170692846,"Sách - On Earth We're Briefly Gorgeous : A Novel by Ocean Vuong (US edition, paperback)",473000,473000,0,0
TIKI,cross-border-hang-quoc-te,191316017,"Đồ bơi Nữ CAMEL CROWN Bikini Hai Mảnh Tam Giác Sling",500000,500000,0,0
TIKI,cross-border-hang-quoc-te,113954381,"4 chiếc Giày chống thấm nước, chống trượt cho chó-Size",369000,369000,0,0
TIKI,cross-border-hang-quoc-te,151548619,"Sách - The Song of Achilles : Bloomsbury Modern Classics by Madeline Miller - (UK Edition, paperback)",439000,439000,0,0
TIKI,cross-border-hang-quoc-te,102428769,"2 Piece Replacement  Wrist Strap for Misfit Ray Fitness Tracker",119000,119000,0,0
TIKI,cross-border-hang-quoc-te,195520240,"Áo thun polo CAMEL áo thun có cổ mùa hè ngắn tay ve áoáo thun nam XBB192157",586000,586000,0,0
TIKI,cross-border-hang-quoc-te,205405312,"Áo Thun Lông Cừu Nam CAMEL, Áo Dài Tay Cổ Tròn Mùa Thu Áo Thun Ấm Áp Đơn Giản Mùa Đông",686000,686000,0,0
TIKI,cross-border-hang-quoc-te,46386341,"Sunnimix 1 Glockenspiel Đàn Xylophone Đập Nhựa Cứng Nhám Đầu Cái Vồ Gậy Be",244000,244000,0,0
TIKI,cross-border-hang-quoc-te,196949836,"Áo Thun Thể Thao Nữ CAMEL, Áo Hở Eo Làm Mát Thường Ngày Mùa Hè Áo Trơn Tập Yoga Tay Ngắn Cho Nữ Dành Cho Nữ",417000,417000,0,0
TIKI,cross-border-hang-quoc-te,203812989,"Quần đùi short gió nam CAMEL thể thao Basic trẻ trung năng động",403000,403000,0,0
TIKI,cross-border-hang-quoc-te,109435197,"Loa máy tính có cáp âm thanh 2 * 3,5mm cho Mic SADA V-103-Màu đen",416000,416000,0,0
TIKI,cross-border-hang-quoc-te,176463031,"Sách - Prisoners of Geography : Ten Maps That Tell You Everything You Need to Kn by Tim Marshall (UK edition, paperback)",394000,394000,0,0
TIKI,cross-border-hang-quoc-te,176304381,"Sách - Tuesdays with Morrie: an Old Man, a Young Man, and Life's Greatest Lesson by Mitch Albom (US edition, paperback)",247650,247650,0,0
TIKI,cross-border-hang-quoc-te,201569105,"Quần áo tập yoga CAMEL 2022 mới mùa thu và mùa đông áo lông cừu quần áo thể dục quần áo thể thao quần áo thun dài tay phụ nữ",690000,690000,0,0
TIKI,cross-border-hang-quoc-te,192709820,"30 Pieces Polymer Clay Tools Pottery Modeling Smoothing for Beginners with Carrying Case DIY Ceramic Clay Carving Tool Set Clay Tools",187000,187000,0,0
TIKI,cross-border-hang-quoc-te,17970408,"How to Love (Mindfulness Essentials) - New Cover ",291000,291000,0,0
TIKI,cross-border-hang-quoc-te,17970237,"Picture Of Dorian Gray (Feb 03)",289200,289200,0,0
TIKI,cross-border-hang-quoc-te,109164159,"Túi đựng hành lí khi đi xe đạp, Túi Trunk, túi đặt yên sau xe đạp",464000,464000,0,0
TIKI,cross-border-hang-quoc-te,113401672,"Sách - Your Money or Your Life: 9 Steps to Transforming Your Relationship with Money and Achieving Financial Independence: Fully Revised and Updated by Vicki Robin,Joe Dominguez,Mr. Money Mustache - (US Edition, paperback)",529000,529000,0,0
TIKI,cross-border-hang-quoc-te,52834154,"Thông Gió Miếng Dán Mũi Cho Nghẹt Mũi Giảm Ngáy",167000,167000,0,0
TIKI,cross-border-hang-quoc-te,190320464,"Giày chạy bộ nam CAMEL CROWN Lớp Có đệm không trượt Chịu mài mòn Thở nhẹ",961000,961000,0,0
TIKI,cross-border-hang-quoc-te,273115068,"Christmas Tabletop Decorations Christmas Centerpiece for Home Office Kitchen",209000,209000,0,0
TIKI,cross-border-hang-quoc-te,163159382,"Sách - The Concise Mastery by Robert Greene (UK edition, paperback)",354000,354000,0,0
TIKI,cross-border-hang-quoc-te,7917827,"Intelligent Investor, The",545000,545000,0,0
TIKI,cross-border-hang-quoc-te,11573091,"HOLY BIBLE: King James Version (KJV) Popular Gift & Award Black Leatherette Edition: Authorized King James Version (Bible Akjv)",439000,439000,0,0
TIKI,cross-border-hang-quoc-te,195282895,"Nước Uống Đẹp Da Liquid Collagen One Per Day Drink Mix Mỹ",589000,589000,0,0
TIKI,cross-border-hang-quoc-te,46362176,"Tai Thay Thế Miếng Lót Đệm Tai Nghe Sony MDR-V150 V250 V300 V100 V200 V400 ZX100 ZX300 Tai Nghe",157000,157000,0,0
TIKI,cross-border-hang-quoc-te,112018071,"Giá đỡ bánh xe đạp chuyên dụng chất lượng cao trong nhà có thể gập lại được",587000,587000,0,0
TIKI,cross-border-hang-quoc-te,17966282,"Wine Folly: Magnum Edition",999000,999000,0,0
TIKI,cross-border-hang-quoc-te,108227401,"Tấm bảo vệ màn hình chống ánh sáng xanh cho máy tính với khung hình 16: 9 -Size 14 "16 & 9",172000,172000,0,0
TIKI,thoi-trang-nu,107764628,"Áo thun nữ form rộng tay lỡ mặt cười ( trắng, đen, hồng) áo thun nữ tay lỡ áo thun nữ(cam kết như hình )",58000,58000,0,0
TIKI,cross-border-hang-quoc-te,165017868,"Sách - Seven Husbands of Evelyn Hugo : Tiktok made me buy it! by TAYLOR JENKINS REID (UK edition, paperback)",399000,399000,0,0
TIKI,cross-border-hang-quoc-te,190229589,"Vỉ 6 Hộp Chỉ Nha Khoa Oral-B Glide Advanced Multi-Protection Floss Mỹ 44m(hộp)",446000,446000,0,0
TIKI,thoi-trang-nu,68960906,"Đồ lót nữ trong suốt gợi cảm - Trắng",19000,19000,0,0
TIKI,thoi-trang-nu,37126497,"( 10 cái ) quần lót nữ Su đúc không đường may, hàng đẹp loại xịn W19_503",135000,135000,0,0
TIKI,thoi-trang-nu,21129341,"Bộ 2 Áo Ngực Nữ Cotton Không Gọng Miley Lingerie BRW_03",399000,580000,181000,31
TIKI,cross-border-hang-quoc-te,17966869,"The 48 Laws Of Power by Robert Greene",549000,549000,0,0
TIKI,thoi-trang-nu,118027755,"Đồ Lam Đi Chùa # La Hán Nam Nữ # Đồ Bộ Nam Nữ # Quần Áo Nam Nữ",211000,211000,0,0
TIKI,thoi-trang-nu,7595886,"Áo Kiểu Nữ Tay Loa Hoa Nhí MS0093A",180000,180000,0,0
TIKI,cross-border-hang-quoc-te,170695688,"Sách - A Good Girl's Guide to Murder by Holly Jackson (US edition, paperback)",406000,406000,0,0
TIKI,thoi-trang-nu,17041690,"Áo khoác đi nắng chống bui, khóa kéo che cổ Phúc An DN0001",143100,143100,0,0
TIKI,thoi-trang-nu,72606150,"Váy ngủ lụa xẻ người dây buộc hông",99000,99000,0,0
TIKI,thoi-trang-nu,191500992,"Áo Lót Nữ Áo Ngực Nữ Su Đúc Không Gọng Nâng Ngực Thông Hơi Không Hằn Mỡ Cao Cấp",18000,18000,0,0
TIKI,thoi-trang-nu,6640013,"Quần Độn Mông Đúc Dạng Đùi Nâng Mông Cao Cấp",75000,75000,0,0
TIKI,thoi-trang-nu,72478789,"Áo 2 Dây cotton Dáng Ôm Cho Nữ",50000,50000,0,0
TIKI,thoi-trang-nu,118022753,"Đồ Lam Đi Chùa # Bà Lai 2 Túi Áo # Đồ Bộ # Quần Áo Nữ",157000,157000,0,0
TIKI,cross-border-hang-quoc-te,2043735,"The Culture Map: Decoding How People Think, Lead, And Get Things Done Across Cultures",481000,481000,0,0
TIKI,thoi-trang-nu,169459230,"Đầm ngủ váy ba lỗ sườn xám cách tân sang chảnh",144000,144000,0,0
TIKI,thoi-trang-nu,84529116,"ÁO THUN TRƠN CROPTOP TAY NGẮN DÁNG ÔM VẢI XỊN ĐẸP- ảnh thật sp",78000,78000,0,0
TIKI,thoi-trang-nu,58668155,"Aó lót ren Triumph D 337 WHU - Màu hồng da - có gọng , mút dầy , mút có thể tháo rời",550000,799000,249000,31
TIKI,thoi-trang-nu,179417238,"Quần short nữ ống rộng cá tính, quần đùi nữ ống rộng chất đũi mát siêu đẹp Y1",175000,175000,0,0
TIKI,thoi-trang-nu,58120696,"Quần lót BARE S1030266-ZY",99000,359000,260000,72
TIKI,cross-border-hang-quoc-te,113349197,"Sách - How to Fight by Thich Nhat Hanh Jason Deantonis - (UK Edition, paperback)",236000,236000,0,0
TIKI,thoi-trang-nu,74441778,"Áo Ngực Nữ Không Gọng Thun Lạnh Mút Mỏng Hoa Văn Active Miley Lingerie - Màu Xanh BRM07015",210000,470000,260000,55
TIKI,thoi-trang-nu,192781555,"YU CHERRY | Đầm Mina Cami Dress YD146",350000,350000,0,0
TIKI,thoi-trang-nu,182729631,"Đầm suông linen tay lỡ cổ phát V, chất vải linen tự nhiên mềm mát, thời trang cho phái nữ Da78",282555,299000,16445,6
TIKI,cross-border-hang-quoc-te,7917829,"Good To Great: Why Some Companies Make The Leap",394000,394000,0,0
TIKI,thoi-trang-nu,174211231,"Set bộ đi chơi linen sát nách màu xanh đá trẻ trung sang trọng ArcticHunter, thời trang thương hiệu chính hãng",289000,289000,0,0
TIKI,thoi-trang-nu,178229107,"Váy ngủ ren tà dài đan chéo ngực sexy cao cấp Q505 - Đầm ngủ nữ 2 dây quyến rũ - Đồ ngủ nữ gợi cảm sexy",129000,199000,70000,35
TIKI,thoi-trang-nu,57726141,"Đồ bộ nữ chất liệu cotton quần caro áo thiêu chứ 1141",99000,99000,0,0
TIKI,thoi-trang-nu,78281774,"Chân váy jeans nữ đơn giản , xinh xắn, dễ phối mọi loại trang phục siêu xinh",84550,89000,4450,5
TIKI,thoi-trang-nu,96080189,"Đầm suông dáng hoa tulip thêu họa tiết trẻ ArcticHunter - Trắng",169000,169000,0,0
TIKI,cross-border-hang-quoc-te,109435783,"Nút tai silicon Bluedio NE -40dB Giảm tiếng ồn Cách âm Bảo vệ tai Chống ồn khi ngủ và đi bơi",150000,150000,0,0
TIKI,thoi-trang-nu,89479713," Băng Dính Cố Định Vị Trí Áo (fashion tape)",23570,23570,0,0
TIKI,thoi-trang-nu,167561204,"Quần đùi pyjama nữ ngắn lụa Satin hoạ tiết icon iBasic HOMW028B",139000,199000,60000,30
TIKI,cross-border-hang-quoc-te,174400333,"Sách - The Power of Geography : Ten Maps That Reveal the Future of Our World by Tim Marshall (UK edition, paperback)",384000,384000,0,0
TIKI,thoi-trang-nu,180608792,"Đầm Quý Bà Đầm Trung niên Đầm cho mẹ đầm Suông Họa Tiết Sang Trọng - Siêu Cao Cấp",498000,498000,0,0
TIKI,thoi-trang-nu,174219974,"Quần nữ dáng suông, lưng bo chun thoải mái, chất đũi mặc mát Đũi Việt DV38",149000,169000,20000,12
TIKI,thoi-trang-nu,70933997,"Áo len nữ dài tay cổ tròn mẫu mới siêu đẹp Haint Boutique al46",179550,189000,9450,5
TIKI,thoi-trang-nu,63585201,"Chân váy xòe vải cotton không nhăn họa tiết trái tim VAY81",189000,189000,0,0
TIKI,thoi-trang-nu,191756961,"[ĐẸP CHẤT] Đầm yếm jean dài cài nút xẻ tà dáng suông mềm mại năng động C082",277000,277000,0,0
TIKI,thoi-trang-nu,101686465,"Áo vest Linen blaze nữ ve vuông dáng lửng tay dài ArcticHunter, thời trang hè thu 2021",280000,280000,0,0
TIKI,cross-border-hang-quoc-te,191781146,"Sách - Beyond O.rder : 12 More Rules for Life by Jordan B. Peterson (UK edition, paperback)",396000,396000,0,0
TIKI,thoi-trang-nu,67048080,"Đầm suông đũi cổ trụ ArcticHunter, thời trang thương hiệu chính hãng",199000,199000,0,0
TIKI,thoi-trang-nu,67225104,"Quần tây baggy công sở bigsize lưng thun nữ",149000,149000,0,0
TIKI,thoi-trang-nu,116402810,"Bộ Scrubs bác sĩ phẫu thuật, hộ lý, điều dưỡng phòng mổ cao cấp màu Xanh Lá - NAM",290000,290000,0,0
TIKI,thoi-trang-nu,83159018,"Áo Sơ Mi Nữ Ngắn Tay Hai Màu Xanh Trắng",157000,157000,0,0
TIKI,thoi-trang-nu,9969791,"Đầm Nữ Trung Niên 23TBB ",268000,268000,0,0
TIKI,cross-border-hang-quoc-te,114051039,"Sách - High Output Management by Andrew S. Grove - (US Edition, paperback)",469000,469000,0,0
TIKI,thoi-trang-nu,33694112,"Áo len nữ freesize tay ngắn 15",122550,129000,6450,5
TIKI,thoi-trang-nu,181428892,"Áo kiểu nữ cổ voan bèo nhẹ nhàng, thích hợp đi chơi du lịch, thời trang xuân hè 2022 - Vàng",82600,82600,0,0
TIKI,the-thao-da-ngoai,176166906,"Dây Nhảy FED XM0105 - Dây Nhảy Tăng Thể Lực Giúp Thân Hình Cân Đối Săn Chắc Và Đẹp - Hàng Chính Hãng",385000,450000,65000,14
TIKI,the-thao-da-ngoai,75722804,"Túi Đấm Bốc Boxing Cho Trẻ Em Hình Người Nhện Đỏ Size Trung 37*18*18 cm, Kèm 2 Găng Tay Cho Bé+Tặng Kèm Hình Dán",139000,139000,0,0
TIKI,the-thao-da-ngoai,213868966,"Sữa Tăng Cân Tăng Cơ Mass Tech Elite 6lbs (~2.72kg) - Nhiều Hương Vị - Hàng Nhập Khẩu Chính Hãng Muscletech - Kèm Quà Tặng",1495000,1875000,380000,20
TIKI,the-thao-da-ngoai,108480875,"Mã hàng KT1.HT – Xà đơn xếp Khánh Trình hai tầng dành cho cả trẻ em và người lớn",1820000,1820000,0,0
TIKI,the-thao-da-ngoai,133772727,"Túi Ngủ Văn Phòng Du Lịch, Phượt Cá Nhân, Túi Ngủ Mùa Đông - 3 Lớp Cao Cấp - Gói Gọn Tiện Ích- Hàng Chính Hãng MINIIN",199000,199000,0,0
TIKI,the-thao-da-ngoai,105791646,"Bảng phi tiêu 40cm  + 6 phi tiêu nam châm",430000,430000,0,0
TIKI,the-thao-da-ngoai,180567273,"Đồ bơi nam quần lửng áo cộc tay đẹp",330000,330000,0,0
TIKI,the-thao-da-ngoai,254091226,"BỘ ĐÔI TẠ 30KG BG Tạ Tập Tay Đa Năng Điều Chỉnh 2 in 1 Kết Hợp Tạ Đẩy ( hàng nhập khẩu)",699000,999000,300000,30
TIKI,the-thao-da-ngoai,185966772,"Bộ Tăng Dã Ngoại Cắm Trại Lục Giác Naturehike NH16T012-S",1490000,1490000,0,0
TIKI,the-thao-da-ngoai,92533531,"Mũ Bơi Người Lớn,Nón Bơi Cho Nữ Tóc Dài Chất Liệu 100% Silicon Co giãn,Chống Nước,Thoải Mái Đại Nam Sport",89000,150000,61000,41
TIKI,the-thao-da-ngoai,144611597,"Bình nước thể thao | Bình nước xe đạp thể thao Sahoo 700ml ",87000,87000,0,0
TIKI,the-thao-da-ngoai,92807916,"La bàn kim loại cầm tay bỏ túi 70mm ",33950,33950,0,0
TIKI,the-thao-da-ngoai,89476448,"Bộ Tạ Loại 1kg bọc cao su (Tổng 2kg)",116000,230000,114000,50
TIKI,the-thao-da-ngoai,150342336,"Bó Cổ Chân, Băng Cổ Chân, Bảo Vệ Mắt Cá Chân, Bảo Vệ Tránh Băng Gân",69000,69000,0,0
TIKI,the-thao-da-ngoai,188377225,"Phao câu đài Nano Tăm To Độ Ổn Định Cao Truyền Tin Nhanh Chính Xác PC28",29000,29000,0,0
TIKI,the-thao-da-ngoai,55463985,"Ống lăn massage gai 33cm- CON LĂN MASSAGE TẬP YOGA GAI  Thể Dục Thẩm Mỹ Gym Massage Giãn Cơ Tập Tạ - Chất liệu EVA PVC Cao Cấp",200000,200000,0,0
TIKI,the-thao-da-ngoai,56866299,"Túi ngủ văn phòng du lịch V2108 (Giao màu ngẫu nhiên)",115000,115000,0,0
TIKI,the-thao-da-ngoai,10785162,"Lều 2 Người Phượt Cắm Trại Du Lịch Galaxy Store Tetragon 2PLE01 Hàng Xuất Khẩu Châu Âu (Màu Ngẫu Nhiên)",579000,920000,341000,37
TIKI,the-thao-da-ngoai,173277026,"Giày Thể Thao Nam Biti's Hunter Core 3D-Airmesh Grey DSMH08700XAL (Xám)",662000,736000,74000,10
TIKI,the-thao-da-ngoai,34811029,"Banh Bóng Rổ Geru Cam",97000,97000,0,0
TIKI,the-thao-da-ngoai,162042284,"Giàn Tạ Đa Năng Zasami Có xà đơn xà kép gồm 1 đòn tạ 1m5 - Lựa chọn mức tạ đĩa nhựa ngẫu nhiên",5500000,7250000,1750000,24
TIKI,the-thao-da-ngoai,89477087,"Xà Đơn – Xà kép Đa Năng EX30 Bản Cao Cấp Tiêu Chuẩn Phòng Gym(Tặng Kìm Bóp Cơ Tay 5-60kg)",2789000,5000000,2211000,44
TIKI,the-thao-da-ngoai,143808230,"Đai dù (phụ kiện) cho dụng cụ kéo giãn đốt sống cổ, vật liệu vải dù DAIKC01",79000,79000,0,0
TIKI,the-thao-da-ngoai,76696769,"Thảm Fitness Yoga Adidas 10mm ADMT-11015",1098000,1208000,110000,9
TIKI,the-thao-da-ngoai,159906214,"Áo bơi nữ Zoggs Quay - 462347",430000,859000,429000,50
TIKI,the-thao-da-ngoai,146763912,"Gối Ngủ Du Lịch Chất Liệu Memory Foam Mật Độ Cao - Gối Ngủ Văn Phòng Thông Minh Cao Cấp Chính Hãng Dododios – Kèm Túi Vải Nhung Đựng Gối Ngủ Chữ U Văn Phòng",349000,349000,0,0
TIKI,the-thao-da-ngoai,177061983,"Bộ đồ chơi bóng rổ trẻ em",115000,115000,0,0
TIKI,the-thao-da-ngoai,20847679,"Bật lửa ZIPPO 207 –Bật lửa ZIPPO STREET CHROME",535000,535000,0,0
TIKI,the-thao-da-ngoai,138725435,"Mồi câu cá giả mềm 90mm/14g có 6 màu",13300,13300,0,0
TIKI,the-thao-da-ngoai,271392535,"Viên Sủi GU ENERGY Hydration Drink Tabs - Ống 12 Viên - Bổ Sung Nước Và Điện Giải Khi Hoạt Động Thể Thao - Ống 12 viên",185000,185000,0,0
TIKI,the-thao-da-ngoai,111928268,"Bộ quần áo bóng đá câu lạc bộ Liverpool mùa giải mới - Áo bóng đá CLB ngoại hạng Anh - Bộ đồ bóng đá đẹp",95000,150000,55000,37
TIKI,the-thao-da-ngoai,117391192,"Lưỡi Câu Cá Đôi Buộc Sẵn Chuyên Câu Đài",33000,33000,0,0
TIKI,the-thao-da-ngoai,16997248,"Bình Nước Xếp Gọn Du Lịch Cắm Trại Dã Ngoại Naturehike NH14S002-T",90000,90000,0,0
TIKI,the-thao-da-ngoai,38074373,"Găng Bao Tay Xỏ Ngón MMA Boxing Đấm Bốc Người Lớn Amalife - Găng Tay Xỏ Ngón MMA Cao Cấp",102000,102000,0,0
TIKI,the-thao-da-ngoai,158615618,"Bàn Xếp Gấp Gọn Du Lịch Và Dã Ngoại Dễ Mang Theo Khi Đi Cắm Trại Picnic Ăn Uống Cùng Gia Đình - Hàng Chính Hãng",626000,626000,0,0
TIKI,the-thao-da-ngoai,83783760,"Dụng cụ cầm tay đa năng Leatherman Free T4 (12 tools)",1950000,1950000,0,0
TIKI,the-thao-da-ngoai,152074922,"Ghế Vớt Tạ đa năng Zasami ",590000,850000,260000,31
TIKI,the-thao-da-ngoai,198522142,"Khung Hỗ Trợ Tập Lưng, Nắn Chỉnh Cột Sống, Khung Định Hình Cột Sống, Hỗ Trợ Điều Trị Thoát Vị Đĩa Đệm, Đau Lưng, Vai Gáy - Chính Hãng",95000,95000,0,0
TIKI,the-thao-da-ngoai,53926218,"Túi Đai Đeo Bụng Hông Chạy Bộ Có Ngăn Đựng Bình Nước JP1",175000,175000,0,0
TIKI,the-thao-da-ngoai,10689279,"Thảm tập yoga định tuyến PU Liforme 4.2mm",4197000,4617000,420000,9
TIKI,bach-hoa-online,15058426,"Khô Gà Lá Chanh Thượng Hạng DTfood 1kg",160550,169000,8450,5
TIKI,bach-hoa-online,99078125,"Lốc 5 Gói Mỳ Jin Rong Biển Ottogi 120g",66200,66200,0,0
TIKI,bach-hoa-online,54022812,"Combo 3 Túi Hạt Bí Rang Trọng Nhân 500gr",239000,239000,0,0
TIKI,bach-hoa-online,56710337,"Ngũ Cốc Lợi Sữa Hena 500g - Giúp Mẹ Bầu có Sữa Về Nhiều Nhanh Đặc Chỉ Sau 3 Ngày - Cải Thiện Chất Lượng Sữa - Bột Ngũ Cốc Bà Bầu Cao Cấp từ 24 Hạt Hữu Cơ - 100% Tự Nhiên - Sản Phẩm Chính Hãng",199000,199000,0,0
TIKI,bach-hoa-online,72885233,"Mè Rang Ăn Liền Hũ 100g - Thực phẩm thuần chay dinh dưỡng",25300,25300,0,0
TIKI,bach-hoa-online,101177557,"Cám cá stella cho cá koi s2,s3,s5,s7 | Túi zip 1kg",32000,32000,0,0
TIKI,bach-hoa-online,177265591,"Dầu hào Lee Kum Kee Panda Brand Oyster Sauce hiệu Gấu trúc với chiết xuất hào chọn lọc 11",45000,45000,0,0
TIKI,bach-hoa-online,137759080,"Thức ăn cho mèo Hàn Quốc Cats eye Kitten and Cat Hộp 1kg cho mèo trên 3 tháng tuổi ",85280,85280,0,0
TIKI,bach-hoa-online,150681306,"Combo 2 túi Táo Đỏ Khô Tân Cương Trading Perfect Partner (500g/túi) _ Táo đỏ khô mùa mới, quả to, mềm, xốp, thịt dày vỏ mỏng",166000,166000,0,0
TIKI,bach-hoa-online,154698931,"Kẹo hương thập cẩm dẻo L'angfarm, 180g, bịch, mẫu túi bạc",26000,26000,0,0
TIKI,bach-hoa-online,161462742,"Thùng 24 chai nước uống sữa trái cây cam tự nhiên TH True Juice Milk 300ml (300ml x 24)",270994,270994,0,0
TIKI,bach-hoa-online,88909447,"[COMBO 2 HŨ] Trái cây sấy khô loại nguyên miếng cao cấp xuất khẩu - TỔNG 560G",92000,99000,7000,7
TIKI,bach-hoa-online,106807279,"Thùng 48 Hộp Sữa Chua Uống Tiệt Trùng Vinamilk Susu 110ml - Hương Dâu",204000,249000,45000,18
TIKI,bach-hoa-online,137850728,"Thùng 24 chai Nước Khoáng Kiềm Thiên Nhiên Vikoda 350ml",105000,105000,0,0
TIKI,bach-hoa-online,88909459,"[Combo 2 Hũ Tổng 400G] Khô cá thiều que tẩm gia vị đặc sản ăn vặt siêu ngon",98000,98000,0,0
TIKI,bach-hoa-online,92523389,"Thức ăn chó Pedigree vị thịt bò & rau củ túi 1.5kg",111000,111000,0,0
TIKI,bach-hoa-online,50425577,"Nước mắm truyền thống Phú Quốc Hồng Hạnh Cốt Nhỉ 40 độ đạm dung tích 500ML - Chấm sống tuyệt ngon, vẹn tròn dưỡng chất",95920,109000,13080,12
TIKI,bach-hoa-online,77283146,"Trân châu thủy tinh Yoki 300g (10*30g)",35000,35000,0,0
TIKI,bach-hoa-online,47242035,"Ngũ Cốc Calbee",137000,137000,0,0
TIKI,bach-hoa-online,31975546,"Nước Dừa Xiêm VICO FRESH 1L",68000,68000,0,0
TIKI,bach-hoa-online,155187416,"CHAI XỊT KHỬ MÙI HÔI THÚ CƯNG, KHỬ MÙI HÔI NƯỚC TIỂU CHÓ MÈO, CÁT VỆ SINH, KHAY, LỒNG, CHUỒNG CHÓ MÈO-XCLEAN PET 500ML-NANO BẠC AHT CORP (AHTC)",89100,148500,59400,40
TIKI,bach-hoa-online,106807277,"Thùng 48 Hộp Sữa Chua Uống Tiệt Trùng Vinamilk Susu 110ml - Hương Cam",210000,249000,39000,16
TIKI,bach-hoa-online,59205264,"Bạt lót ao hồ HDPE",120000,120000,0,0
TIKI,bach-hoa-online,189361532,"Pate cho mèo NEKKO GRAVY 70g",14000,20000,6000,30
TIKI,bach-hoa-online,134515737,"Muối Chẩm Chéo Điện Biên 250g, đặc sản dân tộc Thái Mường Phăng, hũ to siêu ngon loại nhiều mắc khén thơm lừng",27000,40000,13000,33
TIKI,bach-hoa-online,53224414,"Natural Nghệ bột 40gr Dh Foods - Bột nghệ nguyên chất 100%",15000,15000,0,0
TIKI,bach-hoa-online,161462918,"Thùng 24 chai nước uống sữa trái cây dâu tự nhiên TH True Juice Milk 300ml (300ml x 24)",270994,270994,0,0
TIKI,bach-hoa-online,3088445,"Cà Phê Cappuccino Aik Cheong Cafe Art (12 Gói x 25g)",118990,155000,36010,23
TIKI,bach-hoa-online,145092303,"Trà Sữa Teh Tarik Vị Cổ Điển Aik Cheong Malaysia - Teh Tarik Classic 3 In 1 - 600g (15 Gói x 40g)",120000,145000,25000,17
TIKI,bach-hoa-online,48601459,"Sườn non chay Khánh An 1kg. Hàng chính hãng, sản xuất tại Việt Nam,  nguyên liệu đảm bảo an toàn, không sử dụng chất biến đổi gen và chất bảo quản. Hàm lượng Protein cao.",125100,139000,13900,10
TIKI,bach-hoa-online,16176611,"Combo 2 Hộp Táo Đỏ Khô Cao Cấp Smile Nuts (500g/hộp)",175000,252000,77000,31
TIKI,bach-hoa-online,76681202,"Tổ Yến Sào Tinh Chế (3 Tổ/24g/Hộp) (Tổ Yến làm sạch/Tổ Yến Sạch chế biến từ Tổ Yến Thô /Tổ Yến còn lông) Yến Sào Trung Nam",1196000,1300000,104000,8
TIKI,bach-hoa-online,73110081,"Pa tê gan ngỗng hiệu Glavproduct, 90 g",35000,35000,0,0
TIKI,bach-hoa-online,271615582,"Sữa Milo Nestle chính hãng nội địa Úc 1kg - Phát triển chiều cao, tràn đầy năng lượng - OZ Slim Store",364000,728000,364000,50
TIKI,bach-hoa-online,178509637,"Yến Thị- Chưng Đường Phèn-Chưng Sẵn -30% YẾN-70ml",290000,320000,30000,9
TIKI,bach-hoa-online,273963048,"Si Rô VinaSyrup 750ml - 21 Vị Trái Cây Tự Nhiên",30000,30000,0,0
TIKI,bach-hoa-online,70815886,"Gạo Nếp Chùm Vinh Hiển túi 1Kg - Nếp Sạch 3 Không - Gạo nếp dẻo, thơm xôi mới thuộc thương hiệu Gạo Vinh Hiển",28000,28000,0,0
TIKI,bach-hoa-online,89624989,"Tương ớt Chilica 255g",42900,42900,0,0
TIKI,bach-hoa-online,29263873,"Nước dùng Dashi tảo bẹ Kombu Yamasa 500ml",99000,118000,19000,16
TIKI,bach-hoa-online,161387002,"Thùng 24 chai nước táo đào tự nhiên TH True Juice 350ml (350ml x 24)",424155,424155,0,0
TIKI,thoi-trang-nam,16910398,"Combo 5 Quần Lót Nam vải cotton 2 chiều lưng CITYMEN, màu ngẫu nhiên, đồ lót - LMTK-CTM2C",100000,100000,0,0
TIKI,thoi-trang-nam,125355106,"Áo sơ mi đoàn thanh niên nam nữ dài tay Ocean Uniform hàng thường",75000,75000,0,0
TIKI,thoi-trang-nam,81825319,"Quần đùi nam mặc ở nhà quần thun lạnh mềm mát hút mồ hôi tốt size 50-80kg",28000,28000,0,0
TIKI,thoi-trang-nam,84750552,"QUẦN LÓT BOXER NAM ROSSO 0002 - UNDERWEAR",120000,120000,0,0
TIKI,thoi-trang-nam,106700331,"Quần Jean Nam Vovesa Mẫu Mới, Dáng Ôm Trẻ Trung, Nam Tính Q3",99000,99000,0,0
TIKI,thoi-trang-nam,21601483,"Combo 4 quần lót nam quần sịp tam giác nam đúc tàng hình cao cấp",319000,319000,0,0
TIKI,thoi-trang-nam,159100290,"Áo sơ mi nam Oscar tay ngắn - OCMSCSF 046",349000,1990000,1641000,82
TIKI,thoi-trang-nam,103596737,"Áo Blazer Caro 2 Lớp Nam Nữ Form Dáng Rộng Phong Cách Hàn Quốc BZ15",349000,349000,0,0
TIKI,thoi-trang-nam,125614162,"OWEN - Quần kaki nam Owen chất thô giấy mềm mại co dãn màu đen 21993/22006",595000,595000,0,0
TIKI,thoi-trang-nam,105708174,"Áo Khoác Big Size Áo Khoác Dù Nam Có Nón Cổ Trụ Chống Nắng Chống Nóng Chống Lạnh Chống Gió 2 Lớp Phối Logo Thời Trang Nam Tính Hàn Quốc Giá Tốt ShopN6 - QD58",199000,245000,46000,19
TIKI,thoi-trang-nam,20518200,"Quần Kaki Nam Khatoco Q2M528S0-VNMA007-1811-0003",199000,528000,329000,62
TIKI,thoi-trang-nam,83377872,"Quần Bò Nam cao cấp thương hiệu Chandi, chất jean co dãn mẫu mới nhất MA195",194000,289000,95000,33
TIKI,thoi-trang-nam,6982965,"Quần Jogger Kaki Nam Chất Mát - Rằn Ri T06",72000,72000,0,0
TIKI,thoi-trang-nam,131906300,"Áo Thun Tay Lỡ Freesize Nam Nữ 40-70kg",31000,31000,0,0
TIKI,thoi-trang-nam,19395506,"Quần tây âu nam dáng ôm vải co giãn nhẹ bền đẹp phong cách Hàn Quốc - Đen - 32",80000,80000,0,0
TIKI,thoi-trang-nam,87895026,"Bộ bơi nam họa tiết da cá, phom dáng đẹp ôm sát người, chất thun bơi dày đẹp, ít thấm nước, mau khô | BN010",350000,350000,0,0
TIKI,thoi-trang-nam,121635925,"Áo Khoác Nam Cách Nhiệt Vải Kaki Cao Cấp US ARMY U559, Áo Khoác Kaki Lính Lót Bông Cừu Siêu Ấm Phong Cách Cực Ngầu  -HÀNG CHÍNH HÃNG",520000,1198000,678000,57
TIKI,thoi-trang-nam,104110965,"Áo khoác jean nam cao cấp không phai không xù, áo khoác bò thiết kế trẻ trung năng động AK06",225000,225000,0,0
TIKI,thoi-trang-nam,55911268,"Áo Thun Nam Cổ Polo Họa Tiết KO888 Cao Cấp",157000,157000,0,0
TIKI,thoi-trang-nam,150184854,"( Sale 30%)Quần tây nam màu đen mix kẹp vuông phom hàn chuẩn, chất vải chéo cao cấp dáng ôm body.quần tây rẻ, bền",109000,109000,0,0
TIKI,thoi-trang-nam,74037420,"Áo khoác da nam , áo da nam . áo khoác nam",155000,155000,0,0
TIKI,thoi-trang-nam,169332884,"Áo chống nắng nam mặc 2 mặt thun lạnh lỗ kim thoáng mát, thấm hút mồ hôi mẫu mới Micado",250000,250000,0,0
TIKI,thoi-trang-nam,73915026,"Áo thun nam tay dài mặc thu đông giữ nhiệt chất cotton, áo giữ nhiệt nam co giãn, 5 màu lựa chọn, size áo từ 40-80kg, không bị bai xù khi giặt máy",94000,94000,0,0
TIKI,thoi-trang-nam,56919853,"Áo Len Cổ Lọ Nam SZone SAL222 Phong Cách Hàn Quốc",129000,129000,0,0
TIKI,thoi-trang-nam,63037905,"Áo khoác gió cách nhiệt GOKING có mũ, form unisex cho nam nữ. Ngoài vải dù, trong lót vải cào cách nhiệt. 3 túi to rộng",255000,255000,0,0
TIKI,thoi-trang-nam,117921774,"Áo thun nam nữ unisex tay lỡ phông form rộng teen cổ tròn oversize cotton giá rẻ basic đen trắng tee pull 1997",38000,38000,0,0
TIKI,thoi-trang-nam,46688721,"Áo Khoác Da Bomber Nam",175000,175000,0,0
TIKI,thoi-trang-nam,195305781,"Combo 3 quần đùi mặc nhà - Giao màu ngẫu nhiên",270750,285000,14250,5
TIKI,thoi-trang-nam,155147237,"QUẦN KAKI NAM TÚI HỘP MÀU LÍNH",180000,180000,0,0
TIKI,thoi-trang-nam,129299572,"Quần thô Kaki Nam Trung Niên hàng chuẩn đẹp ẢNH THẬT",279000,279000,0,0
TIKI,thoi-trang-nam,167421285,"Quần Tây Âu Nam Co Giãn Nhẹ Dáng Ôm, Quần Nam Công Sở Lịch Sự Phù Hợp Mọi Hoàn Cảnh Thương Hiệu Chandi Mã MT2",189000,350000,161000,46
TIKI,thoi-trang-nam,181136946,"Áo sơ mi nam Slim fit ngắn tay xanh cổ vịt 171424N",445550,469000,23450,5
TIKI,thoi-trang-nam,18012630,"Quần dài thun jogger nam bo lưng thun Phúc An 1042",90000,90000,0,0
TIKI,thoi-trang-nam,80885842,"Quần Đùi Nam Kaki 6 Màu Trẻ Trung Phong Cách Hàn Quốc VICERO",159000,238000,79000,33
TIKI,thoi-trang-nam,136173457,"Áo phông nam, áo thun nam có cổ tay ngắn vải thun cotton 100% mặc thoáng mát - ATN05",83000,83000,0,0
TIKI,thoi-trang-nam,109840857,"Quần Jocker ống rộng bo gót in hình Heroes có túi sau sành điệu, quần thun nỉ dài ống rộng nam phong cách Hàn Quốc",92000,92000,0,0
TIKI,thoi-trang-nam,30030737,"Quần Khaki Nam Không Ply Ống Ôm Khatoco Q2M528S0-VNMA002-1811-0004",199000,528000,329000,62
TIKI,thoi-trang-nam,54762167,"Quần kaki nam không ply Khatoco Q2M528R0-INMA009-2107-0",199000,528000,329000,62
TIKI,thoi-trang-nam,105833043,"Áo khoác nam, Áo khoác jean, bò nam rách from rộng_màu xanh",170000,170000,0,0
TIKI,thoi-trang-nam,109150516,"Quần thun jogger logo in không bong tróc chất thun da cá mềm mịn form đẹp, quần dài nam heroes, Quần thể thao nam nữ mặc , quần thun nam ,quần dài nam, quần nỉ , quần jogger 2 sọc, quần thun",99000,99000,0,0
TIKI,the-thao-da-ngoai,147764196,"Quả Bóng Bàn Luyện Tập Thi Đấu 3W 40+ 2 Sao Độ Cứng Cao Tròn Đều Túi 100 quả.",390000,390000,0,0
TIKI,the-thao-da-ngoai,4594673,"Xà Đơn Treo Tường Gắn Cửa 2018 80-130cm",176000,219000,43000,20
TIKI,the-thao-da-ngoai,81609944,"Nón Bơi Silicone UNISEX SPEEDO",195000,195000,0,0
TIKI,the-thao-da-ngoai,192774683,"Gậy bẻ tập cơ tay lò xo đàn hồi Guang Yu lực từ 20kg đến 60kg",140000,145000,5000,3
TIKI,the-thao-da-ngoai,12728215,"Bể Bơi 4 Tầng Cho Bé Intime Cao Cấp Cỡ Lớn + Kèm Phao Đỡ Cổ",540000,540000,0,0
TIKI,the-thao-da-ngoai,34317815,"Đai bó đầu gối co giãn khi chơi thể thao",69000,79000,10000,13
TIKI,the-thao-da-ngoai,69518151,"Dây Nhảy Thể Dục( Lõi Thép bện ) Dài 2,9m Cải Tiến Cao Cấp Dây Nặng Tay Cầm Chắc Chắn Đủ Màu Sắc",47000,79000,32000,41
TIKI,the-thao-da-ngoai,144897408,"combo 10 bộ thẻo lưỡi đôi câu đài câu đơn buộc sẵn, phụ kiện câu đài - Cần Câu Top1 VN",25500,25500,0,0
TIKI,the-thao-da-ngoai,170752375,"Mũ Lưỡi Trai Chống Tia UV UPF50+ Naturehike NH18H009-T",180000,180000,0,0
TIKI,the-thao-da-ngoai,125603331,"Bảng Phi Tiêu Bóng Gai An Toàn Cho Bé",42000,42000,0,0
TIKI,the-thao-da-ngoai,101651414," Đệm Hơi Liền Gối Một Người Naturehike Dành Cho Văn Phòng, Du Lịch, Dã Ngoại NH15Q002-D",480000,480000,0,0
TIKI,the-thao-da-ngoai,52292808,"Móc Khóa Đa Năng 17in1 ( 17 chức năng trong 1)",125000,125000,0,0
TIKI,the-thao-da-ngoai,20931393,"Bóng Chuyền Hơi Jatan 250gr ",101990,101990,0,0
TIKI,the-thao-da-ngoai,162340921,"Quấn Cán Vợt Bóng Bàn - Cực Bám, Chống Trơn Do Mồ Hôi Tay",50000,50000,0,0
TIKI,the-thao-da-ngoai,167386240,"mồi mềm câu lure mồi cá mềm 9cm 5g",16600,16600,0,0
TIKI,the-thao-da-ngoai,52873171,"PTP Băng Tập Đàn Hồi - Bảng Trung Bình MICRO X HEAVY",425000,425000,0,0
TIKI,the-thao-da-ngoai,421912,"Tạ Nhập Khẩu - TNK-2Kg - Xanh Dương",205000,205000,0,0
TIKI,the-thao-da-ngoai,196911677,"Combo 3 dụng cụ hỗ rợ tập Yoga :  2 gạch tập Yoga in hoa văn họa tiết Mandala+ 1 dây đai tập Yoga sợi cotton , gạch cứng cáp đàn hồi thấm hút chịu lực tốt",97850,103000,5150,5
TIKI,the-thao-da-ngoai,74430510,"Giày bóng rổ trẻ em, giày bóng rổ học sinh nam basketball SST-A223BL màu đen phối trắng, đủ size từ 36-40",589000,620000,31000,5
TIKI,the-thao-da-ngoai,149578363,"Chì Lá Câu Cá Cuốn Sẵn Chuyên Câu Đài Câu Đơn -sét 10 viên",21000,21000,0,0
TIKI,the-thao-da-ngoai,132200007,"Dây thừng tập thể lực phòng gym cao cấp",750000,750000,0,0
TIKI,the-thao-da-ngoai,111509764,"Đai Nẹp Cố Định Khớp Cổ Tay Với 2 Thanh Nẹp Trên Dưới AOLIKES AL1671 1671 Cho Người Chấn Thương Bong Gân Cổ Tay",115000,115000,0,0
TIKI,the-thao-da-ngoai,149584336,"XẢ KHO Thùng đựng cá GW gấp gọn siêu bền",75241,75241,0,0
TIKI,the-thao-da-ngoai,14113629,"Trụ Hơi Đấm Bốc Tự Cân Bằng kèm bơm",160550,169000,8450,5
TIKI,the-thao-da-ngoai,148040904,"Mồi Câu Cá Tổng Hợp Huỳnh Khoa Chuyên Tra Trê Chim Chép Trắm Rô Phi Hồ Dịch Vụ, Sông Tự Nhiên",50000,50000,0,0
TIKI,the-thao-da-ngoai,192122947,"Cần Câu Cá Bỏ Túi Cầm Tay Dạng Ống Lồng Mini - Cần Câu Cá Hợp Kim Nhôm + Cần Câu",135000,135000,0,0
TIKI,the-thao-da-ngoai,2282183,"Quần áo lặn biển 3mm NAM (size M) - BLACK 1070 giữ ấm, bộ đồ lặn thoáng khí, chống thầm nước - POKI",1150000,1150000,0,0
TIKI,the-thao-da-ngoai,159730811,"Kính bơi trẻ em Zoggs Sonic Air Junior 2.0",277000,395000,118000,30
TIKI,the-thao-da-ngoai,43699172,"Giày Đá Bóng Sân Cỏ Nhân Tạo Cổ Thun Mới",265000,265000,0,0
TIKI,the-thao-da-ngoai,16258135,"Bộ đồ tập GYM nam - HM 111",97000,97000,0,0
TIKI,the-thao-da-ngoai,12755007,"Túi ngủ văn phòng (giao màu ngẫu nhiên)",104991,104991,0,0
TIKI,the-thao-da-ngoai,87666653," hộp mồi câu trắm, chép dạng viên siêu nhạy",17000,17000,0,0
TIKI,the-thao-da-ngoai,46760802,"Sét vỏ bao cát đấm bốc boxing 3 lớp + găng mma hở ngón cao cấp + băng đa 5 m siêu bền - Tặng kèm dây xích + móc treo + vít nở sắt",350000,350000,0,0
TIKI,the-thao-da-ngoai,126414776,"Kính bơi nữ Speedo Futura Biofuse Flexiseal - 8-11314B978",495000,495000,0,0
TIKI,the-thao-da-ngoai,149635464,"Siêu Khuyến Mãi 1 kg Bi Sắt 6mm, 7mm, 8mm - Đồ câu 24h - Cần Câu Top1 VN",38500,38500,0,0
TIKI,the-thao-da-ngoai,90526870,"Bộ Giày Trượt Patin Trẻ Em Người Lớn DNS906 Tăng Giảm Size Bánh Cao Su Phát Sáng Đại Nam Sport + Kèm Full Bộ Bảo Hộ",599000,800000,201000,25
TIKI,the-thao-da-ngoai,177190834,"Con Lăn Foam Roller Massage Gai 33cm - Ống Lăn Dãn Cơ Tập Gym, Yoga, Thể Hình",218000,218000,0,0
TIKI,the-thao-da-ngoai,184634737,"Găng tay tập gym, bao tay hở ngón bảo vệ bàn tay, có dây quấn trợ lực cổ tay BTFA01",37050,39000,1950,5
TIKI,the-thao-da-ngoai,52715548,"Thảm tập yoga định tuyến cao cấp DOPI DP1102-2 Chất liệu TPE siêu bám",109000,109000,0,0
TIKI,the-thao-da-ngoai,1747449,"Phao Tay Trẻ Em Roll-Ups",42000,52000,10000,19
TIKI,bach-hoa-online,119657297,"CÀ PHÊ BLAGU HẠT ĐÃ RANG, GURU 3 BLEND COLD BREW – SWEET COLD, MEDIUM ROAST, 250G",170000,170000,0,0
TIKI,bach-hoa-online,20784418,"Sinh tố Osterberg Việt Quất 1L",140000,140000,0,0
TIKI,bach-hoa-online,19414416,"Tấm lót sàn nhựa cho vật nuôi",49898,49898,0,0
TIKI,bach-hoa-online,191354533,"Đặc Sản Kon Tum - 200Gr Khổ Qua Rừng Sấy Khô Nguyên Trái - Có Hút Chân Không - OCOP 3 Sao",80000,80000,0,0
TIKI,bach-hoa-online,94747329,"Đặc Sản Phú Quốc - Hộp 6 Chai Thủy Tinh Nước Mắm Phú Quốc Khải Hoàn 43 Độ Đạm (520Ml X 6) - Ocop 5 Sao",698000,698000,0,0
TIKI,bach-hoa-online,115280887,"Bộ 6 túi thức ăn cho chó lớn dạng sốt Pedigree vị bò và rau củ 130g",114000,114000,0,0
TIKI,bach-hoa-online,58336136,"SỮA BỔ SUNG CANXI -  GLUCOSE PLAN - Dinh dưỡng cho chế độ ăn đặc biệt giúp bổ sung canxi, chống loãng xương, tăng cường hệ tiêu hóa",465000,465000,0,0
TIKI,bach-hoa-online,144486459,"[ Combo 7 Hộp ] Yến Thiên Hoàng 15% Không Đường ( 6 Lọ/ Hộp) + TẶNG 3 LON YẾN",878000,878000,0,0
TIKI,bach-hoa-online,58503630,"Mơ Trung Đông sấy lạnh không đường Kentary túi 200 gram - Trái cây sấy giúp giảm cân",165000,165000,0,0
TIKI,bach-hoa-online,53268663,"Gạo Hạt Ngọc Trời Lứt Tím 1Kg",54000,54000,0,0
TIKI,bach-hoa-online,22475236,"Muối biển tinh khiết 500g",20000,20000,0,0
TIKI,bach-hoa-online,42013180,"Hạt điều rang muối vỏ lụa SVIET",106000,106000,0,0
TIKI,bach-hoa-online,2984271,"Cà Phê Sáng Tạo 5 Trung Nguyên (340g) - 2 gói",248000,248000,0,0
TIKI,bach-hoa-online,51102880,"Trà Gừng DRAGON",38000,38000,0,0
TIKI,bach-hoa-online,170107925,"Giấm táo hữu cơ Bragg 473ml & 946ml - Hàng Mỹ",320000,390000,70000,18
TIKI,bach-hoa-online,108933538,"Thức ăn cho mèo Reflex Kitten Food Chicken & Rice (2Kg)",185999,185999,0,0
TIKI,bach-hoa-online,216401116,"Trà Dưỡng Tâm Hộp 30 Gói Túi Lọc x10gr Gồm Long Nhãn, Kỷ Tử, Táo Đỏ Của Siêu Thị Thiên Nhiên",4999,4999,0,0
TIKI,bach-hoa-online,15353730,"Khô Gà Lá Chanh Thượng Hạng DTfood (500g)",89000,89000,0,0
TIKI,bach-hoa-online,14709221,"Trà Shan Tuyết Cổ Thụ Tà Xùa Lộc Tân Cương (100gr)",119000,119000,0,0
TIKI,bach-hoa-online,40742154,"Combo 5 hộp Gạo Hữu Cơ Hoa Nắng - Vàng Lúa Chín 2kg",720000,720000,0,0
TIKI,bach-hoa-online,217610747,"Thức Ăn Cho Cá CLEAN FOOD ( 500GR) Cao Cấp, Phù Hợp Mọi Loại Cá Cảnh, Giàu Dinh Dưỡng, Giúp Cá Lớn Nhanh, Lên Màu Đẹp",60800,64000,3200,5
TIKI,bach-hoa-online,59271101,"1KG HẠT ĐIỀU NGUYÊN RANG TỎI ỚT LOẠI CAO CẤP THƯƠNG HIỆU SK FOOD",109000,109000,0,0
TIKI,bach-hoa-online,29253172,"Viên cà ri Golden Curry vị cay vừa 198g (8 viên)",79000,79000,0,0
TIKI,bach-hoa-online,100095268," COMBO MÁY SỦI OXY TÍCH ĐIỆN JEBO 9950 TẶNG BỘ PHỤ KIỆN ĐI KÈM, DÂY OXY, ĐÁ SỦI",200000,200000,0,0
TIKI,bach-hoa-online,4681925,"Bột ngũ cốc dinh dưỡng cao cấp 22 dưỡng chất hiệu 22 Complete Nutrimix - Chia Seed (Hạt chia) - hộp thiếc 750g",522500,522500,0,0
TIKI,bach-hoa-online,141095821,"Thức Ăn Hạt Classic Pet Adult Cho Chó Trưởng Thành 400g",18000,18000,0,0
TIKI,bach-hoa-online,14657236,"Nhụy hoa nghệ tây Tashrifat Saffron Premium loại Negin sợi to (1 Grams)",189400,390000,200600,51
TIKI,bach-hoa-online,46989885,"THÙNG 12 HỘP NƯỚC CỐT DỪA UHT VICO RICH 1L",870000,870000,0,0
TIKI,bach-hoa-online,47135825,"Nước màu mật ong Viethoney 200g",17500,17500,0,0
TIKI,bach-hoa-online,97991025," Thức ăn cho mèo con REFLEX KITTEN vị thịt gà",185555,185555,0,0
TIKI,bach-hoa-online,100067285,"DẦU MÈ ĐEN ÉP LẠNH 350ml - Noom (tặng vòi nhấn)",390000,390000,0,0
TIKI,bach-hoa-online,185965772,"Bánh thưởng cho chó Karamo Sumiho gói 100gr",13860,13860,0,0
TIKI,bach-hoa-online,20447387,"Socola Đen Quế  Nguyên Chất, Đắng Vừa | Dark Chocolate Cinnamon Alluvia",115000,115000,0,0
TIKI,bach-hoa-online,45263525,"500gr Trà atiso đỏ",185000,185000,0,0
TIKI,bach-hoa-online,139011587,"Kéo cong cắt tỉa lông chó mèo",90000,90000,0,0
TIKI,bach-hoa-online,51571077,"200gr Trà kỷ tử - Câu kỷ tử - Loại cao cấp",69000,69000,0,0
TIKI,bach-hoa-online,99226221,"Bột các loại hạt, đậu , ngũ cốc, không đường, pha với nước, hũ 325g, thương hiệu New Joy",67900,85000,17100,20
TIKI,bach-hoa-online,51547360,"Đường la hán quả JC BLUEMOON Monk Fruit Classic Blend 500G",286000,286000,0,0
TIKI,bach-hoa-online,56669841,"[ Mật ong ] cao cấp xuất khẩu Hoa Xuyến Chi Phúc Khang Hũ (500g) - Hàng Chính Hãng  - Mật ong sạch , mật ong cao cấp đạt tiêu chuẩn xuất khẩu - Bồi bổ cơ thể , tăng sức đề kháng ",122550,129000,6450,5
TIKI,bach-hoa-online,1988013,"Nước mắm Lê Gia- Cá cơm 650ml",41000,41000,0,0
TIKI,bach-hoa-online,207818898,"[MUA 1 TẶNG 1] SỮA CHAY SOYNA - SỮA HẠT BỔ SUNG PROTEIN CHO NGƯỜI ĂN CHAY- SỮA THỰC VẬT CAO CẤP SOYNA BỔ SUNG CANXI CHO XƯƠNG CHẮC KHỎE",300000,300000,0,0
TIKI,bach-hoa-online,68069074,"Mận Sơn La sấy dẻo Kentary 400gr, vị chua ngọt đậm đà - Giảm cholesterol xấu, tốt cho xương khớp, tim mạch - Trái cây sấy giảm cân, không GMO/Gluten/Chất bảo quản",190000,190000,0,0
TIKI,bach-hoa-online,97991452,"Muối Ớt Chanh Gừng Nha Trang 200gr Dh Foods",23500,23500,0,0
TIKI,bach-hoa-online,81535492,"Sôcôla Thanh 13 Vị Schogetten - Hạt Dẻ - 100g",55000,55000,0,0
TIKI,bach-hoa-online,136605670,"Natural Sả bột 30gr Dh Foods",15000,15000,0,0
TIKI,bach-hoa-online,149402497,"HẠT KHỬ MÙI THAN HOẠT TÍNH HẤP THỤ MÙI, KHỬ KHUẨN CHO CHÓ MÈO",38500,50000,11500,23
TIKI,bach-hoa-online,165028976,"Trà tâm sen cao cấp MS - (200g) - An thần, ngủ ngon giấc",120000,145000,25000,17
TIKI,bach-hoa-online,41873724,"200gr Trà tim sen - Trà tâm sen",83000,83000,0,0
TIKI,bach-hoa-online,94705188,"Đặc Sản Phú Quốc - Nước Mắm Phú Quốc Khải Hoàn 40 Độ Đạm Chai Nhựa 1 Lít - Ocop 5 Sao",142000,142000,0,0
TIKI,bach-hoa-online,49375113,"200gr Trà nụ hoa tam thất - Cao Cấp",189000,189000,0,0
TIKI,bach-hoa-online,20786906,"Socola Đen Hạnh Nhân Thanh Lớn 80 gram, Nguyên Chất, Đắng Vừa | Dark Chocolate Almond Alluvia",130000,130000,0,0
TIKI,bach-hoa-online,912613,"Kẹo Fres Barley (600g)",61000,61000,0,0
TIKI,bach-hoa-online,58655945,"Trà Oolong ( Ô Long/ OLong) Thượng Hạng Nguyên Chất Vũ Gia (200gr/hũ)",220000,330000,110000,33
TIKI,bach-hoa-online,63246285,"Combo 1KG: 500G Đậu Hà Lan Sấy Muối - 500G Đậu Hà Lan Sấy Tỏi Ớt Thương Hiệu SK FOOD",82000,89000,7000,8
TIKI,bach-hoa-online,126020960,"Bột cacao Hershey's Cocoa powder (Hershey’s Cocoa Natural Unsweetened 100% Cocoa)- 226gr",133200,148000,14800,10
TIKI,bach-hoa-online,75986352,"Sữa Tiệt Trùng Có Đường VPMilk Grow+ Vị Dâu Hộp 110ml (Thùng 48 Hộp)",269400,269400,0,0
TIKI,bach-hoa-online,59514285,"Cà phê G7 3in1 - Hộp 21 gói 16gr",67000,72954,5954,8
TIKI,bach-hoa-online,99078142,"Combo 6 gói Mì Jin Cay Ottogi Mini (80g)",49800,49800,0,0
TIKI,bach-hoa-online,88909449,"[Combo 2 Hũ] Mực Sợi Hấp Nước Dừa Ngọt Thơm - Tổng 400G",99000,109000,10000,9
TIKI,bach-hoa-online,73369492,"4 Hộp Cần Tây Mật Ong MOTREE Nhật Bản (Liệu Trình 1 Tháng) Giúp Giảm Cân, Hết Mụn, Sáng Da, Đẹp Dáng, Đào Thải Mỡ Thừa, Thanh Lọc Cơ Thể Tặng Kèm 01 Túi Muối NGâm Chân GIúp Ngủ Ngon Và 01 Chai Thủy Tinh ",419000,419000,0,0
TIKI,bach-hoa-online,2466781,"Muối ớt Tây Ninh 110gr Dh Foods",19500,19500,0,0
TIKI,bach-hoa-online,161524352,"Thùng 48 hộp sữa hạt óc chó TH True Nut 180ml (180ml x 48)",589110,589110,0,0
TIKI,bach-hoa-online,25436955,"1KG ĐẬU PHỘNG RANG TỎI ỚT THƠM NGON ( 2 HŨ 500G)",87000,128700,41700,32
TIKI,bach-hoa-online,140144037,"Cá catnip nhồi bông đồ chơi cho mèo (Giao mẫu ngẫu nhiên)",33000,50000,17000,34
TIKI,bach-hoa-online,138956315,"[Combo 30 lọ] Nước Yến sào Khánh Hòa Sanest đóng lọ 70ml",1080000,1080000,0,0
TIKI,bach-hoa-online,55474726,"Combo 3 gói cà Phê Trung Nguyên Legend S Chinh Phục ( 500g / gói )",165000,165000,0,0
TIKI,bach-hoa-online,112318761,"Dầu Ăn Cao Cấp Sailing Boat Gold Plus 5L giàu Omega 3,6,9 và chất chống oxy hóa [FREESHIP]",209000,255000,46000,18
TIKI,bach-hoa-online,76688244,"Combo 2 sản phẩm Gạo Ông Thọ - Lứt Tím Than túi 1kg hút chân không cao cấp. Gạo sạch hữu cơ dinh dưỡng cho sức khỏe",84000,84000,0,0
TIKI,bach-hoa-online,57829141,"Nhân Hạt Óc Chó Sống DK Harvest Dùng làm Sữa 1000g",329000,499000,170000,34
TIKI,bach-hoa-online,71091278,"Combo 3 Gói Bột Ngọt VEDAN 454g [ LM ]",87000,117000,30000,26
TIKI,bach-hoa-online,129059166," Patê Cột Đèn Hải Phòng 90g - Đồ Hộp Hạ Long",17575,18500,925,5
TIKI,bach-hoa-online,93525485,"Trà Thảo Mộc KingTea 500g Hỗ Trợ Đau Dạ Dày, Ổn Định Huyết Áp, Hạ Men Gan , Mỡ Máu Và Ngăn Ngừa Ung Thư Giúp Ngủ Ngon",149000,149000,0,0
TIKI,bach-hoa-online,74972222,"Gạo Mầm Vibigaba Hộp 1Kg - Ổn định đường huyết và huyết áp, làm chậm quá trình lão hóa và giúp hệ tiêu hóa khỏe mạnh",80000,80000,0,0
TIKI,bach-hoa-online,90982444," ĐỒ CHƠI CHO MÈO BÓNG LẬT ĐẬT CHO MÈO",18999,18999,0,0
TIKI,bach-hoa-online,262979703,"Sữa bột Nestlé Milo Australia giúp bé phát triển chiều cao và cân năng, thông minh và sáng tạo năng động vượt trội - QuaTangMe Extaste",306400,728000,421600,58
TIKI,bach-hoa-online,75400387,"MỰC SỢI HẤP NƯỚC DỪA TÂN LỘC PHÁT COMBO 2 HŨ - MỖI HŨ 200G",99000,129000,30000,23
TIKI,bach-hoa-online,13135804,"Cà phê phin Minh An (Arabica & Robusta) Rang xay nguyên chất - Túi 500g",120000,130000,10000,8
TIKI,bach-hoa-online,118895063,"Rượu Vang Đỏ Úc GEORGE WYNDHAM BIN 868 750ml 13.8% - 14.8% Không hộp",441000,526000,85000,16
TIKI,bach-hoa-online,159814184,"Xương gặm làm sạch răng Yaho cho chó mèo 265gr",76000,76000,0,0
TIKI,bach-hoa-online,57302645,"Cà phê hạt 100% nguyên chất truyền thống số 2 Coffee Tree 1kg đậm đà, thơm ngon, gu vừa",369000,369000,0,0
TIKI,bach-hoa-online,8258860,"Bơm tay thay nước bể cá ",32775,34500,1725,5
TIKI,bach-hoa-online,171259784,"Compo Tắc xí muội và Đá me hạt mềm Thanh Bình- Hộp 900g - Tăng đề kháng, giải nhiệt mùa hè, bổ sung Vitamin mùa dịch",120000,120000,0,0
TIKI,bach-hoa-online,125858364,"Gia vị kho cá Cholimex - hũ thuỷ tinh 200g",20000,20000,0,0
TIKI,bach-hoa-online,145506034,"TRÀ TRÁI KHỔ QUA RỪNG hũ 100g & hũ 120g - HƯƠNG SEN VIỆT",150000,150000,0,0
TIKI,bach-hoa-online,32380314,"COMBO 2 HŨ 1KG ĐẬU PHỘNG TỎI ỚT THƠM NGON (HŨ PET)",99000,115000,16000,14
TIKI,bach-hoa-online,188663186,"Dây đá mài răng hamster, Sóc Bông, Sóc Đất, Sóc Bắc Mỹ, Sóc Bay,...",15000,15000,0,0
TIKI,bach-hoa-online,139010908,"Bóng gặm cho chó, vui chơi, giảm strees cho chó",35000,35000,0,0
TIKI,bach-hoa-online,76183708,"Pate cá hồi sốt phô mai kem Hạ Long - 90g [DATE T06/2024]",19800,39600,19800,50
TIKI,bach-hoa-online,1717869,"Thức Ăn Cho Chó Royal Canin Mini Adult (2kg)",400000,400000,0,0
TIKI,bach-hoa-online,36909124,"Cacao ngòi (cocoa nibs) - Nhân hạt cacao rang túi 250g - Ăn trực tiếp hay làm bánh, chocolate - Heyday Cacao",125000,125000,0,0
TIKI,bach-hoa-online,117069987,"Xẻng cán thẳng xúc cát vệ sinh – Xẻng xúc chất thải cho mèo - xẻng lớn",33000,50000,17000,34
TIKI,bach-hoa-online,55195568,"Bánh ngũ cốc  (Cereal cracker) - Thai Lan",45000,45000,0,0
TIKI,bach-hoa-online,274056040,"Sinh Tố VINA MỨT (Hũ 650gr) - Vị Trái Cây Tươi Tự Nhiên",58000,58000,0,0
TIKI,bach-hoa-online,48341360,"Combo 3 Hộp Trà Linh Chi (Hộp 20 Túi Lọc X 2gr) - Tăng Tuổi Thọ, Bồi Bổ Sức Khỏe  - Nguyên Thái Trang – Thảo Dược Thiên Nhiên",99000,99000,0,0
TIKI,bach-hoa-online,185948771,"1 viên Xương kẹo sữa dê canxi Thái Lan",2000,2000,0,0
TIKI,bach-hoa-online,73636224,"Bò Sốt Vang Hạ Long - 175g",44100,49000,4900,10
TIKI,bach-hoa-online,107018635,"Tiêu Đen Xay Fadely (45g)",20000,20000,0,0
TIKI,bach-hoa-online,196857767,"Dung dịch vệ sinh mắt cho chó mèo và bông lau mắt Borammy - Lọ nhỏ mắt loại bỏ bụi bẩn và vết ố vàng cho thú cưng",32000,32000,0,0
TIKI,bach-hoa-online,73720756,"Vải Thiều Nước Đường Hạ Long - 560g",65340,72600,7260,10
TIKI,bach-hoa-online,105153859,"Sữa bột Dr.kyan Precaten cho chó mèo thú cưng",43999,43999,0,0
TIKI,bach-hoa-online,59162968,"Thức ăn cho chó con Ganador vị Sữa và DHA - Puppy Milk with DHA 400gr",26000,26000,0,0
TIKI,bach-hoa-online,56365927,"Mầm Đậu Nành Collagen Hena 500g - Bột Mầm Đậu Nành Tinh Chế Nguyên Xơ Cao Cấp với 100% Nguyên Liệu Hữu Cơ - Tăng Vòng 1 Siêu Tốc - Đã Kiểm Nghiệm và Công Bố Chất Lượng - Sản Phẩm Chính Hãng",199000,199000,0,0
TIKI,bach-hoa-online,55656739,"Chà Là Nguyên Cành Smile Nuts hộp 250g - Dòng Chà Là Deglet Nour Nhập Khẩu Từ Tunisia (Chà là với thớ thịt mềm, dẻo, thoảng vị mật ong)",98000,145000,47000,32
TIKI,bach-hoa-online,76674062,"Bún Ốc Lý Tử Thất - Chính hãng Li ZiQi",69000,88000,19000,22
TIKI,bach-hoa-online,166453140,"Đặc Sản Kon Tum - Miếng Chuối Hột Kon Tum Ép Bánh Thơm Ngon (Chuối Hột Nhà) 1Kg - OCOP 3 Sao",135000,135000,0,0
TIKI,bach-hoa-online,56761522,"Ngũ Cốc Giảm Cân Hena 500g - Ngũ Cốc Ăn Kiêng Giảm Cân Không Gây Mất Nước - 100% Tự Nhiên - Giảm Cân An Toàn và Khoa Học - Sản Phẩm Cao Cấp Chính Hãng - Đã Được Kiếm Nghiệm và Công Bố",199000,199000,0,0
TIKI,bach-hoa-online,69061414,"[MẪU MỚI - CHÍNH HÃNG] LỤC TRÀ LÀI LỘC PHÁT - 1KG - NGUYÊN LIỆU DÙNG PHA CHẾ ĐỒ UỐNG - TRÀ SỮA (Trà Lộc Phát)",160000,160000,0,0
TIKI,bach-hoa-online,106381120,"[Combo 3 chai] Dầu Đậu Nành Simply 2L",348000,348000,0,0
TIKI,bach-hoa-online,185948645,"Xương gặm Hello Joy cho chó giúp sạch răng, thơm miệng",4000,4000,0,0
TIKI,bach-hoa-online,115942019,"Ngũ cốc dinh dưỡng sinh việt 500g",64935,64935,0,0
TIKI,bach-hoa-online,141099510,"Bơ thượng hạng Golden Margarine 200gr",17500,24500,7000,29
TIKI,bach-hoa-online,56510470,"Combo 4 túi Đậu gà và Đậu lăng đỏ và Đậu hà lan xanh nguyên hạt và Đậu cúc 500g (CB10)",137750,145000,7250,5
TIKI,bach-hoa-online,56107033,"Trà hoa cúc chi Kami sấy lạnh (50g) – Cải thiện thị lực, thanh nhiệt, giải độc cơ thể",149000,149000,0,0
TIKI,bach-hoa-online,121020714,"Dầu ăn thượng hạng Ranee Golden 2 lít",90000,140000,50000,36
TIKI,bach-hoa-online,154699165,"Thập cẩm sấy L'angfarm, dòng phổ thông, 450g, bịch, mẫu nhãn kẹp",100000,100000,0,0
TIKI,bach-hoa-online,59505951,"Thịt Khô Bò Loại Miếng Mềm Thương Hiệu SK FOOD - Hũ 250G",125000,139000,14000,10
TIKI,bach-hoa-online,140229139,"Combo 10 gói Mì Lẩu Thái Tôm (1 gói 80gr)",99000,99000,0,0
TIKI,bach-hoa-online,154698821,"Kẹo me cay L'angfarm, 300g, bịch, mẫu kraft 1 mặt trong",38000,38000,0,0
TIKI,bach-hoa-online,106346491," Thức ăn cho mèo ít vận động Me-o Gold Fit and Firm",166399,166399,0,0
TIKI,bach-hoa-online,185095383,"Áo chó mèo hình thú có mũ chất nỉ - Quần áo chó mèo thú cưng",39999,39999,0,0
TIKI,thoi-trang-nu,92055188," Bra / Áo Lá Học Sinh Hai Lớp Xuất Đông Âu ( AL : 193 ) Hàng Loại Đẹp",26000,26000,0,0
TIKI,thoi-trang-nu,92159061,"Set 3 món đồ bơi nữ tay dài quần dài kèm quần đùi bơi rời - TK2165",437000,437000,0,0
TIKI,thoi-trang-nu,192710205,"Áo Hoodie nỉ bông thêu sadboiz màu ĐEN / Nam nữ unisex",100000,100000,0,0
TIKI,thoi-trang-nu,158129574,"Váy/đầm ngủ chất liệu ren voan mềm mịn, cao cấp, xẻ tà trước đầy gợi cảm LYEN008",112000,118000,6000,5
TIKI,thoi-trang-nu,110757056,"chân váy nữ có túi kiểu hàn 3 màu kiểu hàn quốc",89000,89000,0,0
TIKI,thoi-trang-nu,184489131,"Áo Bơi Nữ Tay Dài Black Befree Sobie",382500,450000,67500,15
TIKI,thoi-trang-nu,35976449,"Áo Len Nữ Cardigan Nhẹ Bốn Mùa ALN002 MayHomes Kiểu Cánh Dơi",118900,145000,26100,18
TIKI,thoi-trang-nu,109190445,"ĐẦM HOA PHỐI DẬP LY TRẺ TRUNG - MS 0603D",390000,390000,0,0
TIKI,thoi-trang-nu,179412988,"Áo kiểu nữ ngắn tay in hình phong cách Retro,bốn màu siêu đẹp,siêu sang - Mã A17",166470,166470,0,0
TIKI,thoi-trang-nu,187012164,"Bộ đồ bơi bikini nữ đi tắm biển kín đáo - B.35",190000,200000,10000,5
TIKI,thoi-trang-nu,128158907,"Quần lót lọt khe Full lưới Sexy kiểu dáng độc đáo siêu co giãn",35000,35000,0,0
TIKI,thoi-trang-nu,112052377,"(HÀNG HOT TEEN) VÁY ĐŨI SUÔNG DÁNG MAXI FULL MÀU HÀNG CHUẨN NHƯ HÌNH CÓ ẢNH THẬT",78700,78700,0,0
TIKI,thoi-trang-nu,19758703,"ÁO THUN NỮ TRỄ VAI",29000,29000,0,0
TIKI,thoi-trang-nu,196205490,"Chân Váy Nữ New Design Thiết kế Dáng Váy Đắp Tà Chéo ,Phom chữ A Trẻ Trung, Dài 63cm ,Thanh Lịch Công Sở ,,Chất Vải Tốt Co Giãn (3 Màu )CV0083",159000,359000,200000,56
TIKI,thoi-trang-nu,78553196,"Đầm suông linen cổ sen vuông form rộng trẻ trung, chất vải linen mềm mát, thời trang phong cách Nhật Bản",230000,230000,0,0
TIKI,thoi-trang-nu,7150525,"Quần Độn Mông Đúc Dạng Đùi Nâng Mông Cao Cấp - 5Star",72000,72000,0,0
TIKI,thoi-trang-nu,57400785,"Bộ đồ bơi bikini 2 mảnh nữ phong cách Hàn xinh xắn, chất bơi thun lạnh Lycra cao cấp, dáng dễ mặc, kín đáo mà vẫn quyến rũ | KT047",480000,480000,0,0
TIKI,thoi-trang-nu,197191834,"Áo hoodie in chữ YE MUST BE BORN AGAIN KANYE cho nam và nữ, ÁO HOODIE NỈ IN CHỮ YE MUST BORN FORM RỘNG UNISEX NAM NỮ, Áo hoodie in chữ YE MUST BE BORN AGAIN KANYE cho nam và nữ",100000,100000,0,0
TIKI,thoi-trang-nu,186862647,"Bộ quần áo lửng cho mẹ họa tiết Sọc xám linen cotton - AICDMESQPMZ0 - AIN Closet",310000,430000,120000,28
TIKI,thoi-trang-nu,25964805,"Quần lót lọt khe sexy nữ chất liệu ren thiết kế xẻ đáy quyến rũ gợi cảm - Màu hồng",25000,25000,0,0
TIKI,thoi-trang-nu,134357642,"Chân váy xếp ly dáng dài - kèm đai",153400,153400,0,0
TIKI,thoi-trang-nu,58327731,"Đầm suông nữ xếp từng phối ren form rộng đủ size AH10",179000,179000,0,0
TIKI,thoi-trang-nu,76541904,"Quần lót lọt khe nữ dễ thương ren buộc dây",25000,25000,0,0
TIKI,thoi-trang-nu,271138640,"Đồ Bộ Đũi Trung Niên Chất Liệu Đũi Cao Cấp Cho Mẹ Và Bà Mặc Đi Tiệc Đi Chơi - Tuấn Tú Store 68",279000,279000,0,0
TIKI,thoi-trang-nu,73200262,"Áo Kiểu Nữ Hàn Quốc Dạng Áo Kiểu Tay Lỡ Phối Màu - Nhiều Màu GOTI 3A03",219000,219000,0,0
TIKI,thoi-trang-nu,103358919,"Váy ngủ quảng châu cao cấp – Váy ngủ sexy ren G7 – Váy ngủ gợi cảm – Đầm ngủ ren hoa – Đồ ngủ sexy – Váy ngủ sexy",95000,95000,0,0
TIKI,thoi-trang-nu,178509168,"Áo croptop hai dây bản to polo cổ v nữ, áo thun ôm body rút dây gợi cảm hở lưng mặc đi biển đi chơi dưới 50 cân",86900,86900,0,0
TIKI,thoi-trang-nu,92489126,"Quần dài nữ Baggy kẻ sọc caro lưng thun",104500,104500,0,0
TIKI,thoi-trang-nu,69028851," ÁO THUN CROPTOP ÔM BODY TRƠN BASIC XOẮN NGỰC 50",84000,84000,0,0
TIKI,thoi-trang-nu,143148359,"ĐẦM XÒE VOAN DỰ TIỆC THẮT NƠ EO SIÊU XINH",123000,123000,0,0
TIKI,thoi-trang-nu,34499006,"Quần bò giấy nữ chất dãn từ 43-76kg",169000,169000,0,0
TIKI,thoi-trang-nu,137669568,"Áo Sơ Mi Nhung Gân Tăm Phong Cách Retro Hàn Quốc Form Rộng Unisex Nam Nữ Ulzzang",152000,152000,0,0
TIKI,thoi-trang-nu,185004745,"Quần đùi mẹ Nâu cà phê chéo Hàn - AICDMEVKF3HT - AIN Closet",165000,260000,95000,37
TIKI,thoi-trang-nu,74915290,"Đầm suông linen cổ đức phối 2 túi ngực ArcticHunter, chất vải linen tự nhiên mềm mại, thời trang thương hiệu chính hãng",250000,250000,0,0
TIKI,thoi-trang-nu,108507753,"Quần baggy nữ công sở gấu bằng vải tuyết mưa",75000,75000,0,0
TIKI,thoi-trang-nu,181428485,"Set bộ linen áo cổ 2 ve dáng lửng và quần ống rộng, thời trang phong cách Hàn - Xám",350000,350000,0,0
TIKI,thoi-trang-nu,51731179,"Đồ ngủ cosplay nữ phi công sexy gợi cảm",139000,139000,0,0
TIKI,thoi-trang-nu,179979931,"Áo lót trung niên cài trước, áo lót cho người già",108000,108000,0,0
TIKI,thoi-trang-nu,129402470,"Quần kẻ caro nữ",69000,69000,0,0
TIKI,thoi-trang-nu,134025545,"Đầm body ôm 2 dây thiết kế khoét vai dự tiệc",121000,121000,0,0
TIKI,the-thao-da-ngoai,33454921,"Đai Lưng Mềm Tập GYM Valeo Bản To 15cm EVA-2",165000,165000,0,0
TIKI,the-thao-da-ngoai,184783770,"hot - Ghế câu cá địa hình vải dù khung inox gấp gọn để du lịch dã ngoại cắm trại camping ngoài trời , cafe trà chanh",118999,118999,0,0
TIKI,the-thao-da-ngoai,195624120,"Dây nhảy thể dục lõi thép AOLIKES A-3201 Sport Jump Rope",92000,159000,67000,42
TIKI,the-thao-da-ngoai,12110417,"Dụng cụ tập bắp cổ tay zeno",89000,89000,0,0
TIKI,the-thao-da-ngoai,122379441,"Tất thể thao Bendu hàng chính hãng cao cấp, nhiều 3 màu lựa chọn",35000,35000,0,0
TIKI,the-thao-da-ngoai,90527569,"Bộ 10 Nấm Chiến Thuật Bóng Đá,Cone Tập Luyện Thể Thao Chiều Cao 16cm DNS002 Chính Hãng Đại Nam Sport (Giao Màu Ngẫu Nhiên)",89000,99000,10000,10
TIKI,the-thao-da-ngoai,181247253,"Túi Chiết Nhựa Đựng Mỹ Phẩm Lotion Dầu Gội Tiện Lợi Đi Du Lich 30ml / 50ml / 100ml",57000,57000,0,0
TIKI,the-thao-da-ngoai,25118084,"Dây cước câu cá Trilene Big Game",265000,265000,0,0
TIKI,the-thao-da-ngoai,42895584,"Gậy Massage Triggerpoint Acucurve",700000,700000,0,0
TIKI,the-thao-da-ngoai,148570608,"Chống cần Câu Đài Câu Đơn Cao Cấp Ultra Light KK-13",44100,44100,0,0
TIKI,the-thao-da-ngoai,189063341,"Chân Cắm Đất Gác Cần Câu Đài Chống Cần Câu Đài Cao Cấp DCC2",55000,55000,0,0
TIKI,the-thao-da-ngoai,169935973,"Gậy bơm hơi cổ vũ bóng đá, thể thao vui nhộn",10000,10000,0,0
TIKI,the-thao-da-ngoai,187182785,"Đai bảo vệ cột sống ",238000,238000,0,0
TIKI,the-thao-da-ngoai,76359754,"Găng Tay Thể Thao Glofit GFST012 Siêu Nhẹ, Siêu Thoáng (WORKOUT GLOVES)",345000,450000,105000,23
TIKI,the-thao-da-ngoai,58450152,"Dây kéo lưng tập gym Lifting Straps GoodFit GF731LS",119000,149000,30000,20
TIKI,the-thao-da-ngoai,491591,"Tạ Nhập Khẩu - TNK- 4Kg - Đen",410000,410000,0,0
TIKI,the-thao-da-ngoai,191648646,"Dây giày thông minh phản quang 3 vạch LiveFit Lock Laces không cần buột I vừa với mọi loại giày I Chất liệu dây Nylon bền chắc với thời gian",99000,99000,0,0
TIKI,the-thao-da-ngoai,6495813,"Bật Lửa Zippo 1935 Replica Brushed Chrome 1935.25",955000,955000,0,0
TIKI,the-thao-da-ngoai,13644922,"Đấm bốc trẻ em Boxing Suit - Bộ đồ tập đấm bốc boxing chuyên nghiệp cho trẻ em",220999,220999,0,0
TIKI,the-thao-da-ngoai,138737865,"Ghế câu cá. Ghế dã ngoại gấp ngọn tiện lợi - Cần Câu Top1 VN",106800,106800,0,0
TIKI,the-thao-da-ngoai,74814137,"Cần câu tay Carbon Daiwa Dao chính hãng 39 (3m9), Dao 45 (4m5), Dao 54 (5m4), Dao 63 (6m3)",1981000,1981000,0,0
TIKI,the-thao-da-ngoai,132777616,"TÚI CHỐNG NƯỚC BỌC BALO",29000,29000,0,0
TIKI,the-thao-da-ngoai,124274396,"Túi Bọc Balo Chống Thấm Nước",33000,35000,2000,6
TIKI,the-thao-da-ngoai,14370033,"Bộ dây tập thể lực TRX P1 SUSPENSION THIENTRUONG",699000,699000,0,0
TIKI,the-thao-da-ngoai,149614364,"Cần câu máy rút gọn Percast đủ size 2m1 đến 3m6 - cần câu cá giá rẻ",104050,104050,0,0
TIKI,the-thao-da-ngoai,115085981," ỐNG CẦU LÔNG HẢI YẾN XÁM BẠC CHUYÊN NGHIỆP, CHẤT LƯỢNG CAO",115000,115000,0,0
TIKI,the-thao-da-ngoai,88822152,"Lều 2 Lớp 4 - 5 Người Dã Ngoại Phượt Cắm Trại Galaxy Store GSL07 Chống Nước Tốt Kèm Quà Tặng - Hàng Chính Hãng (Màu Ngẫu Nhiên)",1175000,2000000,825000,41
TIKI,the-thao-da-ngoai,44005347,"Đồng hồ thi đấu cờ PS-1688 (42 chế độ chỉnh thời gian) màu Xanh",380000,380000,0,0
TIKI,the-thao-da-ngoai,156047442,"Cần câu lục xa bờ Comando USA 4m25 và 4m5 Hàng loại 1 Độ Cứng 45 Top1vn",503000,503000,0,0
TIKI,the-thao-da-ngoai,180046042,"Quần Short Legging Nam Ngắn Ôm Bó Cơ Giữ Nhiệt - LocalBrand X9 - Tập Gym Đá Bóng Yoga Chạy Bộ - X004",320000,320000,0,0
TIKI,the-thao-da-ngoai,144221631,"Bộ dụng cụ tập luyện đánh bóng Tennis tại nhà kèm đế  cực kì tiện dụng tập mọi lúc mọi nơi",99000,99000,0,0
TIKI,the-thao-da-ngoai,92807055,"Còi cứu sinh có la bàn và nhiệt kế",29000,29000,0,0
TIKI,the-thao-da-ngoai,131395791,"Khóa Linh Chống Xoắn, Khóa Link Chữ U Cao Cấp - Phụ kiện câu cá",60000,60000,0,0
TIKI,the-thao-da-ngoai,69025166,"Bó cổ chân có đai thể thao bảo vệ gót mắt cá co giãn tránh chấn thương H010",79000,79000,0,0
TIKI,the-thao-da-ngoai,63493859,"Quấn cổ chân tập GYM tập mông với cáp phụ kiện Gym chuyên nghiệp AK_26",70000,70000,0,0
TIKI,the-thao-da-ngoai,186558684,"Bục Nhảy Tập GYM Aerobic Có Thể Điều Chỉnh Kích Thước",495000,495000,0,0
TIKI,the-thao-da-ngoai,1694657,"Áo Hỗ Trợ Đốt Mỡ Giảm Cân Cho Nam Giới Sportslink SK Fitness (Size",106000,142000,36000,25
TIKI,the-thao-da-ngoai,7879077,"Ghế xếp du lịch siêu gọn nhẹ",59000,59000,0,0
TIKI,the-thao-da-ngoai,167422373,"Bộ 2 tạ tay cao su Reefit màu đen 3kg (gồm 2 cục)",360000,360000,0,0
TIKI,the-thao-da-ngoai,115344720,"Áo phao bơi, áo phao lính người lớn và trẻ em",130000,130000,0,0
TIKI,the-thao-da-ngoai,14762149,"Bạt Kiêm Túi Miscato Đa Năng Tiện Dụng Đi Picnic, Phượt, Hoạt Động Ngoài Trời",53000,53000,0,0
TIKI,the-thao-da-ngoai,19686868,"GIÀY Trượt Patin Trẻ Em - Papaison A3",699000,699000,0,0
TIKI,the-thao-da-ngoai,124275874,"Dây Dù Siêu Chắc Dài 10m",14000,15000,1000,7
TIKI,the-thao-da-ngoai,189468141,"Xà Đơn Gắn Cửa FED-0228 | Kích thước 115-140cm (Chịu lực 400kg - Có chốt khóa an toàn khi gắn xà - Dễ dàng tháo lắp không cần khoan tường)",690000,790000,100000,13
TIKI,the-thao-da-ngoai,132713006,"Đũa Phíp Đen Soắn chống trơn trượt - Hàng Việt Nam",15000,15000,0,0
TIKI,the-thao-da-ngoai,33348363,"Sữa tăng cơ Rule 1 Casein 28 servings - 952g tặng 1 gói thử hãng Rule 1 bất kì",700000,700000,0,0
TIKI,the-thao-da-ngoai,58078050,"Phao Bơi Trẻ Em xỏ chân Sportslink - Hình Con Vịt",92000,102000,10000,10
TIKI,the-thao-da-ngoai,78563386,"Balo Tennis Babolat PURE DRIVE 2021 (753089)",1699000,1990000,291000,15
TIKI,the-thao-da-ngoai,48696566,"Ống tay thun lạnh co giãn 4 chiều chống nắng và tia UV 3M PS2000",139000,139000,0,0
TIKI,the-thao-da-ngoai,118007668,"Áo bó giữ nhiệt áo body áo tập gym AKKA co dãn 4 chiều",80000,95000,15000,16
TIKI,the-thao-da-ngoai,147411482,"Đai quấn lưng tập gym bảo vệ lưng và cột sống lõi thép trợ lực bảo vệ giúp  tránh chấn thương hiệu quả HY008 - Hành chính hãng BORO SPORT",350000,350000,0,0
TIKI,the-thao-da-ngoai,16256787,"Bật lửa Zippo Armor High Polish Chrome 167",835000,835000,0,0
TIKI,the-thao-da-ngoai,107617019,"Combo Khăn trùm đầu Ninja Fullface + Găng Tay Chống Nắng Xỏ Ngón màu đen",24900,24900,0,0
TIKI,the-thao-da-ngoai,40770111,"Bó gối chân trong bóng đá, bóng chuyền",24999,24999,0,0
TIKI,the-thao-da-ngoai,49374148,"Cước câu cá chuyên dụng - Chất lượng siêu bền - Cước dài 500m  CCH04",179000,179000,0,0
TIKI,the-thao-da-ngoai,176530434,"Dây Thun Quấn Chân Gối Đa Năng Aolikes Dài 120cm (1 Chiếc)",55000,55000,0,0
TIKI,the-thao-da-ngoai,72455190,"Combo 5 Khăn Đa Năng Chống Nắng Có Thể Làm Khẩu Trang Nhiều Màu Sắc Dài 47CM",39000,39000,0,0
TIKI,the-thao-da-ngoai,6625365,"Khung bóng rổ thi đấu - có kèm lưới",129000,129000,0,0
TIKI,the-thao-da-ngoai,141613584,"Combo đầy đủ đi câu thuận lợi",164550,164550,0,0
TIKI,the-thao-da-ngoai,153610317,"TEE ĐỠ BÓNG GOLF - PGM - QT001",40000,40000,0,0
TIKI,the-thao-da-ngoai,115270977,"Dây Nhảy Tập Thể Dục Cao Cấp Tại Nhà Lõi Thép Cao Cấp, Viền Tay Cầm Hình Kim Cương Chính Hãng Cao Cấp KitAcoom",89000,89000,0,0
TIKI,the-thao-da-ngoai,160409520,"Giày đá bóng Dagger đã khâu Full Đế size từ 38 đến 43",250000,250000,0,0
TIKI,the-thao-da-ngoai,2282593,"Bộ 4 Vỉ Đá Zippo",200000,200000,0,0
TIKI,the-thao-da-ngoai,139055367,"Bộ Vợt Cầu Lông Trẻ Em Vợt Cầu Lông Cho Bé - LYLY SPORTS",133000,133000,0,0
TIKI,the-thao-da-ngoai,125573023,"Golf Strike Spray - Bình Xịt Mặt Gậy Golf Phân Tích Điểm Tiếp Xúc Bóng Golf Với Mặt Gậy Golf",331500,390000,58500,15
TIKI,the-thao-da-ngoai,26670886,"Cán cờ du lịch dành cho hướng dẫn viên dẫn đoàn, công ty lữ hành, loại  2m đầu đồng",120000,120000,0,0
TIKI,the-thao-da-ngoai,57780501,"Đai lưng tập gym GoodFit GF721WS",249000,300000,51000,17
TIKI,the-thao-da-ngoai,23229090,"2 Băng bảo vệ đầu gối - Băng gối thể thao cao cấp (SP073)",85000,85000,0,0
TIKI,the-thao-da-ngoai,56902119,"Dụng cụ tập thể dục cho lưng, bụng có dây kéo lò xo đơn REXCHI( Màu ngẫu nhiên)",75000,75000,0,0
TIKI,the-thao-da-ngoai,144404607,"Dây Kéo Lưng Cải Tiến Aolikes AL-7633 | Quấn Cổ Tay Nâng Tạ, Đu Xà, Tập Gym Chính Hãng",149000,149000,0,0
TIKI,the-thao-da-ngoai,57703479,"Combo 2 kẹp bịt mũi kèm 4 cái bịt tai ngăn nước đi bơi Legaxi",37000,37000,0,0
TIKI,the-thao-da-ngoai,103744213,"BĂNG CHẶN MỒ HÔI ĐẦU HEAD (285085) Giao màu ngẫu nhiên",149000,149000,0,0
TIKI,the-thao-da-ngoai,58530328,"Kính Bảo Vệ Chơi Thể Thao, Bóng Rổ, Bóng Đá Chống Sương Mù, Mồ Hôi Cao Cấp REXCHI",125000,125000,0,0
TIKI,the-thao-da-ngoai,147192876,"Bi Lăn Tay Inox, Dùng Tập Cơ Tay Vật Lý Trị Liệu -VT0227",93700,93700,0,0
TIKI,the-thao-da-ngoai,11020657,"Quần bơi nam boxer Deenyt A1807",198000,218000,20000,9
TIKI,the-thao-da-ngoai,110151809,"Bọc đầu cơ Bida cao cấp",65000,65000,0,0
TIKI,the-thao-da-ngoai,83484683,"Dụng cụ luyện tập sức mạnh ngón tay(tặng kèm pick)",59000,59000,0,0
TIKI,the-thao-da-ngoai,141634318,"Bao Đựng Cần Câu Tay Giá Rẻ 1m2",39700,39700,0,0
TIKI,the-thao-da-ngoai,31864103,"Quần thể thao Tennis nam",131100,138000,6900,5
TIKI,the-thao-da-ngoai,23013042,"Túi thể thao, Túi đeo bụng chạy bộ (SP041)",32670,47190,14520,31
TIKI,thoi-trang-nam,154298071,"Combo 2 quần đùi nam, quần Short Gió nam thể thao Họa Tiết Rằn Ri trẻ trung năng động, thoáng mát co giãn 4 chiều MRM Manlywear",269000,399000,130000,33
TIKI,thoi-trang-nam,38496061,"Combo 7 Quần lót nam tam giác cotton xịn nhiều lưng có size lớn màu ngẫu nhiên cao cấp mặc cực thoãi mái underwear SỊP HN7",135000,135000,0,0
TIKI,thoi-trang-nam,164312116,"UNSTOPABLE đa sắc, mã G61. Áo thun hàng hiệu Goking, form unisex cho nam nữ, trẻ em, bé trai gái. Áo phông in đẹp, quà tặng cao cấp",119000,119000,0,0
TIKI,thoi-trang-nam,22492292,"Áo polo nam ngắn tay có cổ ( TẶNG QUẦN LÓT NAM CAO CẤP ) , Combo 2 áo, DokaFashion regular fit chuẩn hàng xuất, áo phông thun polo nam tay ngắn – EZ235",157000,285000,128000,45
TIKI,thoi-trang-nam,90979601,"Áo Khoác Dù Nam chống nước ( TẶNG QUẦN LÓT HÀNG HIỆU ) Dokafashion Cao Cấp 2 Lớp Vải Dù Ấm Áp Cản Gió Đi Nắng, Chống Nước EZDS23",147000,209000,62000,30
TIKI,thoi-trang-nam,162033134,"Combo 5 quần đùi nam mặc nhà Cotton thoải mái thoáng mát Họa Tiết Ngẫu Nhiên - JAMANO",229000,350000,121000,35
TIKI,thoi-trang-nam,145680551,"Hộp 5 Quần Lót Nam lưng Hàn Quốc hiệu CITYMEN vải thun lạnh 4 chiều cao cấp, sịp nam - LMTK-HANAL ( Giao màu ngẫu nhiên )",115000,115000,0,0
TIKI,thoi-trang-nam,31638135,"Combo 4 quần lót nam Boxer sợi cạp 1cm sợi tre tự nhiên mềm mịn thấm hút mồ hôi, co giãn 4 chiều MRM Manlywear - Màu ngẫu nhiên",255000,340000,85000,25
TIKI,thoi-trang-nam,31638135,"Combo 4 quần lót nam Boxer sợi cạp 1cm sợi tre tự nhiên mềm mịn thấm hút mồ hôi, co giãn 4 chiều MRM Manlywear - Màu ngẫu nhiên",255000,340000,85000,25
TIKI,thoi-trang-nam,88011606,"Quần Sịp Nam Quần Lót Nam ( từ 40kg đến 100kg )  Dokafashion Sợi Cotton Mềm Mịn Siêu Thoáng Mát, Co Giãn 4 Chiều Cao Cấp EZQLH01",21000,49000,28000,57
TIKI,thoi-trang-nam,52133729,"Quần Lót Nam lưng CITYMEN vải lạnh co giãn 4 chiều cao cấp, đồ lót - LMTK-CTMAL",30000,30000,0,0
TIKI,thoi-trang-nam,110704393,"Combo 2 quần đùi nam Cotton mặc nhà thoải mái thoáng mát JAMANO- MÀU NGẪU NHIÊN",99000,140000,41000,29
TIKI,thoi-trang-nam,111850645,"Bộ Quần Áo KaKi Lính Mỹ US ARMY U569 Kiểu Dáng Túi Hộp Chiến Thuật, Chất Liệu Kaki Cao Cấp Phong Cách Lính Cực Ngầu - HÀNG CHÍNH HÃNG",855000,1798000,943000,52
TIKI,thoi-trang-nam,7599073,"Combo 5 Quần Lót Nam tam giác vải cotton co giãn 2 chiều hiệu CITYMEN, màu ngẫu nhiên, sịp nam - LMTK-MULTI2C",100000,100000,0,0
TIKI,thoi-trang-nam,67538621,"COmbo 5 quần ĐÙI May 10",135000,135000,0,0
TIKI,thoi-trang-nam,31637590,"Combo 4 quần lót nam tam giác Bamboo Organic mềm mịn thoáng mát thấm hút mồ hôi - MRM Manlywear - Màu Ngẫu Nhiên",249000,340000,91000,27
TIKI,thoi-trang-nam,99968881,"Set 2 quần đùi nam, quần Short Gió nam thể thao Basic trẻ trung năng động, thoáng mát co giãn 4 chiều MRM Manlywear",255000,399000,144000,36
TIKI,thoi-trang-nam,99329103,"Quần Thể Thao Nam TSIMPLE, quần short tập gym vải thun lạnh thoáng mát, co giãn, chuẩn form nhiều màu",89000,113000,24000,21
TIKI,thoi-trang-nam,31637590,"Combo 4 quần lót nam tam giác Bamboo Organic mềm mịn thoáng mát thấm hút mồ hôi - MRM Manlywear - Màu Ngẫu Nhiên",249000,340000,91000,27
TIKI,thoi-trang-nam,99968881,"Set 2 quần đùi nam, quần Short Gió nam thể thao Basic trẻ trung năng động, thoáng mát co giãn 4 chiều MRM Manlywear",255000,399000,144000,36
TIKI,thoi-trang-nam,169619782,"SET 3 Chiếc Quần Lót Nam Không đường may cao cấp BADBIRD, quần lót nam, quần sịp nam dạng boxer, Thương hiệu Việt",189000,199000,10000,5
TIKI,thoi-trang-nam,99958075,"Quần đùi short gió nam thể thao Basic trẻ trung năng động, thoáng mát co giãn 4 chiều MRM Manlywear",129000,199000,70000,35
TIKI,thoi-trang-nam,124635780,"Áo sơ mi nam trơn tay dài cao cấp Lados - 779 chất kate lụa mềm mát, thấm hút mồ hôi",116000,235000,119000,51
TIKI,thoi-trang-nam,162033134,"Combo 5 quần đùi nam mặc nhà Cotton thoải mái thoáng mát Họa Tiết Ngẫu Nhiên - JAMANO",229000,350000,121000,35
TIKI,thoi-trang-nam,99156609,"Áo Thun Nam cổ tròn TSIMPLE áo phông trơn basic tay ngắn vải cotton co giãn, dày dặn , form chuẩn nhiều màu",89000,113000,24000,21
TIKI,thoi-trang-nam,170400732,"SET 5 Chiếc Quần Lót Nam Không đường may cao cấp BADBIRD, quần lót nam, quần sịp nam dạng boxer, Thương hiệu Việt",315000,315000,0,0
TIKI,thoi-trang-nam,126700166,"Quần Jean nam basic cao cấp LADOS - 4035 form slimfit, vải đẹp",265000,500000,235000,47
TIKI,thoi-trang-nam,104080625,"Combo 4 Quần Lót Nam hiệu CITYMEN vải thun lạnh 4 chiều lưng Hàn Quốc cao cấp, đồ lót - LMTK-HANAL ( Giao màu ngẫu nhiên )",136000,136000,0,0
TIKI,thoi-trang-nam,52184516,"Combo 3 quần lót nam Boxer sợi Organic mềm mịn thoáng mát co giãn 4 chiều MRM Manlywear ( TẶNG Đôi Tất Nam Cao Cấp Giao Ngẫu Nhiên)",199000,285000,86000,30
TIKI,thoi-trang-nam,154298071,"Combo 2 quần đùi nam, quần Short Gió nam thể thao Họa Tiết Rằn Ri trẻ trung năng động, thoáng mát co giãn 4 chiều MRM Manlywear",269000,399000,130000,33
TIKI,thoi-trang-nam,160393397,"Áo thun polo nam ngắn tay, chất thun vải mềm mịn, thiết kế phần bo tay và cổ áo phối màu độc lạ - FORMEN SHOP - FMPS176",179000,250000,71000,28
TIKI,thoi-trang-nam,114571809,"Quần Sịp Nam Cao Cấp, Quần Lót Nam Thun Lạnh, Hộp 4 Sịp Đùi Nam Vải Sợi Tự Nhiên Thun Lạnh, Thoáng Khí, Co Giãn 4 Chiều, Không Phai Màu, Không Xù Lông, Thấm Hút Mồ Hôi, Thoát Hơi Và Kháng Khuẩn Rất Tốt",115500,115500,0,0
TIKI,thoi-trang-nam,99325284,"Áo Thể Thao Nam TSIMPLE thun nam tập gym ngắn tay vải thun lạnh thoáng mát, co giãn, chuẩn form nhiều màu",89000,113000,24000,21
TIKI,thoi-trang-nam,187574051,"Combo 3 quần lót nam boxer CITYMEN lưng Thái cao cấp vải cotton 100% co dãn mềm mại thoáng khí thấm hút tốt, quần xịp sịp đùi nam - Giao màu ngẫu nhiên",140000,140000,0,0
TIKI,thoi-trang-nam,49165591,"Đồ bơi cho nam quần lửng",299000,314480,15480,5
TIKI,thoi-trang-nam,111972654,"Quần Túi Hộp Tháo Ống US ARMY U880 Chuyên Phượt Chất Vải Gió Cao Cấp Mau Khô Ống Có Thể Tháo Rời Làm Quần Short -HÀNG CHÍNH HÃNG",284000,699000,415000,59
TIKI,thoi-trang-nam,186133766,"Quần Short Kaki Nam US ARMY, Quần Túi Hộp Nam Phong Cách Lính Chất Liệu KaKi Cao Cấp, Kiểu Dáng Trẻ Trung Năng Động -HÀNG CHÍNH HÃNG",283000,598000,315000,53
TIKI,thoi-trang-nam,82819910,"Áo Polo nam cổ bẻ ngắn tay, chất liệu vải cá sấu cotton cao cấp, trẻ trung, năng động – FORMEN SHOP – FMPS150",159000,219000,60000,27
TIKI,thoi-trang-nam,79435123,"Áo chống nắng nam cao cấp, thông hơi, chống nắng, chống tia UV, chống bám bụi – FORMEN SHOP – FMTHT024 - XÁM TRẮNG - M",129000,215000,86000,40
TIKI,thoi-trang-nam,176251118,"Combo 2 Áo thun nam Cotton Compact Premium trẻ trung thấm hút mồ hôi, co giãn 4 chiều MRM Manlywear",289000,499000,210000,42
TIKI,thoi-trang-nam,76537581,"Quần Jean Nam Đen Trơn cao cấp thương hiệu Chandi, phong cách tôn dáng nam tính chất jean co dãn Mẫu J20",165000,280000,115000,41
TIKI,thoi-trang-nam,110704393,"Combo 2 quần đùi nam Cotton mặc nhà thoải mái thoáng mát JAMANO- MÀU NGẪU NHIÊN",99000,140000,41000,29
TIKI,thoi-trang-nam,144162512,"Combo 3 quân sịp đùi nam, set 3 quần lót boxer nam Aristino chất liệu cotton kháng khuẩn, khử mùi, co giãn 4 chiều thấm hút mồ hôi cực tốt ABX03707",298000,390000,92000,24
TIKI,thoi-trang-nam,172210350,"Hộp 4 quần boxer nam thun lạnh, quần lót nam co dãn 4 chiều- Formen Shop- FMQS017",179000,280000,101000,36
TIKI,thoi-trang-nam,22610869,"Combo 3 Áo Thun nam HÀNG HIỆU đa phong cách -  ĐB3QC16 (Chọn Màu)- Vải thun cotton có điểm đặc biệt, thân thiện với làn da, co giãn và khả năng thấm hút tốt",300000,300000,0,0
TIKI,thoi-trang-nam,52720544,"Quần Lót Nam Thun lạnh 4 chiều cao cấp màu ngẫu nhiên",25000,30000,5000,17
TIKI,thoi-trang-nam,14694284,"Áo khoác nam 2 lớp GOKING, vải dù ấm áp, cản gió hiệu quả, thích hợp đông và thu đông (Màu xanh đen)",235000,235000,0,0
TIKI,thoi-trang-nam,87981660,"Combo 2 áo ba lỗ nam, áo 3 lỗ nam, sợi cotton mềm mịn, thấm hút mồ hôi tốt, thoáng mát, mặc thoải mái JAMANO",149000,198000,49000,25
TIKI,thoi-trang-nam,133821238,"Combo 5 Quần Lót Nam Boxer Cotton Lưng Thái Cao Cấp, Quần Sịp Đùi Nam Co Giãn 4 Chiều CITYMEN - ( Màu Ngẫu Nhiên )",230000,230000,0,0
TIKI,thoi-trang-nam,99183754,"Áo Polo Nam cổ bẻ TSIMPLE thun có cổ tay lỡ vải cá sấu cotton phong cách trẻ trung, chuẩn form, nhiều màu",149000,170000,21000,12
TIKI,thoi-trang-nam,164338704,"Áo Thun Nam Ngắn Tay 8 Màu Thiết Kế Thời Trang Cao Cấp AVIANO",129000,258000,129000,50
TIKI,thoi-trang-nam,14702607,"Áo Thun Nam Tay Lỡ Unisex Hạc JaPan",37000,37000,0,0
TIKI,thoi-trang-nam,125800026,"Áo khoác dù 2 mặt chống Nước LADOS - 2027 , Form đẹp, chống nắng, chống nước tốt",203000,379000,176000,46
TIKI,thoi-trang-nam,176250783,"Áo thun nam Cotton Compact Premium trẻ trung năng động thấm hút mồ hôi co giãn 4 chiều MRM Manlywear",149000,249000,100000,40
TIKI,thoi-trang-nam,97057130,"Áo Thun nam Polo Bảo Bảo Store chất thun cotton cá sấu hàng xuất khẩu form Quốc tế có bigsize - Form rộng giảm 2 size",75050,79000,3950,5
TIKI,the-thao-da-ngoai,46607075,"Lưỡi lăng xê - Bộ 4 lưỡi - Ảnh thật sản phẩm LC02",89000,89000,0,0
TIKI,the-thao-da-ngoai,114011202,"Đai Lưng Mềm Lục Giác Hỗ trợ tập Gym Bản To 19.5cm",232650,255000,22350,9
TIKI,the-thao-da-ngoai,196578753,"Thảm Tập Yoga TPE 2 Lớp 6mm, Thảm Mềm Mại, Thấm Hút Mồ Hôi, Chống Trơn Trượt",78000,78000,0,0
TIKI,the-thao-da-ngoai,10650902,"Khung Bóng Rổ + Lưới",163000,329000,166000,50
TIKI,the-thao-da-ngoai,106503398,"Lều cắm trại, lều du lich dã ngoại, câu cá 2- 5 người, dễ dàng gập mở, đóng gói nhỏ gọn, thuận tiện",449000,449000,0,0
TIKI,the-thao-da-ngoai,54059328,"Thảm tập GOLF tại nhà tặng hộp 06 bóng tập chuyên dụng",150000,250000,100000,40
TIKI,the-thao-da-ngoai,135462907,"Kìm Gỡ Cá Đa Năng Kẹp Cá Gỡ Cá Cao Cấp PK12",29000,29000,0,0
TIKI,the-thao-da-ngoai,164943026,"Tấm Chắn Gió Dã Ngoại 8 Tấm Naturehike NH15F008-B Hợp Kim Nhôm Gấp Gọn ",215000,215000,0,0
TIKI,the-thao-da-ngoai,84446604,"20 mét Dây Dù Dã Ngoại Loại To và Dầy",65000,65000,0,0
TIKI,the-thao-da-ngoai,154930022,"[Chính Hãng] Máy Câu Cá Deukio AC, Máy AC, Máy Câu Cao Cấp",114269,114269,0,0
TIKI,the-thao-da-ngoai,8338009,"Dây tập thể lực BLACK Yellow, thang dây thể thao tập bóng cao cấp - DONGDONG",75000,75000,0,0
TIKI,the-thao-da-ngoai,160449809,"Kính bơi bé trai Zoggs Superman Character - 382437",495000,555000,60000,11
TIKI,the-thao-da-ngoai,9263020,"Combo xà đơn treo tường DNS  (KT 60-110cm) + Kìm bóp tay điều chỉnh lực",189000,350000,161000,46
TIKI,the-thao-da-ngoai,16178414,"Thảm tập Yoga định tuyến PU cao cấp",438000,699000,261000,37
TIKI,the-thao-da-ngoai,176504497,"Mồi Câu Cá Tra Pioner Mekong Catfish Gói 200g Dùng Câu Sông Tự Nhiên Hồ Dịch Vụ",25000,25000,0,0
TIKI,the-thao-da-ngoai,68604999,"Thực phẩm bổ sung Creatine không mùi Rule 1 Creatine Unflavored 150 servings - 750g tặng Rule 1 Shaker",1453500,1530000,76500,5
TIKI,the-thao-da-ngoai,192880480,"KHÓA AN TOÀN CHO MÁY CHẠY BỘ ",50000,50000,0,0
TIKI,the-thao-da-ngoai,53840753,"Dụng Cụ Tăng Cơ Tay Hiệu Quả Gậy Bẻ Cơ Tay Lò Xo Lực 40kg PT40",74000,79000,5000,6
TIKI,the-thao-da-ngoai,170148515,"Combo 10 Gói Pre-Workout Abe Hỗ Trợ Tăng Sức Mạnh Tăng Năng Lượng Trong Quá Trình Tăng Cơ Giảm Mỡ",250000,250000,0,0
TIKI,the-thao-da-ngoai,52325239,"Băng Trán Làng Lá NARUTO combo 2 màu đen và xanh ",100000,100000,0,0
TIKI,the-thao-da-ngoai,9415395,"Thảm định tuyến PU 5mm (kèm túi đựng ) Cao Cấp",438000,699000,261000,37
TIKI,the-thao-da-ngoai,14903415,"Phao Tay Tập Bơi An Toàn Nhỏ Gọn 22x19.5cm",39000,39000,0,0
TIKI,the-thao-da-ngoai,69511948,"Dây Nhảy Thể Dục Dài 2,9m  Có Thể Điều Chỉnh Được Độ Dài Của Dây Hàng Đủ Màu Siêu Bền Đẹp",38000,49000,11000,22
TIKI,the-thao-da-ngoai,53472886,"Bộ Trò Chơi Phóng Phi Tiêu Bảng Từ Nam Châm Thiết Kế Cuộn Tròn Thông Minh 15 Inch 2 Mặt Tặng Kèm 6 Phi Tiêu_NC15 Cao Cấp",143000,143000,0,0
TIKI,the-thao-da-ngoai,2371655,"Nón bơi, mũ bơi BL - XANH mềm mại CHỐNG thấm nước, chất liệu PU co giãn cao cấp - POKI",49000,49000,0,0
TIKI,the-thao-da-ngoai,101642318,"Đèn cắm trại ngoài trời Desert&Fox G-85 Rechargeable camping lantern",224000,369000,145000,39
TIKI,the-thao-da-ngoai,162548486,"Băng Cổ Tay Thấm Mồ Hôi  - Vải Mềm Mịn , Thấm Hút Mồ Hôi Cực Tốt",45000,45000,0,0
TIKI,the-thao-da-ngoai,197900282,"Còi trọng tài",25000,25000,0,0
TIKI,the-thao-da-ngoai,16510019,"Nẹp Định Vị Một Tay Giúp Luyện Chơi Golf PGM - JZQ006",225000,225000,0,0
TIKI,the-thao-da-ngoai,59164406,"Combo 20 Viên Khăn Giấy Nén Viên Du Lịch Cao Cấp",28875,55000,26125,48
TIKI,the-thao-da-ngoai,139664764,"Bó Gối Thể Thao Một Dây - Đai Bảo Vệ Khớp Gối - AOLIKES AL7912",100000,100000,0,0
TIKI,the-thao-da-ngoai,107615359,"22 mét Dây Dù Dã Ngoại Loại To và Dầy",80000,80000,0,0
TIKI,the-thao-da-ngoai,17891598,"Bóng tập yoga trơn 75cm",124740,237600,112860,48
TIKI,the-thao-da-ngoai,138810337,"Bột chống mồ hôi tay VS, victor, taan",120000,120000,0,0
TIKI,the-thao-da-ngoai,37298571,"Đèn đội đầu Q5",50831,94000,43169,46
TIKI,the-thao-da-ngoai,112108843,"Đầu cơ Tpro 11.5mm - 12mm - 13mm",220000,220000,0,0
TIKI,the-thao-da-ngoai,148560053,"SALE KỊCH SÀN Bao đựng cần câu cá tùy chọn size từ 75cm tới 165cm",62173,62173,0,0
TIKI,the-thao-da-ngoai,176435316,"Túi lưới đựng bóng chuyên nghiệp sợi dù đan (giao màu ngẫu nhiên)",70000,77000,7000,9
TIKI,the-thao-da-ngoai,190081577,"Mũ bơi cho bé POPO 1179 phù hợp trẻ em trên 3 tuổi hình ngộ nghĩnh chất liệu an toàn",88500,88500,0,0
TIKI,the-thao-da-ngoai,186932334,"Bình Nước Camelbak Podium Chill 21OZ (620ml)",299000,299000,0,0
TIKI,thoi-trang-nu,105616492,"váy suông cộc tay cổ tim dáng dài xẻ tà in chữ LA 3 màu",89000,89000,0,0
TIKI,thoi-trang-nu,146773109,"(Big size) Chân váy xòe dài có túi",129000,129000,0,0
TIKI,thoi-trang-nu,67992226,"ĐẦM BI TAY PHỒNG LENA",163000,163000,0,0
TIKI,thoi-trang-nu,193152975,"Quần lót nữ dáng Bikini gợi cảm chất liệu cotton Mỹ ONOFF - 16UJ23A034",79000,79000,0,0
TIKI,thoi-trang-nu,2710459,"Set 6 miếng dán che ngực phụ nữ nội địa Nhật Bản",65500,65500,0,0
TIKI,thoi-trang-nu,134498214,"Chân váy ngắn nữ chất da mềm dây rút 2 bên cá tính màu đen nâu kem thời trang Banamo Fashion 5912",119000,119000,0,0
TIKI,thoi-trang-nu,68962459,"Combo quần lót nữ và áo ngực gợi cảm",39000,39000,0,0
TIKI,thoi-trang-nu,91754247,"Áo HOODIE HEART DÂY KÉO UNISEX, Áo Khoác Nỉ Bông Dây Kéo HEART Thêu Trái Tim Unisex , Áo khoác hoodie chống nắng dành cho nam nữ Thêu Trái Tim, Nỉ ngoại form rộng Có Dây Kéo unisex ulzzang",100000,100000,0,0
TIKI,thoi-trang-nu,185096001,"Áo lót học sinh 2 dây mút mỏng dành cho học sinh tiểu học trung học cơ sở chất cottton tăm mềm mại thoáng mát Lá Bralette A26",38000,38000,0,0
TIKI,thoi-trang-nu,61494413,"Đầm Ngắn Dễ Thương Nơ Trắng Và Viền Tay DN087 MayHomes Kiểu Dáng Thời Trang",143650,169000,25350,15
TIKI,thoi-trang-nu,185004783,"Bộ quần áo lửng cho mẹ Nâu xước - AICDMEUVNTQJ - AIN Closet",310000,430000,120000,28
TIKI,thoi-trang-nu,73279950,"Quần Lót Không Viền Su Đúc Thoải Mái Loire QSD04",89000,89000,0,0
TIKI,thoi-trang-nu,242620516,"Áo kiểu nữ cổ yếm hở vai 2 lớp kèm dây đai, áo babydoll bánh bèo điệu đà",82000,82000,0,0
TIKI,thoi-trang-nu,119420030,"Áo ngực tạo khe chữ U 8867",66000,66000,0,0
TIKI,thoi-trang-nu,47308948,"Váy ngủ xuyên thấy sexy tặng kèm quần chíp MS001",45000,45000,0,0
TIKI,thoi-trang-nu,101280855,"Combo 10 Quần Lót Nữ Cotton Thái Siêu Mịn (Freesize 40-57kg) - Chất Liệu Thấm Hút Và Co Giãn 4 Chiều Tốt .",99000,99000,0,0
TIKI,thoi-trang-nu,87720310,"Bộ đồ lót liền thân gợi cảm cho nữ",119000,119000,0,0
TIKI,thoi-trang-nu,174550945,"Áo Thun Cá Sấu Nam Nữ Thời Trang Cao Cấp 40kg-80kg (MS08)",100000,100000,0,0
TIKI,thoi-trang-nu,146785126,"(BIG SIZE) Quần ống suông dài",180000,180000,0,0
TIKI,thoi-trang-nu,194121245,"Chân Váy Bò Xẻ Trước Dáng Dài.Chân váy Jean Nữ Lưng Cao Dáng Chữ A_A3",139000,139000,0,0
TIKI,thoi-trang-nu,68961675,"Bộ đồ ngủ mặc nhà lụa Satin áo hai dây quần cộc quyến rũ gợi cảm - Xanh ngọc",145000,145000,0,0
TIKI,thoi-trang-nu,87453112,"ÁO KHOÁC SƠ MI CARO NAM NỮ / ÁO SƠ MI NỮ / ÁO SƠ MI SỌC CARO / ÁO KHOÁC SƠ MI",104000,104000,0,0
TIKI,thoi-trang-nu,1921271,"Áo Ngực Triumph D179 GT-VN - Trắng (Size",239000,239000,0,0
TIKI,thoi-trang-nu,109570000,"Combo 3 Quần Lót Cotton Lụa Plus Size Miley Lingerie Nature Wind FCP_11",190000,237000,47000,20
TIKI,thoi-trang-nu,121645478,"Áo dài cách tân nam",360000,360000,0,0
TIKI,thoi-trang-nu,25964812,"Quần lót nữ lọt khe xẻ đáy - Màu tím",29000,29000,0,0
TIKI,thoi-trang-nu,74884034,"Đồ ngủ lưới Sexy gợi cảm",49000,49000,0,0
TIKI,thoi-trang-nu,7778560,"Áo ngực nữ cúp ngang Miley Lingerie BRM09102",218000,315000,97000,31
TIKI,thoi-trang-nu,115936134,"Combo 2 quần lót su phối ren ôm trọn vòng 3 sexy đầy gợi cảm LYEQ029 ( màu ngẫu nhiên )",112000,118000,6000,5
TIKI,thoi-trang-nu,52136184,"Áo khoác vest nữ sang trọng HATI -001",258000,258000,0,0
TIKI,thoi-trang-nu,155792392,"Váy ngủ hai dây nữ, đầm ngủ hai dây bản to nữ tính chất vải lanh lụa rayon tự nhiên thoáng mát nhiều màu mã VAV0224",129000,129000,0,0
TIKI,thoi-trang-nu,187009117,"Quần lót lọt khe nữ siêu Sexy Briefs nâng mông",45000,45000,0,0
TIKI,thoi-trang-nu,75750021,"Bộ Đồ Trung Niên - Bộ Đũi Cao Cấp - Bộ Đũi Họa Tiết Tròn - Dành Cho các Quý Bà U40 - U50 - U60 - U70 - Laddy Store",250000,250000,0,0
TIKI,thoi-trang-nu,35539631,"set 5  Quần Lót Nữ Nhật Lưng Cao nt3 màu ngẫu nhiên ",67970,67970,0,0
TIKI,thoi-trang-nu,45400958,"ĐẦM DỰ TIỆC CAO CẤP",350000,350000,0,0
TIKI,thoi-trang-nu,95051365,"Áo Thun Croptop Nữ Form Body Thời Trang, Sexy",100000,100000,0,0
TIKI,thoi-trang-nu,173858351,"Bộ thể thao nữ chất liệu cotton cao cấp thoáng mát ko bai xù phù hợp thời tiết mùa hè Us 003, Bộ cộc tay nữ siêu đẹp kiểu dáng trẻ trung, chất vải thoáng mát, thấm hút mồ hôi, phù hợp mặc đi chơi dã ngoại",109000,109000,0,0
TIKI,thoi-trang-nu,189476155,"(FreeShip Xtra) QUẦN THUN MẶC TRONG VÁY QUẦN BẢO HỘ",25000,25000,0,0
TIKI,thoi-trang-nu,101280860,"Combo 10 chiếc quần lót cotton trơn co dãn tốt fom từ 45-60kg",99000,99000,0,0
TIKI,the-thao-da-ngoai,95524187,"Lưỡi Câu Cá Maruseigo Thép Trắng Siêu Cứng Cực Bén Không Gỉ Sét",40000,40000,0,0
TIKI,the-thao-da-ngoai,135815532,"Quả bóng đá EURO 2021 số 5, số 4 da PU - Tặng kim bơm bóng ( bóng may )",157000,157000,0,0
TIKI,the-thao-da-ngoai,75396049,"Khăn trùm đầu Ninja Fullface đi phượt (Màu đen)",15000,15000,0,0
TIKI,thoi-trang-nu,169347867,"Áo Khoác Dù BOMBER 7ZIA Ulzzang Nam Nữ Unisex Form Rộng Vải 2 Lớp Ulzzang",100000,100000,0,0
TIKI,the-thao-da-ngoai,104884872,"Bột Câu Cá Ngũ Vị Hương Hiệu Quả Với Cá Tra, Chép, Rô Phi Chuyên Dùng Ủ Cơm Thiu, Trộn Cháo Rết, Ủ Bún, Trộn Cám",55000,55000,0,0
TIKI,the-thao-da-ngoai,57010114,"Lều 2 Lớp 4 - 5 Người Dã Ngoại Phượt Cắm Trại Galaxy Store GSL07 Chống Nước Tốt - Màu Ngẫu Nhiên",1175000,1950000,775000,40
TIKI,the-thao-da-ngoai,136029752,"Tất Bóng Rổ, Tất Bóng Chuyền Chuyên Nghiệp V-pro. Dòng Tất Thể Thao Cao Cấp Có Độ Ôm Và Bảo Vệ Cổ Chân Tốt - Thấm Hút Mồ Hôi Và Rất Êm (1 Đôi)",85000,120000,35000,29
TIKI,the-thao-da-ngoai,8493528,"Xà đơn gắn cửa cải tiến có chốt chống xoay (83cm-130cm) - Đen Xanh Dương",312000,344000,32000,9
TIKI,the-thao-da-ngoai,146370515,"Dụng Cụ Hít Đất Chống Đẩy Đa Năng 14 Bài Tập – Dụng Cụ Chống Đẩy 18 Lỗ - Chính Hãng dododios",146000,146000,0,0
TIKI,the-thao-da-ngoai,35454276,"Bao Tay, Găng Tay Tập Gym, Tập YoGa Cho Nam, Nữ Cao Cấp - GT002",136000,136000,0,0
TIKI,the-thao-da-ngoai,17909353,"Bàn bóng bàn Đức Long TL-05",4400000,4400000,0,0
TIKI,the-thao-da-ngoai,167025735,"Máy câu cá, câu tôm giá rẻ",40800,40800,0,0
TIKI,the-thao-da-ngoai,149598355,"Dây cáp câu cá kèm sẵn lưỡi câu",2300,2300,0,0
TIKI,the-thao-da-ngoai,140333347,"Băng Đội Trưởng Captain C Bóng Đá",20000,20000,0,0
TIKI,the-thao-da-ngoai,34278045,"Đai bó ống chân co giãn khi chơi thể thao loại dài (Màu ngẫu nhiên)",65550,69000,3450,5
TIKI,the-thao-da-ngoai,60229542,"Dây Câu Cá Leader Daiwa D-Fron 100% Fluoro Carbon Cuộn 100m Made In Japan",278000,278000,0,0
TIKI,the-thao-da-ngoai,67539013,"Đai bảo vệ, cố định khớp vai có điều chỉnh GoodFit GF702S  - Trái",149000,199000,50000,25
TIKI,the-thao-da-ngoai,169984115,"Bộ quần áo bóng đá - Áo đấu các câu lạc bộ bóng đá MU, PSG, Mancity, Liverpool...  mùa giải 2022 - Bộ đồ đá banh",95000,150000,55000,37
TIKI,the-thao-da-ngoai,138898017,"Túi đeo bụng đựng điện thoại đi tập thể dục, chạy bộ",22106,31931,9825,31
TIKI,the-thao-da-ngoai,135539059,"Lọ chiết mỹ phẩm dầu gội du lịch Silicon 89ml",55000,55000,0,0
TIKI,the-thao-da-ngoai,5777583,"Túi ngủ du lịch dã ngoại (Giao màu ngẫu nhiên)",117000,117000,0,0
TIKI,the-thao-da-ngoai,111859855,"Bộ 5 Dây Ngũ Sắc Đàn Hồi Tập Gym, Tập Thể Hình Đa Năng Tại Nhà Amalife ",88000,88000,0,0
TIKI,the-thao-da-ngoai,33257269,"Thảm Yoga Fitness Adidas 7mm",810000,839000,29000,3
TIKI,the-thao-da-ngoai,87094552,"Vợt Tennis Babolat PURE STRIKE LiTE 265gram 3rd Gen (101408)",4106000,4490000,384000,9
TIKI,the-thao-da-ngoai,146905558,"Mồi Câu Cá Dạng Viên Cám Câu Cá Trắm, Chép, Chôi, Rô Phi,..Loại Hạt To, Hạt Nhỏ Siêu Nhậy - thegioidocau",39000,39000,0,0
TIKI,the-thao-da-ngoai,59213855,"Giày Trượt Patin 2 Hàng Bánh Chính Hãng LongFeng Cho Trẻ Em Và Người Lớn",593000,593000,0,0
TIKI,the-thao-da-ngoai,49267678,"Gel Uống Bổ Sung Năng Lượng Và Vitamin ENERGY GEL BiotechuSA",600000,600000,0,0
TIKI,the-thao-da-ngoai,148823403,"Bộ Đôi Găng Bao Tay Đấm Bốc Trẻ Em 5-13 Tuổi Cao Cấp – Găng Tay Tập Boxing MMA Trẻ Em Chính Hãng Dododios",109000,109000,0,0
TIKI,the-thao-da-ngoai,33370060,"DỤNG CỤ KÌM BÓP TAY LÒ XO TẬP TAY CHẮC KHỎE",25000,25000,0,0
TIKI,the-thao-da-ngoai,20847671,"Bật lửa Zippo 352B –Bật lửa Zippo Venetian Brass",1050000,1050000,0,0
TIKI,the-thao-da-ngoai,56407340,"GẬY TẬP THỂ LỰC SWING - PGM SOFT SWING BAR - HGB011",350000,550000,200000,36
TIKI,the-thao-da-ngoai,148567017,"Mồi Câu Cá Giả Bằng Nhựa Mềm 90mm/14g MG-15",12200,12200,0,0
TIKI,the-thao-da-ngoai,11378700,"Mũ nón chống nắng nam, mũ nón đi câu cá, cắm trại cho Nam – chống tia UV – bảo vệ da đầu",132000,132000,0,0
TIKI,the-thao-da-ngoai,92806758,"La bàn cầm tay 4cm",15000,15000,0,0
TIKI,the-thao-da-ngoai,136826840,"Quần đùi chạy bộ AERDIDA137725 nhẹ,thoáng khí, khô nhanh",249000,249000,0,0
TIKI,the-thao-da-ngoai,161451921,"Bộ 2 vỏ tạ tay nhựa bát giác 5kg REEFIT (2 vỏ 5kg, tổng 10kg)",59000,59000,0,0
TIKI,the-thao-da-ngoai,272445832,"Sữa tăng cơ hương vị tự nhiên Rule 1 Protein Isolate/ Hydrolysate Naturally Flavored 1.68 - 1.72lb tặng Rule 1 Sample",700000,700000,0,0
TIKI,the-thao-da-ngoai,170758060,"Tăng Bạt Trải Dã Ngoại Naturehike NH15D004-X Thảm Dã Ngoại Đa Năng",195000,195000,0,0
TIKI,the-thao-da-ngoai,21299541,"TÚI NGỦ VĂN PHÒNG CAO CẤP EDENA 75CM X 190CM",370000,370000,0,0
TIKI,the-thao-da-ngoai,169692394,"Bộ Cần Câu Bút Mini 1M Fish Pen",229000,229000,0,0
TIKI,the-thao-da-ngoai,191073426,"Kính bơi người lớn nam nữ + Mũ Bơi - hãng chính hãng dododios - Mã 2030",89000,89000,0,0
TIKI,thoi-trang-nu,125021753,"(HÀNG SẴN) Áo Sơ Mi Ren Ngắn Tay Cổ Trụ Phong Cách hàn Quốc SM52 - Hàng Quảng Châu Cao Cấp",275000,275000,0,0
TIKI,thoi-trang-nu,85905324,"Quần lót lọt khe nữ Dây sexy C51",33000,33000,0,0
TIKI,thoi-trang-nu,185384313,"Đầm Linen nữ cổ V rút eo 2 túi phong cách công sở Đũi Việt Dv160",235305,249000,13695,6
TIKI,thoi-trang-nu,142994727,"Áo croptop tay dài ôm body nữ cải màu , áo thun croptop nữ chất đẹp 100% cotton free size dưới 52 kg nhiều màu",60500,60500,0,0
TIKI,thoi-trang-nu,179418058,"Áo sơ mi cổ trụ tay lỡ dáng xuông thời trang Hàn Quốc ( mã A25)",186000,186000,0,0
TIKI,thoi-trang-nu,103431434,"Quần shorts nữ cạp cao siêu Hot",65000,65000,0,0
TIKI,thoi-trang-nu,52461347,"Chân váy xòe Zarha sang trọng",185000,185000,0,0
TIKI,thoi-trang-nu,112457080,"Đầm xòe Caro dễ thương-MS019",380000,380000,0,0
TIKI,thoi-trang-nu,135113413,"áo dài nhung trơn đủ màu kèm quần trung niên",350000,350000,0,0
TIKI,thoi-trang-nu,91663893,"Đồ bộ bigsize - Đồ bộ trung niên - Bộ đồ trung niên mặc nhà bigsize Vicci DGN.03 thiết kế áo cộc quần dài chất liệu đũi cao cấp (dành cho người béo)",168000,329000,161000,49
TIKI,thoi-trang-nu,68857986,"Áo croptop cộc tay chất cotton zip",39000,39000,0,0
TIKI,thoi-trang-nu,181656800,"Sét bộ gấm cao cấp áo cổ bẻ đính nút kèm quần ngắn",175000,175000,0,0
TIKI,thoi-trang-nu,187955238,"Đầm suông linen dáng yếm nơ lưng vạt tròn trẻ trung, thời trang phong cách Hàn - Hồng",260000,260000,0,0
TIKI,thoi-trang-nu,163574291,"Quần Short Lưng Cao Vải Nhung Thời Trang Cá Tính Cho Nữ (không kèm thắt lưng)",70000,70000,0,0
TIKI,thoi-trang-nu,185867089,"Bộ quần áo lửng cho mẹ họa tiết Xanh rêu lụa - AICDMEQB5DGH - AIN Closet",310000,430000,120000,28
TIKI,thoi-trang-nu,89871718,"SIÊU HOT MIẾNG DÁN NÂNG NGỰC SILICON",36999,36999,0,0
TIKI,cross-border-hang-quoc-te,190172014,"Sách - Time Is a Mother by Ocean Vuong (US edition, hardcover)",485000,485000,0,0
TIKI,thoi-trang-nu,108926792,"Áo nịt vải lưới dây kéo giữa - Không gen Tom Trans",117999,117999,0,0
TIKI,thoi-trang-nu,129823279,"Áo kiểu nữ form rộng kẻ ô trẻ trung, thời trang trẻ phong cách Hàn",159000,159000,0,0
TIKI,thoi-trang-nu,127807880,"Full sét MERRY cưng xỉu , sét bộ đùi mới toanh diện hè bao chuẩn lun đây nè, form to rộng chuẩn đẹp lắm nhé, Set đồ bộ from rộng sang chảnh, đồ bộ thể thao nữ unisex ulzzang, bộ đồ mặc nhà nữ rộng thoải mái chất mát",99000,99000,0,0
TIKI,cross-border-hang-quoc-te,11778902,"The 5 AM Club: Own Your Morning. Elevate Your Life",549000,549000,0,0
TIKI,cross-border-hang-quoc-te,113345623,"Sách - How to Connect by Thich Nhat Hanh - (UK Edition, paperback)",237000,237000,0,0
TIKI,thoi-trang-nu,176687766,"Đồ Bơi Hai Mảnh Họa Tiết Sọc Kèm Váy Ren ATO54 MayHomes Women Two-Piece Swimwear",161070,177000,15930,9
TIKI,thoi-trang-nu,175849016,"Vải Áo dài Lá Tre",239000,239000,0,0
TIKI,thoi-trang-nu,10730888,"Quần Lót Nữ Smoggi Shine Mini Triumph - Trắng (Size",99000,139000,40000,29
TIKI,thoi-trang-nu,181263918,"Quần lót nữ cạp cao gen bụng thun lạnh cao cấp viền ren mềm đũng 2 lớp kháng khuẩn,co giãn 4 chiều cạp cao",180000,180000,0,0
TIKI,thoi-trang-nu,185684218,"Đồ bộ ngủ bigsize không mút 2 dây phối ren lưng mã 376",50000,50000,0,0
TIKI,thoi-trang-nu,97535393,"Áo sơ mi nữ dáng rộng tay lỡ xẻ tà gấu đuôi tôm",169000,169000,0,0
TIKI,thoi-trang-nu,136940014,"Quần lanh thổ cẩm từ 40kg-80kg",80000,80000,0,0
TIKI,thoi-trang-nu,244332038,"Áo croptop kiểu vạt nhọn cổ vuông vai bồng cộc tay nữ OZENKA , áo crt ôm body phối màu gợi cảm thun cotton dưới 55 cân",79000,79000,0,0
TIKI,cross-border-hang-quoc-te,190468483,"Giày chạy bộ nữ CAMEL CROWN Lưới đế mềm thoáng khí Trọng lượng nhẹ",1217000,1217000,0,0
TIKI,thoi-trang-nu,86882422,"(HÀNG SẴN) Đầm Hoa Trung Niên Che Bụng Cho Mẹ VH52 - Hàng Quảng Châu Cao Cấp",375000,375000,0,0
TIKI,cross-border-hang-quoc-te,46353107,"2 CHIẾC 100% Cotton Hankie Nam Nữ Khăn Tay Bỏ Túi Vuông Hanky Kerchief",154000,154000,0,0
TIKI,thoi-trang-nu,105172727,"BikiniStoreVn : Đồ Bơi Tay Dài Quần Dài S78",410000,410000,0,0
TIKI,cross-border-hang-quoc-te,11777049,"Collins Classics: Little Women",140000,140000,0,0
TIKI,cross-border-hang-quoc-te,114424308,"Hộp đựng thuốc lá nhôm nhẹ-Màu Bạc",117000,117000,0,0
TIKI,thoi-trang-nu,172312344,"Bộ đồ nữ mặc nhà trung niên cho các bà, các mẹ Vicci BTN.26, thiết kế áo cộc tay quần lửng, chất liệu thun Nhật mềm mịn, thoáng mát",175000,309000,134000,43
TIKI,cross-border-hang-quoc-te,95720463,"Đồng Hồ Tốc Độ Không Dây Cho Xe Đạp Leo Núi",384800,384800,0,0
TIKI,cross-border-hang-quoc-te,95718600,"Ống Bơm Bánh Xe Đạp Đa Chức Năng",249600,249600,0,0
TIKI,cross-border-hang-quoc-te,170693069,"Sách - Ugly Love by Colleen Hoover (UK edition, paperback)",600000,600000,0,0
TIKI,thoi-trang-nu,137524599,"Áo khoác,bomber gió chữ R trắng in hình họa tiết cực nổi nam nữ mặc cực chất, Áo Khoác Bomber Nam Thời trang, Áo Bomber Nam Nữ Phối Tay Chữ R Gió Thu Đông Unisex, Áo gió BOMBER",110000,110000,0,0
TIKI,cross-border-hang-quoc-te,111684569,"Dây đeo cổ tay bằng da cho Máy ảnh cầm tay thay thế cho máy ảnh DSLR Canon Nikon Sony Pentax Olympus",121000,121000,0,0
TIKI,thoi-trang-nu,8068749,"Áo Khoác Nữ Xỏ Ngón Comfort Phúc An 4034 Màu",180000,180000,0,0
TIKI,thoi-trang-nu,107479537,"Set maxi tầng, áo bẹt vai (A18)",290000,290000,0,0
TIKI,cross-border-hang-quoc-te,76744011,"LED Wrist Ball Trainer Gyroscope Ball Gyro Arm Power Exerciser",208000,208000,0,0
TIKI,thoi-trang-nu,61473743,"Áo thun nữ wash Nhật Bản thương hiệu GOKING, 100% cotton thấm hút mồ hôi",155000,155000,0,0
TIKI,cross-border-hang-quoc-te,108603413,"Túi đựng, cất trữ xe đạp có thế gấp gọn, dày 2 lớp vải, phù hợp với hầu hết các mẫu xe gấp trên thị trường-Size 16 inch",408000,408000,0,0
TIKI,cross-border-hang-quoc-te,113407876,"Sách - How to Eat by Thich Nhat Hanh - (UK Edition, paperback)",411000,411000,0,0
TIKI,cross-border-hang-quoc-te,189705994,"Giày Chạy Bộ Nữ Giày thể thao CAMEL thoáng khí siêu nhẹ thời trang cho",1040000,1040000,0,0
TIKI,cross-border-hang-quoc-te,77721918,"In Ear Headphone Headset Earbuds Tip Cover Silicone Earplug For Airpods Pro3",157000,157000,0,0
TIKI,cross-border-hang-quoc-te,95382679,"Giày Thể Thao Leo Núi Chống Thấm Nước Chống Trượt Cho Nam Và Nữ giày dép nam trung niên 40 tuổi",884000,884000,0,0
TIKI,cross-border-hang-quoc-te,11504808,"Rich Dad Poor Dad For Teens",437000,437000,0,0
TIKI,cross-border-hang-quoc-te,173561830,"Balo Văn Phòng Nhiều Lớp Chống Nước Chống Trộm Đựng Máy Tính Xách Tay Có Cổng Usb Tiện Dụng Mark Ryden",895000,895000,0,0
TIKI,thoi-trang-nu,7595772,"Áo Sơ Mi Nữ Sọc Cổ Đổ MS0106A",170000,170000,0,0
TIKI,cross-border-hang-quoc-te,17968668,"The Making Of A Manager",582000,582000,0,0
TIKI,cross-border-hang-quoc-te,113356599,"Sách - The Whole-Brain Child : 12 Revolutionary Strategies to Nuture Your Child&#x27;s Developing Mind by Daniel J Siegel - (US Edition, paperback)",356000,356000,0,0
TIKI,thoi-trang-nu,175550126,"ĐẦM XÒE PHỐI CHÂN VÁY HOA - D07",179000,310000,131000,42
TIKI,cross-border-hang-quoc-te,7917830,"Principles: Life and Work",783000,783000,0,0
TIKI,cross-border-hang-quoc-te,46352165,"Viết Tạp Chí Nhật Ký Sổ Tay, A6 Vintage Da Nhân Tạo Bao Trống Viết Scrapbooks Xách Tay",186000,186000,0,0
TIKI,cross-border-hang-quoc-te,17970235,"Never Split The Difference",427000,427000,0,0
TIKI,cross-border-hang-quoc-te,111067221,"Nút tai silicon Bluedio NE -40dB Giảm tiếng ồn Cách nhiệt Bảo vệ tai Chống ồn ",141000,141000,0,0
TIKI,thoi-trang-nu,103079663,"[ĐẸP ĐỘC] Chân váy jean ngang gối 08 phối dây xích lưng cá tính C101 Cỏ Boutique",295000,295000,0,0
TIKI,cross-border-hang-quoc-te,109437991,"Đèn pha xe đạp phong cách cổ điển 3 đèn LED",183000,183000,0,0
TIKI,thoi-trang-nu,143117503,"Áo lót nữ cotton không gọng đệm mỏng cao cấp, áo lót nữ sinh",68000,105000,37000,35
TIKI,cross-border-hang-quoc-te,52837551,"Jacquard Stretch Low Back Ghế Cover Bar Counter Stool Trượt",181000,181000,0,0
TIKI,thoi-trang-nu,193142944,"Đầm dự tiệc dáng xòe tay dún hàng cao cấp",160000,160000,0,0
TIKI,cross-border-hang-quoc-te,10732510,"Astronomy 101: From The Sun And Moon To Wormholes And Warp Drive, Key Theories, Discoveries, And Facts About The Universe",556000,556000,0,0
TIKI,cross-border-hang-quoc-te,98029417,"Màn Hình Chiếu HD 120 Inch 16: 9 Có Thể Gập Lại Treo Tường Cho Rạp Hát Tại Nhà/Văn Phòng, Màu Đen Trắng - 100 inch",204000,204000,0,0
TIKI,thoi-trang-nu,195291832,"Váy ngủ 2 dâu xuyên thấu phối ren sexy gợi cảm P12a - Đầm ngủ nữ seexy quyến rũ - Đồ ngủ nữ",269000,350000,81000,23
TIKI,cross-border-hang-quoc-te,171089881,"Thạch Giúp Cân Bằng Và Ngăn Nhiễm Trùng Đường Tiết Niệu COZO Cranberry Jelly Chiết Xuất Nam Việt Quất Và Elderberry, Tăng Khả Năng Miễn Dịch",852000,852000,0,0
TIKI,cross-border-hang-quoc-te,170704473,"Sách - Beyond Good and Evil by Friedrich Nietzsche (US edition, paperback)",371000,371000,0,0
TIKI,cross-border-hang-quoc-te,107860639,"Bình xịt vệ sinh cá nhân cầm tay cho phụ nữ",152500,152500,0,0
TIKI,cross-border-hang-quoc-te,11504729,"Harvard Business Review: Guide To Project Management",477000,477000,0,0
TIKI,cross-border-hang-quoc-te,271773634,"Wireless Lavalier Microphone Clip-on Phone Wireless Mic Noise Reduction Plug-Play Wireless Mic for Vlog Live Stream",310000,310000,0,0
TIKI,cross-border-hang-quoc-te,94366242,"Open Breathable Leather Paly Buckle Belt Silicon Mouth Gag for Women",209000,209000,0,0
TIKI,cross-border-hang-quoc-te,188043098,"Sách - My Mechanical Romance by Alexene Farol Follmuth (UK edition, paperback)",305000,305000,0,0
TIKI,cross-border-hang-quoc-te,11471836,"The Hard Thing About Hard Things",677000,677000,0,0
TIKI,cross-border-hang-quoc-te,189573329,"Sách - Hopeless by Colleen Hoover (UK edition, paperback)",316000,316000,0,0
TIKI,cross-border-hang-quoc-te,191004714,"Ba lô leo núi chuyên nghiệp ngoài trời CAMEL CROWN 40L",1376000,1376000,0,0
TIKI,cross-border-hang-quoc-te,162124438,"Sách - The Spanish Love Deception : TikTok made me buy it! The Goodreads Choice A by Elena Armas (UK edition, paperback)",407000,407000,0,0
TIKI,thoi-trang-nam,38496061,"Combo 7 Quần lót nam tam giác cotton xịn nhiều lưng có size lớn màu ngẫu nhiên cao cấp mặc cực thoãi mái underwear SỊP HN7",135000,135000,0,0
TIKI,thoi-trang-nam,22492292,"Áo polo nam ngắn tay có cổ ( TẶNG QUẦN LÓT NAM CAO CẤP ) , Combo 2 áo, DokaFashion regular fit chuẩn hàng xuất, áo phông thun polo nam tay ngắn – EZ235",157000,285000,128000,45
TIKI,thoi-trang-nam,170400732,"SET 5 Chiếc Quần Lót Nam Không đường may cao cấp BADBIRD, quần lót nam, quần sịp nam dạng boxer, Thương hiệu Việt",315000,315000,0,0
TIKI,thoi-trang-nam,90979601,"Áo Khoác Dù Nam chống nước ( TẶNG QUẦN LÓT HÀNG HIỆU ) Dokafashion Cao Cấp 2 Lớp Vải Dù Ấm Áp Cản Gió Đi Nắng, Chống Nước EZDS23",147000,209000,62000,30
TIKI,thoi-trang-nam,154298071,"Combo 2 quần đùi nam, quần Short Gió nam thể thao Họa Tiết Rằn Ri trẻ trung năng động, thoáng mát co giãn 4 chiều MRM Manlywear",269000,399000,130000,33
TIKI,thoi-trang-nam,31638135,"Combo 4 quần lót nam Boxer sợi cạp 1cm sợi tre tự nhiên mềm mịn thấm hút mồ hôi, co giãn 4 chiều MRM Manlywear - Màu ngẫu nhiên",255000,340000,85000,25
TIKI,thoi-trang-nam,58838015,"Quần bơi nam vảy da cá thể thao chuyên nghiệp YOUYOU",109000,115040,6040,5
TIKI,thoi-trang-nam,164312116,"UNSTOPABLE đa sắc, mã G61. Áo thun hàng hiệu Goking, form unisex cho nam nữ, trẻ em, bé trai gái. Áo phông in đẹp, quà tặng cao cấp",119000,119000,0,0
TIKI,thoi-trang-nam,111850645,"Bộ Quần Áo KaKi Lính Mỹ US ARMY U569 Kiểu Dáng Túi Hộp Chiến Thuật, Chất Liệu Kaki Cao Cấp Phong Cách Lính Cực Ngầu - HÀNG CHÍNH HÃNG",855000,1798000,943000,52
TIKI,thoi-trang-nam,22610869,"Combo 3 Áo Thun nam HÀNG HIỆU đa phong cách -  ĐB3QC16 (Chọn Màu)- Vải thun cotton có điểm đặc biệt, thân thiện với làn da, co giãn và khả năng thấm hút tốt",300000,300000,0,0
TIKI,thoi-trang-nam,95052893,"Quần short nam big size quần sọt nam thể thao chống nóng quần đùi nam mặc nhà quần thun nam cotton 4 chiều co giãn cao cấp WSB2",69000,115000,46000,40
TIKI,thoi-trang-nam,163149118,"Áo Sơ Mi Trơn Vải Lụa Tay Ngắn Cho Nam LADOS - 8069",118000,199000,81000,41
TIKI,thoi-trang-nam,71985742,"Áo khoác dù UV mẫu mới 2024 ( Tặng 1 áo khoác kaki ) - Áo Khoác Chống Nắng đến 98% Chống Thấm Nước Có Túi Trong Kèm Túi Khóa Kéo Phong Cách Trẻ Trung",298000,298000,0,0
TIKI,thoi-trang-nam,186133766,"Quần Short Kaki Nam US ARMY, Quần Túi Hộp Nam Phong Cách Lính Chất Liệu KaKi Cao Cấp, Kiểu Dáng Trẻ Trung Năng Động -HÀNG CHÍNH HÃNG",283000,598000,315000,53
TIKI,thoi-trang-nam,74536479,"Áo khoác nam áo gió vải dù ( Tặng quần lót hàng hiệu ) DOKA STORE cao cấp 2 lớp chống nắng tia UV và chống nước khoát phong cách Hàn Quốc DF20",149000,149000,0,0
TIKI,thoi-trang-nam,99968881,"Set 2 quần đùi nam, quần Short Gió nam thể thao Basic trẻ trung năng động, thoáng mát co giãn 4 chiều MRM Manlywear",255000,399000,144000,36
TIKI,thoi-trang-nam,31637590,"Combo 4 quần lót nam tam giác Bamboo Organic mềm mịn thoáng mát thấm hút mồ hôi - MRM Manlywear - Màu Ngẫu Nhiên",249000,340000,91000,27
TIKI,thoi-trang-nam,4965821,"Combo 4 Quần Lót Nam vải lạnh co giãn 4 chiều lưng CITYMEN cao cấp, đồ lót - LMTK-CTMAL",118000,118000,0,0
TIKI,thoi-trang-nam,193504415,"Combo 2 Áo thun thể thao nam MRM Active Pro thấm hút mồ hôi tốt co dãn thoải mái vận động",229000,399000,170000,43
TIKI,thoi-trang-nam,16712370,"Áo Khoác Kaki Nam Hai Lớp Simple Cao Cấp ShopN6-KK35",169000,245000,76000,31
TIKI,thoi-trang-nam,67903869,"Quần Âu nam Đen Vải Chéo Loại Đẹp,Quần Tây Nam co dãn không nhăn dáng hàn quốc",88000,88000,0,0
TIKI,thoi-trang-nam,104312787,"Quần Lót Nam lưng Hàn Quốc vải thun lạnh 4 chiều hiệu CITYMEN cao cấp, đồ lót - LMTK-HANAL",30000,30000,0,0
TIKI,thoi-trang-nam,75329276,"Áo Polo Nam( Tặng 1 quần lót thái ) Pique Basic Co Giãn Thoáng Khí, combo 2 áo - DBM215",239000,239000,0,0
TIKI,thoi-trang-nam,109403033,"Áo khoác gió nam nữ Goking, ngoài vải dù, trong lót lưới. 3 túi tiện dụng. Mã akg.goking4",225000,225000,0,0
TIKI,thoi-trang-nam,68573034,"Quần Bơi Nam Boxer Có Túi CLEACCO DEENYT Chất Liệu Nylon Cao Cấp , Chống Thấm , Nhanh Khô Form Fitness Thời Trang (Tặng kèm nón bơi + bịt tai silicon) - Hàng Chính Hãng",219000,323000,104000,32
TIKI,thoi-trang-nam,56873562,"Quần lót nam cao cấp thun lạnh (Dành cho các bạn từ 47-85kg), Co giãn 4 chiều cực tốt",26000,49000,23000,47
TIKI,thoi-trang-nam,56614642,"Combo 5 quần sịp boxer chất cotton mềm mịn, thoải mái",189000,245000,56000,23
TIKI,thoi-trang-nam,52189164,"Combo 3 quần lót nam sợi cotton Organic mềm mịn thoáng mát co giãn 4 chiều MRM Manlywear (TẶNG Đôi Tất Nam Cao Cấp màu ngẫu nhiên)",199000,255000,56000,22
TIKI,thoi-trang-nam,68202834,"Combo 2 áo ba lỗ nam, áo sát nách nam,sợi cotton cao cấp mềm mịn, thấm hút mồ hôi, siều thoáng mát, co giãn 4 chiều Mrm Manlywear - MM",249000,310000,61000,20
TIKI,thoi-trang-nam,117031543,"Áo thun Teeworld ỦA Version 2 T-Shirt Nam Nữ Form Rộng Unisex",299000,299000,0,0
TIKI,thoi-trang-nam,169619782,"SET 3 Chiếc Quần Lót Nam Không đường may cao cấp BADBIRD, quần lót nam, quần sịp nam dạng boxer, Thương hiệu Việt",189000,199000,10000,5
TIKI,thoi-trang-nam,126146318,"Áo sơ mi nam trơn không nhăn LADOS - 523, Chất vải mềm mát, thấm hút mồ hôi tốt, form slimfit",116000,179000,63000,35
TIKI,thoi-trang-nam,20527249,"Quần Short Nam Khatoco Q3M318R0-VNMA030-2009-018",129000,318000,189000,59
TIKI,thoi-trang-nam,168067501,"Hộp 5 Quần Lót Nam lưng CITYMEN vải lạnh co giãn 4 chiều cao cấp, sịp nam - LMTK-CTMAL",163000,163000,0,0
TIKI,thoi-trang-nam,23453099,"Áo sơ mi nam abd",95000,95000,0,0
TIKI,thoi-trang-nam,126701222,"Quần tây cao cấp dài LADOS - 1327 - Hàng chất lượng ( ẢNH THẬT) chất dày dặn co giãn nhẹ thoải mái",350000,350000,0,0
TIKI,thoi-trang-nam,14062488,"Combo 2 Áo thun ba lỗ thoát nhiệt Nhật Bản GOKING, áo lót nam hàng hiệu xuất khẩu Nhật Bản",258000,258000,0,0
TIKI,thoi-trang-nam,22492292,"Áo polo nam ngắn tay có cổ ( TẶNG QUẦN LÓT NAM CAO CẤP ) , Combo 2 áo, DokaFashion regular fit chuẩn hàng xuất, áo phông thun polo nam tay ngắn – EZ235",157000,285000,128000,45
TIKI,thoi-trang-nam,145266582,"Combo 3 quần sịp tam giác, Set 3 quần lót nam dáng Brief ARISTINO chất liệu Bamboo thoáng mát, kháng khuẩn khử mùi cực tốt AC-06",198000,240000,42000,18
TIKI,thoi-trang-nam,20518143,"Quần Short Nam Khatoco Q3M318R0-VNMA029-2009-018",129000,318000,189000,59
TIKI,thoi-trang-nam,71909603,"Áo hoodie nam nữ form rộng Unisex một màu in hoạt hình cá tính Hàn Quốc – FORMEN SHOP – FMGV034",105000,199000,94000,47
TIKI,thoi-trang-nam,103076103,"áo ba lỗ nam, áo 3 lỗ nam sợi cotton Organic mềm mịn siêu thoáng mát thấm hút mồ hôi JAMANO",79000,99000,20000,20
TIKI,thoi-trang-nam,107186342,"Quần Tây Âu Nam Co Giãn Nhẹ Dáng Ôm, Quần Nam Công Sở Lịch Sự Phù Hợp Mọi Hoàn Cảnh Thương Hiệu Chandi Mã NT334",175000,299000,124000,41
TIKI,thoi-trang-nam,167432515,"Đồ Lót Nam tam giác vải cotton 2 chiều nhiều lưng hiệu CITYMEN, màu ngẫu nhiên, quần lót - LMTK-MULTI2C",20000,20000,0,0
TIKI,thoi-trang-nam,68202834,"Combo 2 áo ba lỗ nam, áo sát nách nam,sợi cotton cao cấp mềm mịn, thấm hút mồ hôi, siều thoáng mát, co giãn 4 chiều Mrm Manlywear - MM",249000,310000,61000,20
TIKI,thoi-trang-nam,47811534,"Quần shorts thể thao nam dạng sọt sport đùi chất thun lạnh 4 chiều cao cấp phù hợp tập gym hay mặc nhà có màu trắng và đen DUI-P101",115000,115000,0,0
TIKI,thoi-trang-nam,67231390,"Quần tây nam đen ống côn Hàn Quốc vải co giãn mát mẻ",39000,39000,0,0
TIKI,thoi-trang-nam,9730171,"Combo 10 Quần Lót Nam nhiều lưng vải cotton 2 chiều hiệu CITYMEN, màu ngẫu nhiên, sịp nam - LMTK-MULTI2C",180000,180000,0,0
TIKI,thoi-trang-nam,20518115,"Quần Kaki Nam Khatoco Q2M468R1-VNMA017-1908-1- Xanh Rêu",169000,468000,299000,64
TIKI,thoi-trang-nam,99410538,"Áo thun polo Bảo Bảo Store Vải cá sấu chất xịn, có viền cổ trẻ trung, lịch lãm hàng xuất -Hình ảnh độc quyền của shop",66000,120000,54000,45
TIKI,thoi-trang-nam,22490714,"Áo thun nam cổ bẻ ( Tặng 1 ví da nam hàng hiệu ) vải cá sấu, Combo 2 áo – EZ212",199000,285000,86000,30
TIKI,thoi-trang-nam,142409966,"Áo Thể Thao Nam Polo TSIMPLE cổ bẻ tay ngắn vải thun lạnh thoáng mát phong cách trẻ trung chuẩn form MSSAHCD",119000,206000,87000,42
TIKI,thoi-trang-nam,104192913,"Quần Lót Nam sợi thun lạnh thông hơi kháng khuẩn, Quần Sịp Nam co giãn 4 chiều thấm hút mồ hôi cực tốt thương hiệu BAW (combo 3 màu ngẫu nhiên) NT7987",99000,99000,0,0
TIKI,thoi-trang-nam,151047669,"COMBO HỘP 4 Quần Lót Nam Boxer Thun Lạnh ICON Demin, Quần Sịp Đùi nam boxer thun lạnh co dãn 4 chiều cao cấp loại 1 (che tên) MINHSTORE",139000,139000,0,0
TIKI,thoi-trang-nam,31638205,"Combo 4 quần lót nam cạp 1cm sợi tre Bamboo tự nhiên mềm mịn thấm hút mồ hôi - Màu Ngẫu nhiên",229000,300000,71000,24
TIKI,the-thao-da-ngoai,272620668,"Gel Uống Bổ Sung GU Roctane Gel gói 32g",69000,69000,0,0
TIKI,the-thao-da-ngoai,1599479,"Máy Tập Cơ Bụng Đa Năng Cải Tiến New Six Pack Care  KM2017 (hàng nhập khẩu)",799000,1198500,399500,33
TIKI,the-thao-da-ngoai,52040314,"Máy Tập Đa năng New Six Pack Care mẫu mới model KM2017 (Hàng nhập khẩu)",859000,1599000,740000,46
TIKI,the-thao-da-ngoai,125285272,"Máy chạy bộ tại nhà Kingsport BK-8000 Pro đa năng có chức nâng dốc tự động, kèm theo đai massage và thanh gập bụng",13500000,13500000,0,0
TIKI,the-thao-da-ngoai,125284613,"Máy chạy bộ tại nhà KingSport BK-8000 Đa Năng có thảm chạy rộng chống trơn trượt, chống ồn, kèm theo đai massage và thanh gập bụng",11406000,13000000,1594000,12
TIKI,the-thao-da-ngoai,21947276,"Thảm Tập YoGa miDoctor +Bao Thảm Tập Yoga + Dây Thảm Tập Yoga",112000,112000,0,0
TIKI,the-thao-da-ngoai,58547423,"Túi đeo bụng chạy bộ chống nước, đai đeo điện thoại chạy bộ, túi đeo hông chạy bộ phản quang GoodFit GF106RB",129000,199000,70000,35
TIKI,the-thao-da-ngoai,16974932,"Kính bơi chống tia UV , Chống sương mù  , bảo vệ mắt YESURE Cleacco  - Hàng Chính Hãng",249000,404000,155000,38
TIKI,the-thao-da-ngoai,1599467,"Máy Tập Cơ Bụng Đa Năng Cải Tiến New Six Pack Care KM2018 (hàng nhập khẩu)",1099000,1899000,800000,42
TIKI,the-thao-da-ngoai,44434176,"Máy chạy bộ cơ đa năng BG mẫu mới Treadmill SH306 5 in 1 thích hợp cho mọi lứa tuổi luyện tập (hàng nhập khẩu)",1632000,2999000,1367000,46
TIKI,the-thao-da-ngoai,66907970,"Xà Đơn Treo Tường Cleacco Làm Từ Ống Thép Và Nhựa PVC Với Nhiều Chức Năng Tập Luyện Khác Nhau",319000,459000,140000,31
TIKI,the-thao-da-ngoai,32440826,"Thảm Yoga Định Tuyến miDoctor + Bao Đựng Thảm Yoga Định Tuyến + Dây Buộc Thảm Yoga",139000,139000,0,0
TIKI,the-thao-da-ngoai,568178,"Máy Tập Bụng New Six Pack Care New 2018",1099000,1999000,900000,45
TIKI,the-thao-da-ngoai,147389103,"Bao găng tay tập gym kết hợp quấn bảo vệ cổ tay Cleacco J55 - Hàng chính hãng BORO SPORT",111000,201000,90000,45
TIKI,the-thao-da-ngoai,54734250,"Dây Nhảy Tập Thể Dục Cao Cấp Tại Nhà",14000,14000,0,0
TIKI,the-thao-da-ngoai,216128968,"BG Ghế tập bụng ALL MODEL - Máy tập thể dục, thể hình, tập gym đa năng phù hợp cho cả nam và nữ",699000,1299000,600000,46
TIKI,the-thao-da-ngoai,68399004,"Băng Bảo Vệ Đầu Gối Bó Cơ VN09, Băng Gối Thể Thao Cao Cấp VNS (1 Đôi)",125000,150000,25000,17
TIKI,the-thao-da-ngoai,66620428,"Xà Đơn Treo Tường Gắn Cửa Đa Năng Độ Dài Tùy Chỉnh Giúp Bạn Tập Gym, Tập Cơ Bụng, Cơ Vai, Cơ Xô 60-120Cm - Chính Hãng miDoctor (Màu Ngẫu Nhiên)",109000,109000,0,0
TIKI,the-thao-da-ngoai,147672795,"Xà Đơn Treo Tường Gắn Cửa Đa Năng Độ Dài Tùy Chỉnh Giúp Bạn Tập Gym, Tập Cơ Bụng, Cơ Vai, Cơ Xô 60-120Cm - Chính Hãng dododios (Màu Ngẫu Nhiên)",109000,109000,0,0
TIKI,the-thao-da-ngoai,48813144,"Dụng cụ tập cơ tay điều chỉnh lực từ 5-60kg tặng kèm bóp tay thể thao (Màu ngẫu nhiên)",39000,39000,0,0
TIKI,the-thao-da-ngoai,54896822,"Kính bơi chống sương mờ , chống UV Cleacco",121000,201000,80000,40
TIKI,the-thao-da-ngoai,183500376,"Kính bơi chống sương mờ, chống UV, dây được làm 100% silicone mềm mại, thiết kế không trơn trượt, độ co giãn, độ bền thách thức thời gian, dành cho vận động viên chuyên nghiệp, kính bơi cận thị có độ - Chính hãng DODODIOS",79000,79000,0,0
TIKI,the-thao-da-ngoai,191282295,"Bộ tạ đeo chân Zasami - 2kg/4kg/1 đôi - Tập kháng lực nâng cao sức khoẻ nhỏ gọn tiện lợi tại nhà",450000,675000,225000,33
TIKI,the-thao-da-ngoai,88216202,"Thanh xà đơn gắn cửa, xà đơn treo tường GoodFit chịu lực 200kg, chốt khóa an toàn chông trượt tập luyện tại nhà GF201PU",399000,649000,250000,39
TIKI,the-thao-da-ngoai,192455633,"Kìm bóp tập tay dụng cụ hỗ trợ tập cơ tay, cẳng tay, kìm tùy chỉnh lực từ 5 đến 60kg có bộ đếm số",69000,95000,26000,27
TIKI,cross-border-hang-quoc-te,108600088,"Áo khoác phản quang cho nam đi xe đạp và các hoạt động thể thao ngoài trời",430000,430000,0,0
TIKI,the-thao-da-ngoai,57693595,"Bó gối, băng gối thể thao GoodFit dày dặn co giãn 4 chiều, bó gối bóng chuyền kèm dây quấn trợ lực chắc chắn GF511K",99000,150000,51000,34
TIKI,cross-border-hang-quoc-te,170722326,"Sách - What to Expect When You're Expecting by unknown,Heidi Murkoff (US edition, paperback)",839000,839000,0,0
TIKI,the-thao-da-ngoai,147389103,"Bao găng tay tập gym kết hợp quấn bảo vệ cổ tay Cleacco J55 - Hàng chính hãng BORO SPORT",109000,201000,92000,46
TIKI,the-thao-da-ngoai,187619110,"Đèn Pin Đội Đầu Siêu Sáng US ARMY T6 Bóng Led,  Đa Chức Năng, Không Thấm Nước Dung Lượng Pin 5800 mAh Có Thể Sạc Lại Công Suất Đèn  10W- HÀNG CHÍNH HÃNG",146000,299000,153000,51
TIKI,the-thao-da-ngoai,97119072,"DÂY NHẢY TẬP THỂ DỤC CAO CẤP TẠI NHÀ LÕI THÉP ĐỘ BỀN CAO, TAY CẦM CHỐNG TRƯỢT – HÀNG CHÍNH HÃNG",37000,90000,53000,59
TIKI,the-thao-da-ngoai,194845698,"[Chính hãng] Ostrovit Creatine Monohydrate (300g) Hỗ Trợ Tăng Cơ, Tăng Sức Mạnh & Hiệu Suất Tập Luyện",399000,399000,0,0
TIKI,the-thao-da-ngoai,103209829,"[TẶNG 3 CẦU] Vợt cầu lông cán liền cao cấp chính hãng Agnite -  Tặng hộp cầu nhựa và bao đựng - 2 chiếc - F2131",770400,770400,0,0
TIKI,the-thao-da-ngoai,254081998,"Máy Tập Đa năng,Máy Tập Cơ Bụng Đa Năng - Kết Hợp Tập Bụng, Tập Eo, Tập Gym, Tập Thể Hình Tại Nhà (Hàng nhập khẩu)",1345000,2690000,1345000,50
TIKI,the-thao-da-ngoai,165346320,"Dây Nhảy Đếm Số, Đo Calo, Khoảng Cách Cao Cấp Chính Hãng miDoctor - Kèm Bóng Xoay Cho Người Mới Bắt Đầu Tập",59000,59000,0,0
TIKI,the-thao-da-ngoai,72081063,"Tất chống trơn đá bóng, vớ chống trơn chống trượt đá banh",30000,30000,0,0
TIKI,cross-border-hang-quoc-te,95367701,"Thẻ nhớ USB 3.0 dung lượng 2TB",325000,325000,0,0
TIKI,the-thao-da-ngoai,176626447,"Ngũ cốc giảm cân Granola NOFA không đường siêu hạt Ăn kiêng",129000,129000,0,0
TIKI,cross-border-hang-quoc-te,177496878,"D110 Label Maker Machine with 1 Roll Printer Paper Portable Bluetooth Thermal Printer for Home Office",834000,834000,0,0
TIKI,cross-border-hang-quoc-te,95728714,"Cặp đệm tai thay thế cho tai nghe BOSE QuietComfort qc35",262500,262500,0,0
TIKI,the-thao-da-ngoai,193003854,"Máy Chạy Bộ Điện Tại Nhà Zasami KZ-CX1",6600000,9500000,2900000,31
TIKI,cross-border-hang-quoc-te,170721330,"Sách - What Got You Here Won't Get You There : How Successful People Be by Dr Marshall Goldsmith (US edition, paperback)",397000,397000,0,0
TIKI,the-thao-da-ngoai,142321828,"Khăn Trùm Đầu , Khăn Đa Năng , Khăn Trùm Mặt Che Nắng Đi Phượt Đa Năng Cao Cấp Chống Tia UV Vải Thoáng Khí, Mau Khô, Dễ Mặc Cho Nam Và Nữ Dành Cho Phượt Thủ",43000,43000,0,0
TIKI,cross-border-hang-quoc-te,147169491,"Thiết Bị Khuếch Đại Âm Thanh Cho Đàn Guitar / Violin / Mandolin / Ukulele",244500,244500,0,0
TIKI,the-thao-da-ngoai,147423153,"Băng quấn bảo vệ cổ chân , mắt cá chân , lòng bàn chân , giúp tránh chấn thương , tăng khả năng vận động HJ020 - Hàng chính hãng",77000,149000,72000,48
TIKI,cross-border-hang-quoc-te,17970189,"Letters From A Stoic (New Cover)",356000,356000,0,0
TIKI,cross-border-hang-quoc-te,112016134,"Quần dành cho nam đi xe đạp 4D có đệm-Màu đen-Size",444100,444100,0,0
TIKI,cross-border-hang-quoc-te,174400347,"Sách - Divided : Why We're Living in an Age of Walls by Tim Marshall (UK edition, paperback)",398000,398000,0,0
TIKI,the-thao-da-ngoai,193150593,"Đai Treo Xà Kéo Giãn Cột Sống An Cốt Nam Cho Người Thoái Hóa, Thoát Vị",194000,256900,62900,24
TIKI,the-thao-da-ngoai,169749545,"Tất Chống Trượt Thể Thao VNSPORT - TCT01, Vớ Thể Thao Có Silicone Chống Trượt Giày Khi Chạy Nhảy Vận Động Ở Cường Độ Cao",33000,50000,17000,34
TIKI,the-thao-da-ngoai,6658395,"Xe đạp tập thể dục kết hợp tay chân tập luyện trong nhà BG",1599000,2699000,1100000,41
TIKI,cross-border-hang-quoc-te,170726435,"Sách - Six of Crows : Book 1 by Leigh Bardugo (UK edition, paperback)",443000,443000,0,0
TIKI,cross-border-hang-quoc-te,170661823,"Sách - The 7 Habits of Highly Effective People : 30th Anniversary Card Deck by Stephen R. Covey (US edition, paperback)",606000,606000,0,0
TIKI,cross-border-hang-quoc-te,51202213,"4Pcs/Set PU Leather Sports Golf Club Headcover Wood Putter Driver Head Cover",219000,219000,0,0
TIKI,the-thao-da-ngoai,977095,"Hộp 1 Đôi Nút Bịt Tai 2 Chức Năng Chống Ồn, Chống Nước Ear Seals® Mack's #11",169000,169000,0,0
TIKI,cross-border-hang-quoc-te,95729051,"1 Cặp đệm tai nghe audio-technica ath-m50x",262500,262500,0,0
TIKI,the-thao-da-ngoai,55205646,"Kính bơi cận CLEACCO độ cận từ 2 độ tới 7 độ chất liệu PC chống nước , chống tia UV , Chống sương mù , bảo vệ mắt - Hàng chính hãng",279000,404000,125000,31
TIKI,cross-border-hang-quoc-te,169018565,"Sách - If We Were Villains by M. L. Rio (UK edition, paperback)",411000,411000,0,0
TIKI,cross-border-hang-quoc-te,191268792,"Viên uống Kirkland Signature CoQ10 300 mg, 100 viên",633000,633000,0,0
TIKI,cross-border-hang-quoc-te,170600668,"Sách - The Rise and Fall of the Great Powers by Paul Kennedy (UK edition, paperback)",704000,704000,0,0
TIKI,cross-border-hang-quoc-te,184412812,"Quick Release Plate Clamp for Camera Tripod with 2x Spirit Level Plate Mount Adapter",361000,361000,0,0
TIKI,cross-border-hang-quoc-te,46334728,"Tay Cầm Bằng Gỗ Dương Cầm Chỉnh Cờ Lê Grand Piano Sửa Chữa Bảo Trì Dụng Cụ",747000,747000,0,0
TIKI,thoi-trang-nam,76271955,"Quần Lót Nam tam giác vải cotton co giãn 2 chiều lưng Thái hiệu CITYMEN, màu ngẫu nhiên, đồ lót - LMTK-THAI2C",20000,20000,0,0
TIKI,cross-border-hang-quoc-te,184951515,"Bộ 10 Dụng Cụ Pha Chế Cocktail",463000,463000,0,0
TIKI,cross-border-hang-quoc-te,135229882,"Hoạt Hình Túi Xách Thời Trang Mới Hello Kitty Túi Nữ Da Đeo Chéo Túi Đeo Vai Cinnamoroll Dây Kéo Túi Đựng Điện Thoại - one",458197,458197,0,0
TIKI,cross-border-hang-quoc-te,11466602,"First Thousand Words In Chinese",281000,281000,0,0
TIKI,cross-border-hang-quoc-te,7917818,"Multipliers",440000,440000,0,0
TIKI,cross-border-hang-quoc-te,175886807,"Sách - Why Has Nobody Told Me This Before? by Dr Julie Smith (US edition, hardcover)",819000,819000,0,0
TIKI,the-thao-da-ngoai,50583334,"Máy Tập Cơ Bụng Đa Năng,Máy Tập Cơ Bụng Đa Năng Tập Bụng, Lưng, Eo Tại Nhà Gấp Gọn Tiện Lợi Tập Được Nhiều Động Tác Khác Nhau (hàng nhập khẩu)",2299000,2299000,0,0
TIKI,the-thao-da-ngoai,13853076,"Túi Ngủ Cao Cấp Văn Phòng + Đi Phượt GSTN02 (Hàng Xuất Khẩu)",269000,389000,120000,31
TIKI,thoi-trang-nam,190516091,"Combo 3 quần lót nam boxer CITYMEN lưng Hàn Quốc cao cấp vải cotton co dãn 4 chiều mềm mại thoáng khí thấm hút tốt, quần xịp sịp đùi nam - Giao màu ngẫu nhiên",140000,140000,0,0
TIKI,cross-border-hang-quoc-te,184995159,"30 Tone Glockenspiel Xylophone Percussion Gift with Carrying Bag Mallets",716000,716000,0,0
TIKI,thoi-trang-nam,195882562,"Hộp 5 quần lót nam Boxer cao cấp nhiều lưng vải cotton 4 chiều có phối lưới mịn mát thoáng khí co giãn đàn hồi tốt, nhiều màu, quần xì đồ lót sịp đùi nam - ( Giao màu ngãu nhiên )",140000,140000,0,0
TIKI,thoi-trang-nam,110938120,"Áo Phông Nam Lính Mỹ (2 Màu), Chất Liệu Mềm Mại, Thoáng Mát, Chống Nhăn, Phom Dáng Xuông Trẻ Trung, Năng Động (U289)-HÀNG CHÍNH HÃNG",225000,499000,274000,55
TIKI,thoi-trang-nam,158720374,"Áo thun trơn nam ZAVAS, cổ tròn ngắn tay chất vải cotton cao cấp, áo phông tiêu chuẩn thoáng mát thấm hút mồ hôi không gây nóng nực, co giãn tốt - ZT01",149000,189000,40000,21
TIKI,thoi-trang-nam,111560211,"Quần Túi Hộp Nam Kaki Thời Trang Phong Cách Thể Thao US678 Chất Vải Kaki Cao Cấp Phong Cách Lính- HÀNG CHÍNH HÃNG",278000,658000,380000,58
TIKI,thoi-trang-nam,20733222,"Áo khoác gió cách nhiệt GOKING có mũ, form unisex cho nam nữ. Ngoài vải dù, trong lót vải cào cách nhiệt. 3 túi to rộng, phối viền siêu đẹp",255000,255000,0,0
TIKI,cross-border-hang-quoc-te,194807248,"Canxi Nước cho bé Naturade Liquid Calcium Magnesium & Vitamin D3 474ml (01/2024) (Chai)",331000,331000,0,0
TIKI,the-thao-da-ngoai,19751771,"Thảm Tập Yoga miDoctor + Bao Tập Thảm Yoga + Dây Buộc Thảm (Giao Màu Ngẫu Nhiên)",107000,107000,0,0
TIKI,cross-border-hang-quoc-te,115286437,"Cốc có quay bằng đồng đựng cocktail, nước trái cây, trà đá, bia và các loại đồ uống khác cho gia đình quán bar, nhà hàng",319000,319000,0,0
TIKI,the-thao-da-ngoai,42676831,"Quần bơi nam Boxer YESURE DEENYT  Chất liệu Superfine polyester cao cấp , chống thấm , nhanh khô form Fitness thời trang (Tặng kèm nón bơi + bịt tai silicon) - Hàng Chính Hãng",219000,323000,104000,32
TIKI,cross-border-hang-quoc-te,59222616,"Solid CornHole Toss Game Set and 8 Pieces Cornhole Bean Bag Pouch Toss Toy for Family Parties Kindergarten",764000,764000,0,0
TIKI,cross-border-hang-quoc-te,170625575,"Sách - Meditations : A New Translation by Marcus Aurelius (US edition, paperback)",361000,361000,0,0
TIKI,thoi-trang-nam,111599765,"Quần short jean nam, quần đùi nam chất liệu bò ( jean ) mềm mịn, from chuẩn hadong11",179000,179000,0,0
TIKI,thoi-trang-nam,43333663,"Combo 2 áo ba lỗ nam/áo 3 lỗ nam, sợi cotton mềm mịn siêu thoáng mát, thấm hút mồ hôi cực tốt, co giãn 4 chiều MRM FASHION -MM",229000,250000,21000,8
TIKI,thoi-trang-nam,22761075,"Áo thun nam cổ bẻ ( Tặng 1 dây nịt da ) combo 3 áo  vải cá sấu - EZ334",399000,399000,0,0
TIKI,thoi-trang-nam,88011112,"Quần short nam Dokafashion thể thao cao cấp năng động cá tính EZQT01",57000,80000,23000,29
TIKI,thoi-trang-nam,143599914,"Áo thun ba lỗ nam, áo basic Aristino AC-21 màu trắng, chất liệu 100% cotton thấm hút mồ hôi cực thoáng mát, phù hợp thể dục, thể thao, mặc lót bên trong",79800,95000,15200,16
TIKI,the-thao-da-ngoai,212285079,"Bình lắc Shaker pha sữa cho người tập GYM hiệu TCSPORTFOOD - Bình nước thể thao Shaker 600 ml (có nhiều màu lựa chọn)",55000,110000,55000,50
TIKI,thoi-trang-nam,81209773,"Quần Bò Nam cao cấp thương hiệu Chandi, chất jean co dãn Hot Trend mã MR9041",160550,169000,8450,5
TIKI,cross-border-hang-quoc-te,112016001,"Bàn đạp xe đạp bằng hợp kim nhôm siêu nhẹ thiết kế bản to có đinh chống trượt",197000,197000,0,0
TIKI,thoi-trang-nam,15997524,"Combo sỉ gồm 5 quần lót đùi nam xuất nhật - quần boxernam",99000,99000,0,0
TIKI,thoi-trang-nam,98380938,"Quần đùi nam cotton mặc nhà iBasic SHM003",129000,159000,30000,19
TIKI,the-thao-da-ngoai,34240496,"Khung Nắn Chỉnh Cột Sống, Khung Định Hình Cột Sống, Chống Thoát Vị Đĩa Đệm, Đau Lưng, Vai Gáy, Dụng Cụ Hỗ Trợ Tập Lưng - Chính Hãng miDoctor",69000,69000,0,0
TIKI,cross-border-hang-quoc-te,175886322,"Sách - I Used to Have a Plan : But Life Had Other Ideas by Alessandra Olanow (US edition, hardcover)",576000,576000,0,0
TIKI,cross-border-hang-quoc-te,129220702,"Sách - The Song of Achilles by Madeline Miller - (UK Edition, hardcover)",772000,772000,0,0
TIKI,thoi-trang-nam,11203758,"Combo 4 Quần Lót Đùi Nam Thông Hơi Thoáng Mát (Giao Màu Ngẫu Nhiên)",85000,85000,0,0
TIKI,thoi-trang-nam,182968034,"quần lót nam relax uderwear cotton cao cấp chính hãng siêu xịn, quần sịp nam rl003",69000,69000,0,0
TIKI,cross-border-hang-quoc-te,113486419,"PBT Keycaps, Thermal Dye Sublimation PBT Keycaps Set OEM Profile 108 Keycap Set for MX for Switches Mechanical Gaming Keyboard",246000,246000,0,0
TIKI,thoi-trang-nam,144146564,"Combo 3 quần sịp đùi nam, set 3 quần lót boxer nam Aristino chất liệu Modal cao cấp kháng khuẩn, khử mùi, mềm mại thoáng mát gấp 2 lần so với sợi vải thông thường ABX1616",298000,390000,92000,24
TIKI,the-thao-da-ngoai,186494607,"[Loại Cao Cấp - Giữ Nhiệt - Inox 304] bình lắc gym, bình lắc shaker, bình nước thể thao inox giữ nhiệt + kèm quả lắc Lò Xo - Hàng chính hãng DoDoDios",169000,169000,0,0
TIKI,the-thao-da-ngoai,55053644,"Kính bơi chống tia UV , Chống sương mù , bảo vệ mắt Cleacco - Hàng Chính Hãng",249000,404000,155000,38
TIKI,the-thao-da-ngoai,54876123,"Bộ 5 dây đàn hồi tập gym, dây đàn hồi  mini band tập yoga dây đàn hồi kháng lực cao cấp, dây đàn hồi tập thể dục Cleacco ( bộ 5 dây đủ màu trong 1 túi )",129000,201000,72000,36
TIKI,thoi-trang-nam,191452803,"Quần Đùi Nam cao cấp chất Cotton dày dặn thoáng mát đủ màu Big size mùa hè QD03 - PROMAN",120000,120000,0,0
TIKI,cross-border-hang-quoc-te,52837911,"Áo Khoác Nam Unisex áo Khoác Dài Tay áo Sơ Mi Nhà Bếp đồng Phục Bảo Hộ Lao động",239000,239000,0,0
TIKI,thoi-trang-nam,73742258,"Combo 5 Quần Lót Nam nhiều lưng co giãn 2 chiều vải cotton hiệu CITYMEN, màu ngẫu nhiên, đồ lót - LMTK-MULTI2C",90000,90000,0,0
TIKI,the-thao-da-ngoai,33395818,"Xà Đơn Treo Tường Gắn Cửa Đen Đỏ Chịu Lực 150kg Chính Hãng Đại Nam Sport + Kèm Găng Tay Tập Xà",168000,300000,132000,44
TIKI,cross-border-hang-quoc-te,188976683,"CAMEL CROWN Đèn Cắm Trại Ngoài Trời Đèn Lồng LED Sạc Trực Tiếp USB Cầm Tay Cắm Trại Chống Nước",1761000,1761000,0,0
TIKI,thoi-trang-nam,104904605,"Quần short nam big size quần sọt nam thể thao quần đùi nam mặc nhà quần thun nam cotton 4 chiều co giãn cao cấp ShopN6 - TSB2",59000,90000,31000,34
TIKI,cross-border-hang-quoc-te,126022275,"Sách - Discourses and Selected Writings by Epictetus - (UK Edition, paperback)",386000,386000,0,0
TIKI,thoi-trang-nam,172120459,"Bộ 4 quần đùi nam, quần short mặc nhà kate caro nhiều màu , mềm mịn  - FORMEN SHOP- FMTT002",139000,160000,21000,13
TIKI,cross-border-hang-quoc-te,17968980,"The Elements Of Style Illustrated",552000,552000,0,0
TIKI,cross-border-hang-quoc-te,175851291,"Keyboard case with integrated pen holder, detachable, wireless Bluetooth",231000,231000,0,0
TIKI,thoi-trang-nam,104192739,"Quần Boxer Nam sợi thun lạnh thông hơi kháng khuẩn, Quần Lót Nam co giãn 4 chiều thấm hút mồ hôi cực tốt thương hiệu BAW (combo 3 màu ngẫu nhiên) NT7986",199000,199000,0,0
TIKI,cross-border-hang-quoc-te,178060756,"Sách - Layla by Colleen Hoover (US edition, paperback)",488000,488000,0,0
TIKI,thoi-trang-nam,121252846,"Quần Boxer Nam sợi thun lạnh kháng khuẩn, Quần Lót Nam co giãn 4 chiều thấm hút mồ hôi cực tốt thương hiệu BAW (combo 3 màu ngẫu nhiên) NH79",189000,189000,0,0
TIKI,thoi-trang-nam,144752742,"Áo polo nam YODY Chất liệu Pique mắt chim bền màu, co giãn tốt, đàn hồi - APM3299",299000,299000,0,0
TIKI,thoi-trang-nam,76166657,"Quần khaki nam không ply ống ôm xanh dương pha tím nhạt Khatoco Q2M528S0-CNMA006-2006-0",199000,528000,329000,62
TIKI,cross-border-hang-quoc-te,51200738,"Dây Cáp Sạc USB 5Pin Cho Máy Ảnh Kỹ Thuật Số Canon",123000,123000,0,0
TIKI,thoi-trang-nam,87940800,"Quần Kaki Nam cao cấp thương hiệu Chandi, chất kaki co giãn xu hướng mã NT300-MÀU ĐEN",194000,239000,45000,19
TIKI,thoi-trang-nam,72691958," Áo thun tay lỡ cotton Bear [ áo thun tay lỡ unisex nam nữ đều mặc được",39000,39000,0,0
TIKI,thoi-trang-nam,67516826,"Áo sơ mi nam tay ngắn tím họa tiết Khatoco A1MN468T2-CNIN035-2110-N",374400,468000,93600,20
TIKI,thoi-trang-nam,33610954,"Áo khoác da cá GOKING 6 túi, form unisex cho nam nữ, trẻ em. Chống lanh, giữ ấm, chống nắng, chống tia UV",280000,280000,0,0
TIKI,thoi-trang-nam,76698261,"Quần jean nam ống suông vải co giãn may kỹ đẹp hàng công ty đưa ra loại quần jean công sở",99000,99000,0,0
TIKI,thoi-trang-nam,55411656,"Quần Bơi Nam Dáng Đùi Cao Cấp SZone SQB105 Vải Mềm Mại Co Giãn Cực Tốt Phong Cách Chuyên Nghiệp",55000,55000,0,0
TIKI,thoi-trang-nam,107801368,"Combo 2 quần đùi nam May 10 phiên bản có túi 2 bên, màu ngẫu nhiên",119000,119000,0,0
TIKI,the-thao-da-ngoai,67039784,"Băng Khớp Gối Glofit VN030 (Protect.Genu), Băng Trợ Lực Và Cố Định Đầu Gối, Hỗ Trợ Khớp Gối Trong Thể Thao Và Chấn Thương Vùng Gối (1 Chiếc)",345000,450000,105000,23
TIKI,thoi-trang-nam,72513159,"Áo khoác dù nam , áo khác dù nữ , áo khoác gió , áo khoác cặp đôi nam nữ mặc vải dù 2 lớp",90000,90000,0,0
TIKI,thoi-trang-nam,193492866,"Áo thun thể thao nam MRM Active Pro thấm hút mồ hôi tốt co dãn thoải mái vận động",119000,199000,80000,40
TIKI,thoi-trang-nam,54762494,"Áo sơ mi nam tay ngắn form ôm caro Khatoco A1MN438S1-CNCR015-2102-N",350400,438000,87600,20
TIKI,thoi-trang-nam,57800471,"Áo Khoác Dù Nam Hai Lớp Chống Nước Có Nón Áo Khoác Nam Dày Dặn Đi Phượt Cao Cấp AD54 - ShopN6 (Nhiều Màu)",129000,179000,50000,28
TIKI,thoi-trang-nam,75628604,"Áo khoác dù nam, áo gió nam cao cấp, chống nắng, chống bám bụi – FORMEN SHOP – FMHN005",109000,209000,100000,48
TIKI,the-thao-da-ngoai,25608349,"Thảm Yoga Định Tuyến 2 Lớp 6mm miDoctor + Bao Đựng Thảm Yoga Định Tuyến + Dây Buộc (Màu Ngẫu Nhiên)",139000,139000,0,0
TIKI,thoi-trang-nam,190515645,"Combo 4 quần sịp nam boxer cao cấp CITYMEN lưng Hàn Quốc cotton 100% thấm hút tốt co dãn 4 chiều mềm mại thoáng khí, quần lót xịp đùi nam - Giao màu ngẫu nhiên",190000,190000,0,0
TIKI,thoi-trang-nam,13670345,"Áo Thun Nam Trắng Trơn THUNTRANG01",23000,23000,0,0
TIKI,bach-hoa-online,13636229,"Ngũ Cốc Ăn Sáng Ăn Liền Nhật Bản - Tặng 1 Gói Trà Sữa Matcha Macca 20g",136400,136400,0,0
TIKI,bach-hoa-online,62723544,"KHÔ BÒ DẠNG CỤC TÂN LỘC PHÁT - HŨ 250G",97000,129000,32000,25
TIKI,bach-hoa-online,152695933,"BEST SELLER - BÁNH TRÁNG ABI SNACK",174000,174000,0,0
TIKI,bach-hoa-online,32334432,"Đặc Sản Phan Thiết - Nước Mắm Tĩn Trẻ Em Cá Cơm Than Cặp 2 Chai 250Ml Không Chất Bảo Quản, An Toàn Cho Bé",190000,380000,190000,50
TIKI,bach-hoa-online,157056291,"Quần áo cho Chó Mèo , Áo Giữ ấm ,Áo dày có tay. Quần Áo Thú Cưng - M",39000,39000,0,0
TIKI,bach-hoa-online,271617991,"Thùng 24 Ly Mì Lẩu Thái Tomyum NGON NGON VIFON (60g / Ly)",69600,69600,0,0
TIKI,bach-hoa-online,161462334,"Thùng 48 hộp sữa hạt và gạo lứt đỏ TH True Nut 180ml (180ml x 48)",589110,589110,0,0
TIKI,bach-hoa-online,4424835,"Dầu Ăn Hoa Cải Ajinomoto Bổ Sung Omega 3 & 6 (1000G)",88900,88900,0,0
TIKI,bach-hoa-online,72191805,"Thùng 48 Hộp Sữa Tươi Tiệt Trùng Vinamilk 100% Organic Không Đường 12 lốcx180ml-Mẫu mã mới",530000,530000,0,0
TIKI,bach-hoa-online,139011522,"Cattree nhà mèo 3 tầng - Nhà cây cho mèo (Hàng có sẵn)",350000,350000,0,0
TIKI,bach-hoa-online,181000483,"Đặc Sản Sóc Trăng - Bánh Pía Chay Dứa Sầu Riêng Tân Huê Viên 400G, Bánh Pía Không Trứng Tân Huê Viên Sóc Trăng",74480,76000,1520,2
TIKI,bach-hoa-online,19652386,"Kẹo hồng sâm không đường hàn quốc",57000,57000,0,0
TIKI,bach-hoa-online,7853177,"Trà tân cương thượng hạng 500 gram",155000,155000,0,0
TIKI,bach-hoa-online,86147390,"Nước tương hữu cơ Tamari và Teriyaki 200ml - PBFarm",108000,108000,0,0
TIKI,bach-hoa-online,109335244,"Pate Whiskas cho mèo gói 85g",13000,13000,0,0
TIKI,bach-hoa-online,99138532,"HẠT ĐIỀU RANG MUỐI VỠ TÂN LỘC PHÁT HŨ 500G",53000,72800,19800,27
TIKI,bach-hoa-online,192917906,"Kẹo chanh muối himalaya malaysia",86888,86888,0,0
TIKI,bach-hoa-online,187188571,"Đặc Sản Phan Thiết - Nước Chấm Cá Cơm Than Làng Chài Xưa Chai Nhựa Cao Cấp 1 Lít/Chai Đặc Biệt Thanh Dịu An Toàn Tiết Kiệm",42000,60000,18000,30
TIKI,bach-hoa-online,1715929,"Sữa Bột Cho Chó Mèo Bio Milk (100g)",34444,34444,0,0
TIKI,bach-hoa-online,141291499,"Sữa non Anpha Lipid American 450g - 24h - Sữa Non Cao - Phòng ngừa tai biến - tốt cho tim mạch",510000,510000,0,0
TIKI,bach-hoa-online,128115713,"Combo 02 thùng Bia Sapporo Premium - 12 lon 500ml ",544000,640000,96000,15
TIKI,bach-hoa-online,145493674,"Alkin Fungikur xịt viêm da ghẻ nấm cho chó mèo ",75000,75000,0,0
TIKI,bach-hoa-online,144053958,"Mật mía nguyên chất Nhàn Đức, thơm ngon, siêu đặc, làm từ 100% cây mía tươi",52000,70000,18000,26
TIKI,bach-hoa-online,599724,"Trà Sữa Aik Cheong Vị Classic 3 In 1 600G (40 G X 15 Gói) - [9556771000554]",119000,129000,10000,8
TIKI,bach-hoa-online,134971266,"[COMBO 2 HŨ] Chà Bông Heo Xù Thượng Hạng Mỗi Hũ 250G SK FOOD",97000,150000,53000,35
TIKI,bach-hoa-online,109229577,"Combo 3 Gói Hạt Nêm Aji-ngon® Nấm Hương và Hạt Sen 200g/Gói",57000,57000,0,0
TIKI,bach-hoa-online,191073282,"LƯỢC CHẢI LÔNG CHO CHÓ MÈO HÌNH CHÂN GẤU CÓ NÚT BẤM",37999,37999,0,0
TIKI,bach-hoa-online,10691690,"Thùng 12 hộp Nước dừa dứa VICO FRESH (1 lít / hộp)",630000,630000,0,0
TIKI,bach-hoa-online,160642697,"Trà sencha hoa hồng L'angfarm, 86g, hộp, mẫu stamp",109000,109000,0,0
TIKI,bach-hoa-online,99078020,"Lốc 8 gói mì kim chi Ottogi 120g",76800,76800,0,0
TIKI,bach-hoa-online,2783849,"Thùng Fristi Hương Dâu 48x80ml",190000,190000,0,0
TIKI,bach-hoa-online,140861988,"Xịt trị ve rận cho chó mèo Hantox Spray",27268,27268,0,0
TIKI,bach-hoa-online,128471926,"[CHÍNH HÃNG] Bột Cần Tây Sấy Lạnh Nguyên Chất  - Hỗ trợ giảm cân, giảm mỡ bụng, giảm mụn, giảm gút - Gói 50gr",165000,240000,75000,31
TIKI,bach-hoa-online,1717857,"Thức Ăn Cho Chó Royal Canin Poodle Adult (1.5kg)",419999,419999,0,0
TIKI,bach-hoa-online,73089745,"Rượu Vodka Absolut Vị vanilla 700ml 38% - 41% - Không kèm hộp",486000,486000,0,0
TIKI,bach-hoa-online,142471179,"Nồng độ cồn 4.9% - Thùng 24 lon bia Tuborg 330ml",345000,365000,20000,5
TIKI,bach-hoa-online,55524540,"Cà Phê Đen Hòa Tan Espresso KING COFFEE - Hộp 15 gói x 2.5g",56700,59600,2900,5
TIKI,bach-hoa-online,138813681,"Cám Thái inve 5/8 - thức ăn cho cá cảnh",38000,38000,0,0
TIKI,bach-hoa-online,20843221,"Thùng 24 Gói Mì Chay Rau Nấm Yomee 65g Hàng Xuất Khẩu Chất Lượng Cao Hương Vị Thơm Ngon",99000,99000,0,0
TIKI,bach-hoa-online,5754769,"Combo 2 Hộp Chia Úc MFood 250g",90000,90000,0,0
TIKI,bach-hoa-online,74678885,"NHÂN HẠT MACCA TÁCH VỎ TÂN LỘC PHÁT - HỘP 250G",92000,199000,107000,54
TIKI,bach-hoa-online,89890414,"Sữa bột Gold Care  - Đông Trùng Hạ Thảo - Nano Curcumin - Sữa Non",230000,230000,0,0
TIKI,bach-hoa-online,164782817,"Đặc Sản Kon Tum - Chuối Hột Rừng Khô Đóng Gói Hút Chân Không 1Kg - OCOP 3 Sao",79000,79000,0,0
TIKI,bach-hoa-online,54809429,"HẠT ĐIỀU RANG TỎI ỚT TÂN LỘC PHÁT COMBO 1KG - MỖI HŨ 500G",87000,159000,72000,45
TIKI,bach-hoa-online,2688941,"Heyday Bột Cacao Nguyên Chất Không Đường Việt Nam - Dòng Origin - Chứng Nhận UTZ - Hỗ Trợ Giảm Cân - Túi Giấy 250g",108000,108000,0,0
TIKI,bach-hoa-online,138800731,"Combo Bột Rau Củ Thải Độc Dalahouse Hộp 63gr (Mẫu mới gồm 7 loại rau củ chia tuýp nhỏ) Sấy lạnh nguyên chất - Detox thanh lọc cơ thể",166500,185000,18500,10
TIKI,bach-hoa-online,48564057,"Đậu Đen Xanh Lòng Rang Mộc 1KG (Hạt Rời) - Mộc Thanh Trà",150000,150000,0,0
TIKI,bach-hoa-online,160658295,"Bánh gạo lứt ăn kiêng Hello Rice, bánh gạo lức nguyên hạt 300gr/500gr",29000,29000,0,0
TIKI,bach-hoa-online,151778898,"Bột Ca Cao Nguyên Chất 100% - MS Cacao (500g)",99000,100000,1000,1
TIKI,bach-hoa-online,92710915,"Bộ 12 túi thức ăn mèo con Whiskas vị cá thu túi 80g/túi",150000,150000,0,0
TIKI,bach-hoa-online,165947096,"Hạnh Nhân Rang Bơ Pams, Nhập Khẩu Mỹ Vỏ Mỏng Chất Lượng, Không Cholesterol, Dùng Ăn Kiêng",99000,188000,89000,47
TIKI,bach-hoa-online,176151045,"Ức gà cắt khúc - 180g - Đồ Hộp Hạ Long",28500,28500,0,0
TIKI,bach-hoa-online,50295630,"Combo 2 hộp Hạt Chia Đen Hữu Cơ Smile Nuts 500g - Nhập khẩu từ Nam Mỹ (Hạt Chia 100% Organic, hạt sáng, nở đều, không lẫn tạp chất)",188000,300000,112000,37
TIKI,bach-hoa-online,87021522,"Bột sắn dây cao cấp gói 500g - Sắn dây cho người ăn thực dưỡng - Bột được lắng lọc kỹ qua 18 lần nước, cho chất lượng bột mịn và nguyên chất nhất",150000,150000,0,0
TIKI,bach-hoa-online,52337909,"COMBO 4kg - Gạo Hữu Cơ Trắng Nàng Hương -  Nàng MEKONG - 100% Organic",224000,224000,0,0
TIKI,bach-hoa-online,38151252,"Ngũ Cốc Calbee Nhật Bản",133182,135900,2718,2
TIKI,bach-hoa-online,20769618,"Sữa bột Suremilk Canxi Gold 800g",324000,324000,0,0
TIKI,bach-hoa-online,103789164,"Combo 2 gói chè dưỡng nhan 12 vị - Mỗi gói 400gr",125000,125000,0,0
TIKI,bach-hoa-online,118133869,"Ớt Bằm Chilica 212g",41900,41900,0,0
TIKI,bach-hoa-online,125858381,"Xốt rang me Cholimex chai PET 280g",15000,15000,0,0
TIKI,bach-hoa-online,84795541,"HẠT ĐIỀU MẬT ONG 400g LAFOOCO Honey roasted cashew nuts",164700,189000,24300,13
TIKI,bach-hoa-online,58837755,"Trà Bưởi Nguyên chất giàu Vitamin Sanga Hàn Quốc (Hộp 30 gói)Mẫu mới",345000,450000,105000,23
TIKI,bach-hoa-online,177844180,"Sữa 9 loại hạt Vinamilk Super Nut - Thùng 24 hộp 180ml",290000,290000,0,0
TIKI,bach-hoa-online,144035152,"Thức ăn trộn hải sản/rang bơ 500g",28000,28000,0,0
TIKI,bach-hoa-online,34880303,"1KG ĐẬU PHỘNG SẤY TỎI ỚT TLP",74000,159000,85000,53
TIKI,bach-hoa-online,125265620,"Rượu Whisky Chivas Extra 13YO American Rye Cask 700ml 40% - Có hộp",849000,849000,0,0
TIKI,bach-hoa-online,141474699,"Đồ Ăn Vặt Xương Gặm Sạch Răng Cho Chó Orgo túi 90g - Xương Gặm Cho Chó, Bánh Thưởng Cho Chó",22888,22888,0,0
TIKI,bach-hoa-online,166322285,"Nước sốt Nhật Bản Teriyaki Cay - Dashi Lab - 340g/chai - chay mặn đều dùng được",96000,96000,0,0
TIKI,bach-hoa-online,20329659,"Combo 3 Hộp Trà Lạc Tiên Vherbs (3 Hộp x 16 Túi)",215100,239000,23900,10
TIKI,bach-hoa-online,580212,"Nước Ép Đào Và Trái Cây Hỗn Hợp Malee 1L (Thái Lan)",67700,67700,0,0
TIKI,bach-hoa-online,165987710,"Nước Mắm Chay Trái Điều Vương Ngọc 500ml, nước mắm chay làm từ trái điều giàu dinh dưỡng, thơm ngon tự nhiên",34000,60000,26000,43
TIKI,bach-hoa-online,185965626,"Kem đánh răng Borammy cho thú cưng kèm bàn chải (Kem đánh răng cho chó mèo)",78210,78210,0,0
TIKI,bach-hoa-online,35769138,"BÀN CÀO MÓNG CHO MÈO - tặng kèm cỏ bạc hà mèo",45555,45555,0,0
TIKI,bach-hoa-online,147293327,"Chuông Lục Lạc Cho Chó Mèo Siêu Kute (size Vừa & To)",9000,9000,0,0
TIKI,bach-hoa-online,132827021,"Bộ kềm cắt móng kèm giũa móng cho chó mèo -nhiều size",29000,29000,0,0
TIKI,bach-hoa-online,72878779,"Bột ngũ cốc dinh dưỡng Goce - 180g (18 gói x 10g)",88000,110000,22000,20
TIKI,bach-hoa-online,55133824,"KHÔ GÀ LÁ CHANH COMBO 1KG - MỖI HŨ 500G",119000,199000,80000,40
TIKI,bach-hoa-online,1083278,"Đặc Sản Thái Nguyên - Trà Móc Câu Đặc Biệt Lộc Tân Cương (100g) - Trà Thái Nguyên",72000,72000,0,0
TIKI,bach-hoa-online,21973761,"Thùng 48 Bịch Sữa Dinh Dưỡng Vinamilk Có Đường (220ml / Bịch)",352000,411000,59000,14
TIKI,bach-hoa-online,67333093,"Yến Mạch Tươi Canada Nguyên Chất túi 1kg ( Nguyên Hạt )",55000,55000,0,0
TIKI,the-thao-da-ngoai,46248186,"Bóng gai  cao su bóp tập tay phục hồi chức năng sau tai biến",4000,13379,9379,70
TIKI,the-thao-da-ngoai,26287806,"Dây nhảy thể dục Sportslink 2.7m (Màu ngẫu nhiên)",44000,142000,98000,69
TIKI,the-thao-da-ngoai,139915099,"Đầu bu chống xoắn dùng cho cần câu máy đủ kích cỡ",10000,10000,0,0
TIKI,the-thao-da-ngoai,40798649,"BÓNG TẬP YOGA GAI MÀU XANH DƯƠNG VNS017 (Tặng kèm bơm bóng và khóa van)",285000,380000,95000,25
TIKI,the-thao-da-ngoai,124942479,"Băng Chặn mồ hôi trán , Thể Thao sành điệu co dãn chống trượt TT17",35000,35000,0,0
TIKI,the-thao-da-ngoai,163851339,"Phao Câu Ngày Đêm Săn Hàng Fuwang",104600,104600,0,0
TIKI,the-thao-da-ngoai,42043190,"Dây thừng kéo co Thiên Trường tầm trung 7,6kg đến 8kg",810000,810000,0,0
TIKI,the-thao-da-ngoai,196597277,"Băng dán cơ thể thao Kinesiology Tape AOLIKES A-MT002",134000,199000,65000,33
TIKI,the-thao-da-ngoai,149605597,"Hộp đựng phụ kiện câu cá, mồi giả , hộp đựng mồi câu lure giá rẻ tiện lợi",16600,16600,0,0
TIKI,the-thao-da-ngoai,154961350,"Lưới đánh cá săn cá mương loại lưới chìm",329550,329550,0,0
TIKI,the-thao-da-ngoai,104935216,"Tạ gang đen 5kg",260000,260000,0,0
TIKI,the-thao-da-ngoai,146924756,"Quần Dài Jogger Nữ Thể Thao Chất Vải Thun Lạnh Co Dãn Mềm Mịn",204250,215000,10750,5
TIKI,the-thao-da-ngoai,68909224,"Quần Nam thể thao kiểu dáng Hàn Quốc - Q0010",185000,185000,0,0
TIKI,the-thao-da-ngoai,16257273,"Bật lửa Zippo  Clover High Polish Chrome Design 24699",1025000,1025000,0,0
TIKI,the-thao-da-ngoai,96521842," Khung trợ lực khớp gối cao cấp giúp bảo vệ đầu gối luôn chắc khỏe",175000,175000,0,0
TIKI,the-thao-da-ngoai,154934362,"Phao Câu Đài Ngày Đêm SHADOWLESS, phao câu đêm Phao câu cá PC-14",27600,27600,0,0
TIKI,the-thao-da-ngoai,35148054,"Bộ Kính Bơi Cận View V510 (Đen) Và Nút Bơi Nhét Tai EP405 - Hàng Chính Hãng",495000,725000,230000,32
TIKI,the-thao-da-ngoai,26664936,"Cán cờ đi tour 2,5m chuyên dành cho hướng dẫn viên du lịch công ty lữ hành",120000,120000,0,0
TIKI,the-thao-da-ngoai,191529358,"Kính Bơi Có Thể Điều Chỉnh Ucle Bills – Swimming Goggles (Màu sắc Ngẫu Nhiên)",66000,66000,0,0
TIKI,the-thao-da-ngoai,180035841,"Áo Ba Lỗ Tanktop Thể Thao Nam - LocalBrand X9 - Tập Gym Chạy Bộ Yoga - X002",380000,380000,0,0
TIKI,the-thao-da-ngoai,57352382,"Băng vải đeo cổ tay thấm mồ hôi thể thao (giao ngẫu nhiên)",19000,19000,0,0
TIKI,the-thao-da-ngoai,167025862,"Khóa Link Nhật - Bộ 10 mani nhật - Khóa Linh Chống Xoăn cao cấp - Phụ kiện câu cá",13300,13300,0,0
TIKI,the-thao-da-ngoai,138701914,"Giỏ Đựng Cá Rọng đựng cá",86450,86450,0,0
TIKI,the-thao-da-ngoai,183064756,"Bóng đá Futsal AKpro AF3800",387030,399000,11970,3
TIKI,the-thao-da-ngoai,140767517,"Khung nắn chỉnh kéo dãn cột sống cổ điện chuẩn từ chuyên thoái hóa đốt sống cổ, mỏi cổ do cúi nhiều-tuehanshoop-A11",225000,225000,0,0
TIKI,the-thao-da-ngoai,190093414,"Quấn cán tennis, cầu lông Bộ 5 cái có gân chống trơn POPO chất liệu thoáng khí thoát mồ hôi",133500,133500,0,0
TIKI,the-thao-da-ngoai,34316790,"Đôi đai bó đầu gối co dãn thể thao - Đen cam",68000,73500,5500,7
TIKI,the-thao-da-ngoai,157117939,"Dây Trục câu đài buộc sẵn cước câu cá 3260 , tảng hình cao cấp , cước trục fluorocacboncao chống mài mòn cực cao ( đồ câu a lâm )",14998,14998,0,0
TIKI,the-thao-da-ngoai,423988,"Bộ Chì Chân 1.6kg (Giao Màu Ngẫu Nhiên)",170000,170000,0,0
TIKI,the-thao-da-ngoai,197669061,"Chai Xịt Găng Tay Thủ Môn Bóng Đá - Hỗ Trợ Mặt Mút Bám Dính , Bám Chắc Banh",220000,220000,0,0
TIKI,the-thao-da-ngoai,54898667,"Áo bóng rổ Los Angeles Lakers - Mùa giải mới nhất - Bộ quần áo bóng rổ thi đấu",136000,259000,123000,47
TIKI,the-thao-da-ngoai,26304327,"Túi Ngủ Văn Phòng, Du Lịch Thông Minh Gấp Gọn Tiện Lợi",124900,124900,0,0
TIKI,the-thao-da-ngoai,1694261,"Băng Bảo Vệ Đầu Gối Khi Chơi Thể Thao Sportslink Litian Loại Dài - Màu Lính",70000,99000,29000,29
TIKI,the-thao-da-ngoai,146904732,"Bạt Phủ Đất Chống Cỏ Mọc, Chống Sói Mòn Đất 500*100CM",55000,55000,0,0
TIKI,the-thao-da-ngoai,149631058,"Bộ vợt câu cá inox siêu bền dài 1.7m-3m",148600,148600,0,0
TIKI,the-thao-da-ngoai,155435966,"Đèn pin 2 đầu đeo cổ Glocusent - sạc 1 lần dùng 1 tuần",990000,990000,0,0
TIKI,the-thao-da-ngoai,1374137,"Kính Bơi View V500S",279000,450000,171000,38
TIKI,the-thao-da-ngoai,149432550,"Vòng Lắc Eo Giảm Mỡ Bụng Ống Thép Bọc Mút Xốp - Tùy Chỉnh Độ Nặng - Chính Hãng miDoctor",159000,159000,0,0
TIKI,the-thao-da-ngoai,6565249,"Giày đá bóng Prowin RX + tặng kèm tất bóng đá cao cổ",218000,218000,0,0
TIKI,the-thao-da-ngoai,273675300,"Đồ chơi cầu lông cho bé trai và bé gái, màu ngẫu nhiên ( có sẵn 2 quả cầu)+Tặng kèm hộp đựng bút hình hộp sữa- Bộ 2 vợt cầu lông trẻ em",148000,159000,11000,7
TIKI,the-thao-da-ngoai,138737431,"Lưỡi câu cá lóc, cá ngão, cá chim , cá chê, cá rô , cá trắm, cá chép cao cấp",3400,3400,0,0
TIKI,the-thao-da-ngoai,75667664,"BAO TAY TẬP GYM, GĂNG TAY THỂ HÌNH - Lâm Sport - 1 CẶP - CÓ DÂY CUỘN CỔ TAY",32000,60000,28000,47
TIKI,the-thao-da-ngoai,26062511,"Bóng tập Yoga cao cấp 65cm dày 2mm chống nổ - Tặng bơm bóng và phụ kiện",133000,133000,0,0
TIKI,thoi-trang-nu,98772287,"Áo Thun Nữ Cổ Lọ Tay Dài Giữ Nhiệt Vải Thun Cao Cấp Mềm Mịn Ôm Dáng - MSP T22",65000,65000,0,0
TIKI,thoi-trang-nu,193012068,"Váy ngủ lụa hai dây hở lưng sexy gợi cảm P7 - Đầm ngủ lụa quyến rũ - Đồ ngủ nữ sexy",199000,279000,80000,29
TIKI,the-thao-da-ngoai,195972019,"Bộ cần câu cá - cần câu cá  kèm máy câu 5000 - Tặng kèm nhiều phụ kiện BCC03",299000,299000,0,0
TIKI,thoi-trang-nu,88912969,"Áo thun cotton cổ tim{ co dãn 4 chiều} hàng cao cấp",123000,123000,0,0
TIKI,the-thao-da-ngoai,68545318,"Bộ Sản Phẩm Con Lăn Massage Tập Yoga gai 33cm kèm Thanh lăn massage 5 bóng gai Yoga Cao Cấp",214000,219000,5000,2
TIKI,thoi-trang-nu,129402265,"Quần legging lót lông,quần legging nữ lót lông",131000,131000,0,0
TIKI,thoi-trang-nu,99280793,"Áo Lót Mút Mỏng Kèm Miếng Mút Rời Màu Hồng Nhạt Fashion Maggie Mae By Sabina SBT1074PL",315000,619000,304000,49
TIKI,thoi-trang-nu,181428988,"Bộ đồ linen tay cánh rơi nút xẻ sau trẻ trung (Áo nâu, quần Trắng)",350000,350000,0,0
TIKI,thoi-trang-nu,68962397,"Combo 2 quần lót nữ lọt khe",49000,49000,0,0
TIKI,the-thao-da-ngoai,165769111,"Combo Sữa tăng cơ giảm mỡ VEGAN PRO của APPLIED NUTRITION hộp 70 lần dùng 100% protein từ thực vật & Bình shaker 600ml (Mẫu ngẫu nhiên)",1850000,1850000,0,0
TIKI,thoi-trang-nu,136818293,"Bộ 2 miếng Mút đệm, Mút lót độn ngực hình tròn( dày 3cm ) dành cho Bra, Bikini, Đồ tập Yoga, Gym",49000,55000,6000,11
TIKI,the-thao-da-ngoai,33979580,"Kính Bơi Nam Nữ Cao Cấp miDoctor",88000,88000,0,0
TIKI,the-thao-da-ngoai,146905448,"Lồng Bát Quái Bẫy Cá, Tôm, Cua, Lươn, Trạch Lồng bát quái,lưới đánh Cá",171999,171999,0,0
TIKI,the-thao-da-ngoai,8073271,"Mũ bơi người lớn cao cấp Aolikes AL5010",68800,68800,0,0
TIKI,the-thao-da-ngoai,163747251,"Ghế Câu Đài Ghế Câu Cá Địa Hình Ghế Câu Xếp, Phụ Kiện Câu Đài",510500,510500,0,0
TIKI,thoi-trang-nu,157414523,"ÁO KHOÁC NỈ DÂY KHOÁ KÉO, ÁO KHOÁC HOODIES NỮ CHẤT THUN NỈ MỀM CÓ NÓN PHỐI CHỮ IN SIÊU HOT",110000,110000,0,0
TIKI,the-thao-da-ngoai,186392834,"Máy chạy bộ gấp gọn KingSmith R2 - Động cơ không chổi than vận hàng yên tĩnh - Hàng Chính Hãng",15500000,15500000,0,0
TIKI,thoi-trang-nu,158815678,"Quần lót ren nữ cạp cao hoạ tiết xinh xắn dễ mặc phù hợp với mọi đối tượng Lylylorem QL092",160000,160000,0,0
TIKI,the-thao-da-ngoai,156073792,"THÙNG ĐỰNG CÁ đa năng phụ kiện câu cá",80950,80950,0,0
TIKI,thoi-trang-nu,105673810,"Đầm xoè nữ kẻ sọc, đầm vải thun co giãn 4 chiều D83",141550,149000,7450,5
TIKI,the-thao-da-ngoai,139930294,"Cần Câu lure 2 ngọn máy đứng và máy ngang Hunting Black",410400,410400,0,0
TIKI,thoi-trang-nu,152523826,"Hàng nhập cao cấp - Quần legging cạp cao-Video + Sẵn hàng Quần legging nữ lưng thun cao cấp QL-201i",190000,190000,0,0
TIKI,thoi-trang-nu,113394038,"[Mẫu Mới] - Bộ Lanh cao cấp ( đã qua xử lý co ) - đủ size từ 47 - 70kg -  dành cho quý bà 2021 - Tuấn Tú Store",169000,169000,0,0
TIKI,the-thao-da-ngoai,67211545,"Bộ cần câu cá - Cần carbon huter Man - Máy Deukio chính hãng - Tặng kèm 9 phụ kiện CC02",489000,489000,0,0
TIKI,thoi-trang-nu,143687625,"GOTI - Áo Sơ Mi Công Sở Nữ Kiểu Áo Nữ Hàn Quốc Cổ Chữ V Kèm Phụ Kiện Ở Cổ - THỜI TRANG CÔNG SỞ 3A25",169000,169000,0,0
TIKI,the-thao-da-ngoai,178096707,"Thảm tập yoga 6mm 2 lớp cao cấp HENRYSA",165000,250000,85000,34
TIKI,thoi-trang-nu,106366427,"quần legging cạp cao gen bụng siêu tôn dáng",79000,79000,0,0
TIKI,the-thao-da-ngoai,174384074,"Băng Keo Thể Thao Đá Bóng Võ Thuật Gym… Quấn Cổ Tay, Cổ Chân Hạn Chế Chấn Thương Cao Su Non Vải Tự Dính",7000,7000,0,0
TIKI,the-thao-da-ngoai,196938285,"Thảm trải dã ngoại đi picnic 200x200 cm trải sàn CLEACCO   , đi pinic thiết kế gấp gọn tiện lợi mang đi BORO SPORT - Hàng chính hãng",209000,336000,127000,38
TIKI,the-thao-da-ngoai,38158215,"Đèn Pin Đội Đầu 2 Bóng LED Siêu Sáng Q5 cổng sạc USB",49000,49000,0,0
TIKI,the-thao-da-ngoai,790316,"Thảm Tập Yoga Eco Friendly TPE - Xanh Dương Đậm (6mm)",72000,72000,0,0
TIKI,the-thao-da-ngoai,139939138,"cần câu tay GW VÂN LONG 6h bạo lực - chuyên săn hàng",208550,208550,0,0
TIKI,the-thao-da-ngoai,163745945,"Thùng Đựng Cá MC chính hãng",439000,439000,0,0
TIKI,the-thao-da-ngoai,21316585,"Bộ 5 Dây Đàn Hồi Tập Gym Yoga, Dây Kháng Lực, Dây Đàn Hồi Tập Thể Dục- Hàng Chính Hãng",84500,84500,0,0
TIKI,the-thao-da-ngoai,88962763,"Combo 5 gói phao đèn câu đêm bẻ sáng",35000,35000,0,0
TIKI,thoi-trang-nu,34589122,"Đai sinh nhiệt giảm mỡ bụng Hot Belt cao cấp, size XL",81000,99000,18000,18
TIKI,thoi-trang-nu,142995282,"Áo Trung Niên Size Lớn Form Rộng Dạng Áo Sơ Mi Trung Niên Kiểu Nữ Cho Mẹ U50 U60 In Hoa Đẹp Cao Cấp Nhiều Mẫu GOTI 3A26",207000,235000,28000,12
TIKI,the-thao-da-ngoai,138810322,"Tất thể thao cầu lông Y.onex kỷ niệm 75 năm",50000,50000,0,0
TIKI,the-thao-da-ngoai,68484619,"Giày Bata Thể Thao Nam Nữ Cao Cấp",250000,250000,0,0
TIKI,the-thao-da-ngoai,193336663,"xả hàng sale Bộ dây trục câu đài săn hàng tàng hình Ngư Long - uy tín - nhanh tay",21000,21000,0,0
TIKI,the-thao-da-ngoai,40253876,"Con Lăn Tập Bụng 4 Bánh + Đệm Lót",95000,95000,0,0
TIKI,thoi-trang-nu,102905096,"Đầm suông đũi lụa tay lỡ cổ tim phối khuy trai ArcticHunter, thời trang thương hiệu chính hãng",199000,199000,0,0
TIKI,the-thao-da-ngoai,148944414,"Găng Tay Tập GYM Da Bò  Hở Mu Bàn Tay Lifting Grips , Dây Kéo Lưng - Hàng chính hãng BORO SPORT",229000,449000,220000,49
TIKI,the-thao-da-ngoai,197637729,"Cần câu cá - Cần câu tay carbon siêu cứng - Tặng kèm nhiều phụ kiện DCH02",219000,219000,0,0
TIKI,thoi-trang-nu,148636931,"Váy ngủ cộc tay dáng suông đầm ngủ chất thun sữa mềm họa tiết dễ thương bầu bí bon chen V285",66000,66000,0,0
TIKI,the-thao-da-ngoai,135463438,"Dây An Toàn Cần Câu Tay Gắn Thùng Câu Cá Ghế Câu Đài HPK6",21000,21000,0,0
TIKI,the-thao-da-ngoai,169930113,"Đầu Kẹp Cá Sấu Nhỏ Đủ Loại",1000,1000,0,0
TIKI,the-thao-da-ngoai,57175986,"Băng quấn cổ định cổ tay khi tập luyện thể thao với chất liệu polyester phong cách thể thao mạnh mẽ Cleacco - Hàng chính hãng (Giao màu ngẫu nhiên)",79000,174000,95000,55
TIKI,the-thao-da-ngoai,60716616,"Thảm Tập Yoga Định Tuyến TPE 2 Lớp – Chọn Màu – Chọn Độ Dày + Bao Thảm Tập Yoga + Dây Buộc Thảm Tập Yoga Chính Hãng miDoctor",149000,149000,0,0
TIKI,the-thao-da-ngoai,59200785,"Dây kháng lực tập gym cao su tự nhiên, mức lực kéo phân theo từng màu, tiện lợi mang theo bất cứ đâu Cleacco",39000,79000,40000,51
TIKI,the-thao-da-ngoai,189589375,"Chăn Giữ Nhiệt Chăn Cứu Hộ Khẩn Cấp Aonijie A107",140000,140000,0,0
TIKI,thoi-trang-nu,173758811,"Váy ngủ lụa ren hông cao cấp Q09 - Váy ngủ 2 dây - Đầm ngủ sexy gợi cảm - Đồ ngủ mạc nhà",169000,240000,71000,30
TIKI,the-thao-da-ngoai,189684215,"Quấn Cổ Tay, Đai Bảo Vệ Cổ Tay - YOGA QG, Chất Liệu Polyester Sợi Cao Cấp, Co Dãn Thoải Mái, Thoáng Mát - Hàng chính hãng",109000,137000,28000,20
TIKI,thoi-trang-nu,167543332,"(HÀNG SẴN) Áo Sơ Mi Nữ Cotton Thêu Tay Họa Tiết SM150 - Hàng Quảng Châu Cao Cấp",245000,245000,0,0
TIKI,the-thao-da-ngoai,43033115,"Bao Đeo Tay Điện Thoại Chống Sốc Chạy Bộ Thể Thao DT03",60000,60000,0,0
TIKI,the-thao-da-ngoai,57839415,"Bộ 2 vợt bóng bàn tặng kèm 3 bóng GoodFit, cốt vợt 7 lớp, mặt mút đàn hồi, chất lượng đạt chuẩn Goodfit GF001TS",199000,250000,51000,20
TIKI,the-thao-da-ngoai,185993815,"Kính bơi trẻ em Coosa 9335 thiết kế Panorama, không gọng, chống sương, chống tia UV",115000,115000,0,0
TIKI,the-thao-da-ngoai,190125184,"Kính bơi người lớn cho nam, nữ chính hãng dododios tầm nhìn rộng 180 độ góc nhìn PANORAMA hạn chế sương mờ, cản tia UV",180000,180000,0,0
TIKI,the-thao-da-ngoai,126947487,"Bảo Vệ Đầu Gối , Băng Gối , Băng Bảo Vệ Gối Có Đệm Đầu Gối Cao Cấp  dùng chơi thể thao du lich dã ngoại yoga",100000,100000,0,0
TIKI,thoi-trang-nu,69031635," ÁO THUN F21 CROPTOP TRƠN ÔM BODY - CỔ TIM",60000,60000,0,0
TIKI,the-thao-da-ngoai,57844141,"Vợt bóng bàn tặng kèm 3 bóng GoodFit cốt vợt 9 lớp đạt chuẩn chất lượng GF002TR",279000,375000,96000,26
TIKI,thoi-trang-nu,131418507,"Áo phao gile nam nữ siêu ấm,trẻ trung và năng động full size (KN4)",199000,199000,0,0
TIKI,the-thao-da-ngoai,195864929,"PUMA - Áo bra thể thao nữ ULTRAFORM Cropped Running 522150",1199000,1199000,0,0
TIKI,the-thao-da-ngoai,139934593,"Chì câu cá tròn xuyên tâm",1200,1200,0,0
TIKI,the-thao-da-ngoai,178958676,"Đai bảo vệ khớp gối cao cấp WOSAWE bảo vệ đầu gối chống ngã khi chơi các môn thể thao mạo hiểm",99000,175000,76000,43
TIKI,the-thao-da-ngoai,195937842,"Thảm Yoga PU Định Tuyến, Chất Liệu Cao Su Thiên Nhiên PU 5mm x 183 x 66cm , Nặng 3kg Mềm Mại., Chống Trơn Trượt, Độ Đàn Hồi Tốt, Thấm Hút Mồ Hôi, Đường Định Tuyến In Rõ Nét",399000,425000,26000,6
TIKI,the-thao-da-ngoai,67112118,"Găng tay hở ngón, bao tay tập gym, tập đu xà nam nữ GoodFit đệm silicone chống trượt, vải đục lỗ thoáng khí GF202G - M",79000,129000,50000,39
TIKI,the-thao-da-ngoai,163843664,"Dây quấn cần câu dài 1m5 Quấn cán vợt cầu lông",33100,33100,0,0
TIKI,the-thao-da-ngoai,168563022,"Túi Ghi Đông Treo Đầu Xe Máy TÚI GPS chuyên dùng SUNHA dùng xem bản đồ xe máy, xe ôm công nghệ Grab,SIGIATO SGT 739",69000,69000,0,0
TIKI,thoi-trang-nu,185684246,"Đồ ngủ sexy nữ/Đồ ngủ 2 dây ren nude không mút, chất phi mịn quyến rũ 400",54000,54000,0,0
TIKI,the-thao-da-ngoai,2282607,"Xăng Zippo (125ml)",90000,90000,0,0
TIKI,thoi-trang-nu,106991359,"Áo dài trắng học sinh 4 tà lụa nhật / áo dài nữ sinh / áo dài truyền thống",220000,220000,0,0
TIKI,the-thao-da-ngoai,55023453,"Dụng cụ hỗ trợ chống đẩy , hít đất tập thể thao tại nhà kèm bàng chỉ dẫn theo màu sắc tập trung các nhóm cơ chính - Kèm dây đàn hồi tập đa năng",299000,404000,105000,26
TIKI,the-thao-da-ngoai,11488622,"Đai bảo vệ đầu gối ZAMST JK-1",1012000,1012000,0,0
TIKI,the-thao-da-ngoai,196144067,"Đồ cắm trại đèn led Naturehike campoutvn du lịch dã ngoại NH16D300-C móc treo 3 chế độ sáng có đèn cảnh báo với hút nam châm A024",340000,340000,0,0
TIKI,the-thao-da-ngoai,147209969,"Combo 2 Gói Mồi Câu Cám Tổng Hợp T3 , 1 Chai Tinh Mùi Câu Cá Tổng Hợp Thái Lan",85000,85000,0,0
TIKI,the-thao-da-ngoai,74598632,"Dây tập Ngực, tập tay ToanAnh Model TA-8345",90000,180000,90000,50
TIKI,thoi-trang-nu,72337537,"Áo khoác nữ",99000,99000,0,0
TIKI,the-thao-da-ngoai,144404143,"Bóng Đơn Giãn Cơ, Massage Trị Liệu",79000,79000,0,0
TIKI,thoi-trang-nu,54585058,"Body liền thân ôm sát gợi cảm cực sexy kiểu dáng mới",89000,89000,0,0
TIKI,the-thao-da-ngoai,138480707,"Quần legging nữ Fitme Zeta nâng mông cao cấp chất liệu dày dặn cạp cao chuyên tập gym và tập yoga",189000,189000,0,0
TIKI,the-thao-da-ngoai,70161865,"Bộ 6 dây kháng lực tập Gym ,dây đàn hồi Miniband đa năng tập Mông Đùi Chân, độ kháng lực cao Mã 02-RED",97000,180000,83000,46
TIKI,thoi-trang-nu,93044590,"Váy suông in hình cá sấu xẻ tà chất cotton cá tính",72000,72000,0,0
TIKI,thoi-trang-nu,58329345,"ÁO SƠ MI NỮ ĐŨI VIỆT, ÁO ĐŨI NỮ KẺ CARO DVSM02",150255,159000,8745,6
TIKI,the-thao-da-ngoai,137940270,"Kìm Bóp Tập Cơ Tay điều chỉnh từ 5 - 60kg Đếm Nhịp KitAcoom, Hàng Nhập Khẩu Chính Hãng Giao Màu Ngẫu Nhiên",159999,159999,0,0
TIKI,thoi-trang-nu,169483875,"Đồ ngủ hóa trang cosplay người nhện spider man anime khóa kéo mở đũng",280000,280000,0,0
TIKI,the-thao-da-ngoai,162992938,"Bao Đựng Cần Dạng Cứng PK-10 Túi Đựng Cần Câu Máy Câu Lure Cao Cấp",241000,241000,0,0
TIKI,the-thao-da-ngoai,58342155,"Băng quấn cố chân, băng bảo vệ cổ chân, mắt cá chân GoodFit co giãn đàn hồi, đệm silicone chống trượt GF612A",119000,150000,31000,21
TIKI,thoi-trang-nu,191124759,"Áo khoác hoodie nữ OUTERITY full zip vải nỉ có mũ nón form rộng ulzzang dễ thương hợp thời trang",105000,105000,0,0
TIKI,the-thao-da-ngoai,51420207,"Kính Bảo Vệ Chơi Thể Thao, Bóng Rổ, Bóng Đá Chống Sương Mù, Mồ Hôi Cao Cấp - Có Thể Lắp Mắt Kính Cận",109000,109000,0,0
TIKI,thoi-trang-nu,151555399,"(Fullsize - Ảnh/Video Thật) Áo Thun Nữ Tay Lỡ - Áo Phông Nam Nữ Form Rộng Unisex - PAPER PLANE - Vải Mềm Mịn Mát Dày Kita Unisex",144000,144000,0,0
TIKI,thoi-trang-nu,89560764,"Áo khoác BOMBER DÙ 2 LỚP 5426 CÓ 3 MÀU, áo khoác dù nam nữ BOMBER nút bấm Thêu 5426, Áo Khoác Dù Bomber Nam Nữ Cao Cấp Thêu 5426 Kiểu Dáng Bóng Chày Phong Cách Hàn Quốc, ÁO KHOÁC NAM NỮ PHONG CÁCH BOMBER NÚT BẤM THỜI TRANG 5426",99000,99000,0,0
TIKI,the-thao-da-ngoai,60048350,"Dây Cáp Câu Cá, Làm Thẻo Kèm Ống Làm Thẻo",45000,45000,0,0
TIKI,thoi-trang-nu,108930438,"Bộ Đồ Pijama Mặc Nhà Ngắn Tay Azuno BN2706 Chất Liệu Cotton Lụa Nhẹ Mát Cho Mùa Hè",275000,290000,15000,5
TIKI,thoi-trang-nu,103026406,"Quần nữ ống rộng lưng thun chất liệu đũi",121905,129000,7095,6
TIKI,the-thao-da-ngoai,54838799,"Bộ Kính Bơi Nam Người Lớn Chuyên Nghiệp. Tráng Gương Chống Tia UV, Chống Mờ Chống Nước. Túi Đựng Tiện Dụng Buffalo Sports",143000,169000,26000,15
TIKI,the-thao-da-ngoai,172538266,"Bao Tay Tập Gym Có Đệm Tay Và Quấn Cổ Tay Chắc Chắn",145000,145000,0,0
TIKI,the-thao-da-ngoai,76403004,"Bộ cần câu cá - Cần carbon cao cấp - Kèm máy Kim loại HE Chính hãng - Tặng kèm nhiều phụ kiện",359000,359000,0,0
TIKI,thoi-trang-nu,155268951,"Quần gen bụng sau sinh cao cấp chấn liệu co dãn 4 chiều thoáng mát",84500,84500,0,0
TIKI,the-thao-da-ngoai,4956127,"Bóng đá Động Lực số 5 in sao UHV 2.03 (Tiêu chuẩn thi đấu)",550000,550000,0,0
TIKI,the-thao-da-ngoai,114255361,"Dụng cụ tập hít đất Harbinger Push Up Pro_Black",1099000,1099000,0,0
TIKI,the-thao-da-ngoai,121635528,"Quả cầu lông giá rẻ",76000,100000,24000,24
TIKI,the-thao-da-ngoai,16876889,"Quấn cán vợt vỉ 03 cái",125000,125000,0,0
TIKI,the-thao-da-ngoai,156022362,"Dù Câu Cá Siêu Bền X4 7 Màu 100m Dây Dù Câu Cá Dây Câu Lure DC2",27600,27600,0,0
TIKI,thoi-trang-nu,197826233,"Quần lót nữ nâng mông thoáng mát Sexy",37000,37000,0,0
TIKI,the-thao-da-ngoai,90321741,"Băng đô Kpop, Bigbang, băng đô thể thao chặn mồ hôi siêu co giãn TB37",11570,11570,0,0
TIKI,the-thao-da-ngoai,132103044,"Thảm tập Yoga và GYM chuyên dụng dày 10mm kèm túi đựng Agnite - NBR nguyên khối, độ đài hồi tốt, chống lún - Chống trơn trượt, độ bám cao, ngăn ngừa hôi và ẩm mốc - Kèm dây buộc - Hàng chính hãng - EL108 / EL110",89000,268200,179200,67
TIKI,the-thao-da-ngoai,56700930,"GIÀY ĐÁ BÓNG SÂN CỎ NHÂN TẠO THỂ THAO NAM PEACE PS1208",300000,300000,0,0
TIKI,thoi-trang-nu,105229786,"Combo 2 Quần Lót Nữ Trơn Không Đường May Lưng Cao Snowdrop (Mustoto MQ19)",196000,196000,0,0
TIKI,the-thao-da-ngoai,59142178,"Bộ nồi cắm trại 2-3 người Naturehike NH15T203-G",525000,525000,0,0
TIKI,thoi-trang-nu,186253458,"Váy Đầm Trung Niên- Đầm Linen Suông In Hoạ Tiết Tay Ngắn Chất Linen Mát Đũi Việt DV167",282555,299000,16445,6
TIKI,the-thao-da-ngoai,55774848,"Bộ bảo hộ trượt patin gồm 4 món, bảo hộ tay, gối,  khuỷu tay và chuyên nghiệp giúp bảo vệ an toàn bé khi chơi, tránh chấn thương Cleacco, chất liệu nhựa ABS cao cấp , Hàng Chính Hãng",469000,660000,191000,29
TIKI,the-thao-da-ngoai,95194738,"Đai đeo chạy bộ GoodFit, túi đeo hông chạy bộ chống nước, đai đeo điện thoại chạy bộ GoodFit GF108RB",129000,199000,70000,35
TIKI,the-thao-da-ngoai,103168453,"Bình lắc sữa Whey Protein Tập Gym * Bình Đựng Nước Thể Thao* My Protein 600ml- hàng nhựa cao cấp",49500,49500,0,0
TIKI,the-thao-da-ngoai,13866304,"Quấn Nẹp Cổ Tay Bảo Vệ Hỗ Trợ Xương Ống Khớp Cổ Tay Khi Tập Gym, Chơi Thể Thao Pressure Adjustable Wrist Support AOLIKES YE-7937 (1 chiếc)",49000,49000,0,0
TIKI,the-thao-da-ngoai,6936677,"Combo đi phượt Chita CT1 - Goinglink cao cấp tiện dụng (Nón bảo hiểm, găng tay, khăn đa năng)",355000,355000,0,0
TIKI,thoi-trang-nu,301787,"Áo Khoác Nỉ Unisex Phúc An - Xám Đậm",160000,160000,0,0
TIKI,bach-hoa-online,155890433,"Hạt Điều Rang Muối Bình Phước Nguyên Hạt Size A Cồ - Hàng Loại 1 ( 01 kg-2 hộp)",270000,300000,30000,10
TIKI,bach-hoa-online,181000516,"Đặc Sản Sóc Trăng - Bánh Pía Sóc Trăng Đậu Xanh Sầu Riêng Trứng Tân Huê Viên 400G, Bánh Pía Tân Huê Viên 2 Sao 1 Trứng",88200,98000,9800,10
TIKI,bach-hoa-online,70339267,"[Thùng 40 gói x 50gram] Cháo Sườn Non Yến Mạch Đậu Xanh - Yến Đại Phát, , thịt thật, yến mạch ngon, đậm đà hương vị",255000,368000,113000,31
TIKI,bach-hoa-online,126520952,"Hạt Dinh Dưỡng Mix, Hiệu Mfood, Gồm 7 Loại Hạt Sấy Khô Óc Chó Đỏ, Óc Chó Vàng, Hạnh Nhân, Nho, Xoài Sấy, Bí Xanh, Điều",78000,110000,32000,29
TIKI,bach-hoa-online,154698974,"Trà atisô túi lọc Thái Bảo, 60 tép, hộp, mẫu pastel art",77000,77000,0,0
TIKI,bach-hoa-online,7371287,"Lá Rong Biển Khô Daesang 200g Dùng Nấu Canh Rong Biển - Nhập Khẩu Hàn Quốc",139000,139000,0,0
TIKI,bach-hoa-online,141808767,"Tỏi Bột Tự Nhiên Vipep Hũ Nhựa 70g",16000,16000,0,0
TIKI,bach-hoa-online,57806741,"Combo 5 gói Natural Bột Gia Vị Ngũ Vị Hương 10gr Dh Foods",25600,25600,0,0
TIKI,bach-hoa-online,34914469,"ĐẬU PHỘNG CỐT DỪA TÂN LỘC PHÁT COMBO 1KG - MỖI HŨ 500G",75000,159000,84000,53
TIKI,bach-hoa-online,99465602,"MỰC CÁN TẨM VỊ TÂN LỘC PHÁT -HŨ 200G",59000,100100,41100,41
TIKI,bach-hoa-online,19513215,"Combo 2 Gói Bột Phô Mai Tornado Vị Truyền Thống (100g / Gói)",58900,62000,3100,5
TIKI,bach-hoa-online,25166056,"Nam việt quất sấy DK HARVEST nhập khẩu Canada 200g",99000,99000,0,0
TIKI,bach-hoa-online,184476212,"Bánh cuộn trái cây GUfoods - Chua ngọt tự nhiên, Giàu vitamin C, Ăn vặt healthy, Tốt cho sức khoẻ",111000,239000,128000,54
TIKI,bach-hoa-online,92710885,"Bộ 12 túi thức ăn mèo con Whiskas vị cá ngừ 80g",150000,150000,0,0
TIKI,bach-hoa-online,106786861,"Anphalipid Sữa Non Halan Milk 400gr - Tăng sức đề kháng, chống loãng xương, giảm mệt mỏi",230000,230000,0,0
TIKI,bach-hoa-online,177479564,"Snack gạo lứt kẹp thơm GUfoods - Chua ngọt thơm ngon, Giàu chất xơ, Ăn vặt Healthy, Eat clean, Thuần chay",111000,239000,128000,54
TIKI,bach-hoa-online,57828825,"Hạt Hạnh Nhân Sống DK Harvest Dùng làm Sữa Hạt",319000,375000,56000,15
TIKI,bach-hoa-online,107018234,"Kẹo sữa mềm Sumika 140 gram Bibica",13200,13200,0,0
TIKI,bach-hoa-online,73373546,"Pate Gan Đặc Biệt Hạ Long - 100g",21600,24000,2400,10
TIKI,bach-hoa-online,125290361,"Quả OLIU XANH, ĐEN TÁCH HẠT NGÂM HIỆU LATINO BELLA 3KG/ HỘP",308000,350000,42000,12
TIKI,bach-hoa-online,92096095,"500G KHÔ HEO CHÁY TỎI LOẠI 1 TÂN LỘC PHÁT",67000,139000,72000,52
TIKI,bach-hoa-online,152812697,"Da Heo Lắc Sốt Siêu Phẩm ABI SNACK",35000,35000,0,0
TIKI,bach-hoa-online,166497256,"Đặc Sản Kon Tum - Trái Khổ Qua Rừng Sấy Khô Thơm Ngon Hiệu Đặc Sản Và Dược Liệu Kon Tum (1Kg) - OCOP 3 Sao",320000,320000,0,0
TIKI,bach-hoa-online,45211030,"500gr Trà long nhãn - Nhãn nhục sông mã",149000,149000,0,0
TIKI,bach-hoa-online,104587894,"BÁNH ĐIỀU MIX HẠT DINH DƯỠNG TÂN LỘC PHÁT COMBO 1KG - MỖI BỊCH 500G",99000,220000,121000,55
TIKI,the-thao-da-ngoai,91149157,"Vợt cầu lông carbon 4U Quangyu công thủ toàn diện cao cấp 80g",400000,400000,0,0
TIKI,bach-hoa-online,116273351,"Bún gạo lứt Cao Tuyền 500g, đặc sản Cao Bằng, thơm ngon, bổ dưỡng, tốt cho sức khỏe, làm từ 100% bột gạo lứt Huyết Rồng",30000,50000,20000,40
TIKI,bach-hoa-online,57806966,"Combo 5 gói Natural Gia Vị Nấu Cà Ri 10gr Dh Foods",25600,25600,0,0
TIKI,the-thao-da-ngoai,35717946,"Găng tay nửa ngón tập gym, tập tạ Aolikes AL113B (1 đôi)",145000,145000,0,0
TIKI,bach-hoa-online,35354610,"(COMBO 1KG) 2 HỘP HẠT ĐIỀU RANG MUỐI XẾP HOA ĐẸP HÀNG CHẤT LƯỢNG LOẠI 1",180500,190000,9500,5
TIKI,bach-hoa-online,55525135,"Mắm Cá Linh Sông Hương Foods Hũ 400g",81000,81000,0,0
TIKI,bach-hoa-online,2466655,"Muối tôm Tây Ninh 110g Dh Foods",21060,21060,0,0
TIKI,the-thao-da-ngoai,144446121,"Iso HD 2,3kg 100% Isolate tinh khiết - Sữa bổ sung Protein, hỗ trợ phục hồi, tăng Cơ cho người tập thể thao",1549500,1549500,0,0
TIKI,bach-hoa-online,2472415,"Muối tôm Tây Ninh 60g Dh Foods",10500,10500,0,0
TIKI,the-thao-da-ngoai,163717105,"Bó gối thể thao Băng bảo vệ đầu gối có đệm chống chấn thương chơi Đá Bóng Bóng rổ Tennis Bóng chuyền Gym Chạy bộ - Redikick",129000,169000,40000,24
TIKI,the-thao-da-ngoai,119962865,"Đèn Pin Siêu Sáng Với 3 Màu Ánh Sáng Khác Nhau XPE Q5(đèn pin đội đầu)",218500,230000,11500,5
TIKI,the-thao-da-ngoai,117374610,"Bộ thể thao nữ mùa hè áo croptop nữ tay ngắn và quần dài vải thun dẻo",129000,129000,0,0
TIKI,bach-hoa-online,153406924,"Đá Me Hạt Mềm Thanh Bình - Hộp 900g, tăng đề kháng, mát lạnh ngày hè, bổ sung Vitamin mùa dịch",63000,63000,0,0
TIKI,the-thao-da-ngoai,181776455,"Bộ Xà Đơn Xà Kép Treo Tường Di Động Đa Năng 8 IN 1",1390000,1390000,0,0
TIKI,bach-hoa-online,20576303,"Sữa Đặc Có Đường Premium Alphana nhập khẩu Malaysia Lon 1kg thành phần đạm tỷ lệ cao đến 2.3% không Cholesterol",52000,69000,17000,25
TIKI,bach-hoa-online,57768021,"Trà cây xạ đen hòa bình - Gói 1kg",95000,95000,0,0
TIKI,bach-hoa-online,57303356,"Cà phê hạt 100% nguyên chất truyền thống số 3 Coffee Tree 1kg thơm ngon, đậm đà, gu mạnh",202000,372000,170000,46
TIKI,the-thao-da-ngoai,12505834,"Bộ quần áo mưa Givi RRS06",760000,760000,0,0
TIKI,bach-hoa-online,153368584,"Da Cá Hoàng Kim - Da Cá Trứng Muối ABI SNACK",35000,35000,0,0
TIKI,the-thao-da-ngoai,68541859,"Bộ đồ tập Gym nữ - Set quần đùi và áo Bra thể thao",168000,168000,0,0
TIKI,the-thao-da-ngoai,134336080,"Bộ cần câu cá lure máy đứng 1.68m - 1.8m - 2.1m - 2.4m + Máy kim loại + dây câu lure + hộp mồi lure B-lu-D01",400000,400000,0,0
TIKI,bach-hoa-online,127219275,"Đặc Sản Phan Thiết - Nước Mắm Chua Ngọt Cao Cấp Làng Chài Xưa, Nguyên Liệu Tươi, Thơm Ngon Đặc Biệt, Pha Sẵn Từ Chanh Tỏi Ớt Vị Đậm Đà Chai Thủy Tinh 300G",65000,90000,25000,28
TIKI,the-thao-da-ngoai,131395889,"Cần Câu Máy Huntman, Cần Câu Cá, Cần Câu Lancer Cao Cấp",129990,129990,0,0
TIKI,the-thao-da-ngoai,25068523,"Tất Vớ Bóng Đá Bảo Vệ Ống Đồng Kiểu Legging Thoáng Khí Football Leg Guard Plate Socks YE-7968",116000,239000,123000,51
TIKI,bach-hoa-online,270811530,"Vitamin tổng hợp cho bà bầu Prenatal Folic Acid+ DHA Nature Made giúp mẹ khỏe, thai nhi phát triển tốt (Mỹ) - OZ Slim Store",794000,1664000,870000,52
TIKI,the-thao-da-ngoai,88269489,"Bộ Dụng Cụ Giúp Luyện Tập Cơ Cổ Tay, Cơ Bắp Tay To Khoẻ Wrist Arm Trainer Cao Cấp",295000,295000,0,0
TIKI,the-thao-da-ngoai,14800841,"Lều cắm trại tự bung cao cấp dành cho 2 - 3 người",191989,191989,0,0
TIKI,the-thao-da-ngoai,169343144,"Tạ tay nữ 1kg-6kg lõi gang đặc bọc cao su tập gym,yoga chống trơn trượt, xước vỡ sàn Nhà",55000,60000,5000,8
TIKI,the-thao-da-ngoai,149604354,"Dây trục câu đài buộc sẵn đầy đủ các kích thước, cước câu, DC-3",8900,8900,0,0
TIKI,the-thao-da-ngoai,208404505,"Combo bao cát trụ đấm bốc boxing tự đứng UFC + găng tay đấm bốc boxing + băng đa cuốn tay + bóng phản xạ + lót tay chân - Thiết bị đấm bốc boxing dành cho dân chuyên, phòng tập, võ đường",1999000,1999000,0,0
TIKI,the-thao-da-ngoai,152705777,"Bộ Dây Cáp Ròng Rọc Tập Gym Tại Nhà Tiện Lợi",495000,495000,0,0
TIKI,the-thao-da-ngoai,5816817,"Túi ngủ dã ngoại, văn phòng, ngủ trưa",200000,200000,0,0
TIKI,the-thao-da-ngoai,149586182,"máy câu ngang proberos, máy câu lure có tay phải và tay trái",212433,212433,0,0
TIKI,the-thao-da-ngoai,121156985,"Vòng lắc eo thông minh với đầu massage từ tính có màn hình led đếm số lần, số vòng quay, lượng calo tiêu thụ, điều chỉnh kích cỡ theo cân nặng",765000,765000,0,0
TIKI,the-thao-da-ngoai,154978371,"Chống cần Câu Đài Đại Lý Đồ Câu Cá Chống Cần Câu Đơn Cao Cấp Ultra Light Đồ Câu Cá",38899,38899,0,0
TIKI,the-thao-da-ngoai,59292929,"Bình nước thể thao thân tháo rời tiện lợi chất liệu nhựa Cleacco",169000,255000,86000,34
TIKI,the-thao-da-ngoai,135462422,"Rọng Đựng Cá Khung Kim Loại Siêu Bền Rọng Cá Câu Đài KK2",85000,85000,0,0
TIKI,the-thao-da-ngoai,4281325,"Giàn tạ đa năng DV-2014 - Tặng kèm bao tay",2489000,2790000,301000,11
TIKI,the-thao-da-ngoai,139925901,"Cần câu cá Gw Yf 6H đủ sz - Sz cần hoặc lóng,Lóng thứ 2 của cần",57300,57300,0,0
TIKI,the-thao-da-ngoai,55029295,"Xe Đạp Tập Thể Dục Đa Năng Tại Nhà Air Bike MK207 + Kèm Máy Massage Xung Điện",1629000,1629000,0,0
TIKI,bach-hoa-online,21127605,"Cát tắm hamster",13333,13333,0,0
TIKI,the-thao-da-ngoai,139916809,"Vợt Cá Carbon Vành Tròn Có thể thu gọn chuyên dụng câu đài vợt cá câu đài",139000,139000,0,0
TIKI,the-thao-da-ngoai,138827740,"HỘP 50 MIẾNG DÁN CHÂN NGẢI CỨU THẢI ĐỘC BẮC KINH",31925,31925,0,0
TIKI,the-thao-da-ngoai,161458870,"Bộ 2 tạ tay nhựa bát giác 1kg REEFIT (2 tạ 1kg, tổng 2kg)",16000,16000,0,0
TIKI,bach-hoa-online,2180183,"Sữa Hạt Hạnh Nhân Nguyên Chất 137 Degrees (Hộp 1000ML)",119000,119000,0,0
TIKI,the-thao-da-ngoai,189591425,"Kính bơi unisex Speedo HYDROPURE MIRROR - 8-126683487",645000,645000,0,0
TIKI,the-thao-da-ngoai,15219166,"Phao Tay Bơi Cho Bé Cực Chất MAY_PH001",30000,30000,0,0
TIKI,the-thao-da-ngoai,74177441,"Băng bảo vệ đầu gối Reebok Knee Support - RRSU-1332ㅌ",445000,445000,0,0
TIKI,the-thao-da-ngoai,195701219,"Áo croptop tập Yoga Gym Hibi Sports có tay CR816 kiểu xoắn nơ, Kèm mút ngực",252000,360000,108000,30
TIKI,the-thao-da-ngoai,132781394,"Đồ tập gym nữ, bộ tập gym yoga aerobic nữ chất vải co giãn thấm hút mồ hôi tốt( bộ sát nách)",195000,195000,0,0
TIKI,the-thao-da-ngoai,15098291,"Combo khuyến mãi 2 gạch tập và 1 dây yoga cotton",129000,129000,0,0
TIKI,the-thao-da-ngoai,183535386,"[Loại Cao Cấp] dây nhảy thể lực, dây nhảy đếm số tự động tính calo, dây nhảy boxing, dây nhảy không dây - Hãng DODODIOS",20500,20500,0,0
TIKI,the-thao-da-ngoai,193330051," Giày Bóng Đá Nam Biti's Hunter Football DSMH09600CAM (CAM)",537000,716000,179000,25
TIKI,the-thao-da-ngoai,135462135,"Hộp Đựng Lưỡi Câu Đài Lưỡi Câu Đôi, Thẻo câu cá chuyên dành cho câu đài HPK8",99000,99000,0,0
TIKI,the-thao-da-ngoai,119911424,"Dây nhảy thể dục cho bé Agnite - Dây lõi bông, cán gỗ an toàn cho bé - Xanh da trời/ Hồng- Hàng chính hãng - 18702",225000,225000,0,0
TIKI,thoi-trang-nu,125172289,"Áo Khoác Nỉ Bông Chống Nắng Thêu STR Hàn Quốc Nam NữFRESHIP RẺ ĐẸP, Áo Hoodie Kiểu Thun Tay Dài Unisex Couple Jackets",108000,108000,0,0
TIKI,thoi-trang-nu,205533095,"Áo len dệt kim sọc cổ điển phong cách Hàn Hadu shop",189000,189000,0,0
TIKI,thoi-trang-nu,77200023,"Áo Croptop Nữ Ôm Dáng Cổ Chữ V Tay Ngắn Phù Hợp Mặc Đi Chơi, Tập Gym, Yoga - MSP T01",94000,94000,0,0
TIKI,thoi-trang-nu,195124820,"Áo Cúp Ngực, Áo ngực, Áo Quây Chống Tụt Không Dây Nâng Đẩy Ngực Quyến rũ LYEA038",101250,135000,33750,25
TIKI,thoi-trang-nu,191693489,"Áo Ngực Nữ Đúc Su - Áo Lót Không Gọng Trơn Mút Bàn Tay Thông Hơi 820",58888,58888,0,0
TIKI,thoi-trang-nu,116384364,"Áo vest blazer nữ cộc tay chất mát dáng rộng 2 khuy cá tính",119000,119000,0,0
TIKI,thoi-trang-nu,16261633,"Quần độn mông, gen bụng Thái Lan cao cấp - 5Star",82000,82000,0,0
TIKI,thoi-trang-nu,155790530,"Áo len nữ cổ tim dài tay dáng thụng bo gấu chất len mềm mịn co giãn thời trang Hàn Quốc mặc mùa thu đông mã VAA0228",128000,128000,0,0
TIKI,thoi-trang-nu,50677722,"Combo 5 QUẦN LÓT Đùi NỮ MẶC VÁY MÃ 2019",181390,181390,0,0
TIKI,thoi-trang-nu,48173327,"Đầm quý Bà Sang Trọng - Hàng nhập - DQB8401",328000,328000,0,0
TIKI,thoi-trang-nu,97819193,"Váy ngủ 2 dây xuyên thấu - Set đầm ngủ sexy thêu hoa gợi cảm",124000,124000,0,0
TIKI,thoi-trang-nu,185439942,"Đầm suông linen tay lỡ cổ đức nẹp pha ArcticHunter, thời trang thương hiệu chính hãng",269000,269000,0,0
TIKI,thoi-trang-nu,93181829,"[HCM] (65-85kg) Đồ bộ satin bigsize nữ. Đồ bộ lụa hàn bigsize nữ. Đồ bộ bigsize satin. Đồ bộ bigsize lụa hàn. Đồ bộ nữ từ 70kg trở lên. Đồ bộ pijama TNQD. Đồ bộ pyjama TNQD. Đồ bộ pizama TNQD. Đồ bộ mặc ngủ nữ. Đồ bộ mặc nhà nữ. Đồ bộ TNQD",158000,158000,0,0
TIKI,thoi-trang-nu,176103658,"Quần legging nữ Blue Chic nâng mông lưng cạp cao vải thun dày dặn đùi ngố lửng ôm body bó mặc nhà tập gym yoga",155000,155000,0,0
TIKI,thoi-trang-nu,101749109,"Đồ bộ nữ cộc tay - Đồ bộ mặc nhà - Đồ ngủ mặc nhà nữ - Đồ bộ nữ lửng - Set bộ đũi mặc nhà nữ Vicci BDT.01 phối hoạ tiết tim",145000,269000,124000,46
TIKI,thoi-trang-nu,176082103,"Đồ bơi liền thân quần váy nữ, có mẫu dài tay, khóa kéo trước phong cách thể thao, áo sẵn đệm ngực, chất thun bơi dầy mát lạnh | KT072",410000,410000,0,0
TIKI,thoi-trang-nu,75353174,"Gen định hình bắp tay vai gen giảm mỡ bắp tay",336000,336000,0,0
TIKI,thoi-trang-nu,196768144,"OLV - Đầm Jeny Cream Dress",690000,690000,0,0
TIKI,thoi-trang-nu,153789610,"Quần Mặc Trong Váy, Quần Bảo Hộ Co Dãn Tốt Chống Lộ An Toàn Siêu Co Dãn Siêu Hot",24500,24500,0,0
TIKI,thoi-trang-nu,186749768,"Đồ Bơi Nữ Hai Mảnh Tay Dài Chống Nắng Biển Xanh Áo Dài Tay Quần Lưng Cao Tươi Trẻ ATI87 MayHomes, Sun Protection UPF50+, Long-Sleeve Swimwear",251750,265000,13250,5
TIKI,thoi-trang-nu,55650411,"Đầm Nữ Đầm Dự Tiệc Đầm Công Sở  Đầm Xòe Tay",195000,195000,0,0
TIKI,thoi-trang-nu,32155828,"Áo Khoác Jean Nữ Chống Nắng Cao Cấp",480000,480000,0,0
TIKI,thoi-trang-nu,118014158,"Đồ Lam Đi Chùa # Nhật Nơ Thêu Hoa Cúc # Đồ Bộ Nữ # Quần Áo Nữ",198000,198000,0,0
TIKI,thoi-trang-nu,43833365,"Bộ ngủ toàn thân hở vai cosplay sexy BD07, Freesize",75000,75000,0,0
TIKI,thoi-trang-nu,182713163,"Đầm suông sơ mi tay hến chất đũi mềm mát trẻ trung ArcticHunter, thời trang thương hiệu chính hãng",220000,220000,0,0
TIKI,thoi-trang-nu,176939627,"Áo ngực quây  nâng ngực tạo khe Lylylorem AL065",500000,500000,0,0
TIKI,thoi-trang-nu,84820860,"Quần Độn Hông Ren Miếng Độn Rời Siêu Thoáng, Quần Mặc Trong Váy Lưới D373",144000,144000,0,0
TIKI,thoi-trang-nu,89153334,"Đầm xòe voan họa tiết hoa nhí cổ sen cách điệu (có lót trong) - nhiều size, form dang chuẩn thích hợp mặc dạo phố, đi làm hoặc dự tiệc",230000,230000,0,0
TIKI,thoi-trang-nu,2085839,"Áo Ngực Triumph Maxi 819 (HQ-VN) - Da (Size",399000,399000,0,0
TIKI,thoi-trang-nu,6179169," Đầm ngủ nữ form rộng thoải mái chất vải phi lụa lưng dây sang trọng",145000,145000,0,0
TIKI,thoi-trang-nu,192337533,"YU CHERRY | Áo nữ Wrap Line Blazer YA390",325000,325000,0,0
TIKI,thoi-trang-nu,196916610,"Áo khoác hoodie zip WINNER form rộng vải nỉ lót bông nam nữ chống nắng, Áo khoác nỉ Kill ( ảnh chụp tại shop), Áo khoác-Áo khoác hoodie zip nữ criminal chất nỉ bông 2 lớp dày dặn,áo khoác nữ zip",100000,100000,0,0
TIKI,thoi-trang-nu,155793861,"Váy nữ, đầm nữ dáng váy xuông ngắn tay cổ V sẻ tà chất vải Modal tự nhiên phong cách Hàn Quốc mã VAV0112",169000,169000,0,0
TIKI,thoi-trang-nu,95867719,"(MẶC NHƯ KHÔNG MẶC) Quần lót Nữ_Quần lót ren thun lạnh co giãn 4 chiều, không hằn vết SIÊU GỢI CẢM",99500,99500,0,0
TIKI,thoi-trang-nu,168577620,"Áo Khoác Nỉ Khóa Zip Gấu Brown Phong Cách Hàn Quốc Unisex Nam Nữ Đều Mặc Được Form Rộng Knn32",110000,110000,0,0
TIKI,thoi-trang-nu,183078980,"(Local Brand Hot) Áo Thêu Varsity Jacket - Áo Khoác Bomber Thêu Cardigan 3 Màu BOIN LUCKY chữ A thêu cả áo Siêu đẹp Ocea",128000,128000,0,0
TIKI,thoi-trang-nu,160993917,"Váy Công Sở Kẻ Dài Tay Dáng Suông Haint Boutique, Đầm Nữ Lệch Tà Kèm Dây Thắt Eo Cổ Sơ Mi D92",199000,299000,100000,33
TIKI,thoi-trang-nu,175848355,"Vải May Áo Dài Hoạ Tiết Lá",220000,220000,0,0
TIKI,thoi-trang-nu,52275183,"Áo Sơ Mi Nữ Dài Tay Kẻ Sọc Thời Trang",157000,157000,0,0
TIKI,thoi-trang-nu,2085851,"Áo Ngực Triumph Maxi 819 (7C-VN) - Xám Đen (Size",780000,780000,0,0
TIKI,thoi-trang-nam,162248191,"OWEN - Áo sơ mi dài tay OWEN SLIMFIT cổ tàu chất cafe 22731",598000,598000,0,0
TIKI,thoi-trang-nam,104728743,"Quần baggy kaki nam, Quần chinos kaki nam ống suông lưng thun",85000,85000,0,0
TIKI,thoi-trang-nam,14535290,"Quần Jean Rách Gối RACHGOI97 (Rách Gối)",134000,134000,0,0
TIKI,thoi-trang-nam,89466346,"Quần Kaki Baggy Nam Nữ Ống Suông mã Q002",95000,95000,0,0
TIKI,thoi-trang-nam,117170151,"Áo Khoác Bomber Nỉ Dày Dặn 199x Unisex (ẢNH THẬT)",95000,95000,0,0
TIKI,thoi-trang-nam,85790914,"Áo thun nam nữ mèo đeo dây có bigsize",35000,35000,0,0
TIKI,thoi-trang-nam,158758037,"Áo nam thun lạnh trơn cao cấp",81000,81000,0,0
TIKI,thoi-trang-nam,252794076,"Quần short nam chất nhung tăm form big size 80 đến 130kg",265000,265000,0,0
TIKI,thoi-trang-nam,4401897,"Quần Dài Jogger Nam form rộng 1060",95000,95000,0,0
TIKI,thoi-trang-nam,98624659,"Quần Jean Nam Phối Rách ️️ Quần Bò Nam Thời Trang Cao Cấp Chuẩn Hàng Shop Tô Tồ Shop - QJNTT-mã 31",182000,182000,0,0
TIKI,thoi-trang-nam,90722180,"Quần short đũi nam dáng ngắn mặc hè Đũi Việt DV06",149000,149000,0,0
TIKI,thoi-trang-nam,181419404,"Áo sơ mi đũi nam cổ tầu dài tay form rộng LAHSTORE phong cách Hàn Quốc",199000,199000,0,0
TIKI,thoi-trang-nam,53706216,"Áo thun hoa văn cổ trang Trung Quốc phong cách Unisex nam nữ",45000,45000,0,0
TIKI,thoi-trang-nam,95053555,"Áo Khoác Big Size Bomber Nam Nữ Áo Khoác Kaki Nam Nữ Chống Nắng Chống Lạnh Chống Gió Chống Nóng Tia UV 2 lớp Thời Trang FS Hàn Quốc Nam Tính Giá Tốt Cao Cấp QK46 - ShopN6",189000,240000,51000,21
TIKI,thoi-trang-nam,3603023,"Combo 5 Quần Lót Nam Freeman chất liệu thun lạnh 6042",309000,375000,66000,18
TIKI,thoi-trang-nam,176292749,"Bộ quần áo Mặc Nhà Thể Thao Nam Mùa Hè Phong Cách Cao Cấp IN CÚ MÈO, Bộ Đồ Ngủ Áo Tay Ngắn Phối Quần short Vải cotton In Hoạt Hình Thời Trang Mùa Hè",102000,102000,0,0
TIKI,thoi-trang-nam,74823287,"Quần short kaki nam Amazing, lưng thun có giây rút, vải co giãn, màu sắc đa dạng, có big size",119000,189000,70000,37
TIKI,thoi-trang-nam,48579478,"Áo Hoodie Nỉ Cotton Đen Trơn Đủ Size S M L XL Cao Cấp",99000,99000,0,0
TIKI,thoi-trang-nam,151802223,"QUẦN LÓT NAM - Dạng Dây Nâng Mông - JOCKSTRAP",49000,49000,0,0
TIKI,thoi-trang-nam,83161336,"Áo Thun Nam Cổ Bẻ Viền Tay Thời Trang Poniva",157000,157000,0,0
TIKI,thoi-trang-nam,196470324,"Viettien - Áo sơ mi nam dài tay ca rô cao cấp 1Q0584 fom regular chất liệu 100% cotton - Áo sơ mi công sở Việt Tiến",880000,880000,0,0
TIKI,thoi-trang-nam,52198702,"Combo 4 Quần Lót Nam Quần Sịp Nam Sợi Cotton Cao Cấp MRM FASHION Mix 3 Màu TẶNG Đôi Tất Nam Cao Cấp",249000,340000,91000,27
TIKI,thoi-trang-nam,197529327,"Áo hoodie nam nữ PEPPER samseyo, Áo hoodie form rộng phong cách Unisex, Áo khoác hoodie nam nữ Pepper Tutudesign, Áo sweater nỉ form rộng chất cực đẹp",100000,100000,0,0
TIKI,thoi-trang-nam,186321088,"Áo sơ mi nam dài tay caro NSMMCTMTCR210232D",303000,319000,16000,5
TIKI,thoi-trang-nam,201116083,"Quần Jogger Ống Rộng NHUNG TĂM Nam Nữ Thể Thao Bo Gấu Vải Dày Dặn JO06 RPOMAN",89000,89000,0,0
TIKI,thoi-trang-nam,35364542,"Hôp 5 quần lót nam boxer thun lạnh Nhật Bản cao cấp",74098,74098,0,0
TIKI,thoi-trang-nam,18797371,"Áo Sơ Mi Nam Tay Dài Công Sở Vải Tốt Bền Đẹp",73000,73000,0,0
TIKI,thoi-trang-nam,114194298,"Quần dài thể thao nam Jogger 3 sọc ống xuông trẻ trung năng động Micado",150000,150000,0,0
TIKI,thoi-trang-nam,134794425,"Quần lót nam đùi chất liệu mỏng nhẹ, co giãn thoải mái chính hãng Santino",105000,105000,0,0
TIKI,thoi-trang-nam,179162754,"(Big size <130kg) Áo sơ mi nam cổ trụ tay ngắn big size",225000,225000,0,0
TIKI,thoi-trang-nam,177351663,"Áo Sơ Mi Nam Dài Tay Cổ Tàu GRAYHOMME linen kẻ sọc cá tính chất vải đũi thoáng mát",145000,145000,0,0
TIKI,thoi-trang-nam,181992090,"Viettien - Quần tây nam màu đen form regular fit không ly giá 650",650000,650000,0,0
TIKI,thoi-trang-nam,54762474,"Quần kaki nam 1 ply Khatoco Q2M528R1-INMA004-2106-1",422400,528000,105600,20
TIKI,thoi-trang-nam,195961172,"Quần lót nam Freeman chất liệu cotton TC kiểu dáng trẻ trung BO303",49000,49000,0,0
TIKI,thoi-trang-nam,179162138,"Áo sơ mi nam tay ngắn màu trắng trơn big size nam",185000,185000,0,0
TIKI,thoi-trang-nam,66611227,"Áo sơ mi nam cổ trụ chui đầu dài tay form rộng ArcticHunter, chất đũi thoáng mát, thời trang thương hiệu chính hãng",199000,199000,0,0
TIKI,thoi-trang-nam,67262849,"ÁO THUN NAM DÀI TAY ĐẸP",84000,84000,0,0
TIKI,thoi-trang-nam,185943431,"Bộ Quần Áo Thun Nam Nữ Unisex Mùa Hè Ngắn Tay Cổ Tròn Phối Quần Đùi Họa Tiết Thời Trang, Set đồ bộ nam chất thun cotton co giản thoáng mát, thời trang đồ bộ thể thao nam, Set Bộ Quần Áo Thể Thao Nam Mùa hè Co Dãn",99000,99000,0,0
TIKI,thoi-trang-nam,57829428,"Áo Khoác Kaki Nam Hai Lớp Cổ Trụ Giả Vest Cao Cấp KK43 - ShopN6 (Nhiều Màu)",179000,245000,66000,27
TIKI,thoi-trang-nam,179163330,"ÁO SƠ MI ĐEN TRƠN TAY NGẮN BIG SIZE NAM TỚI 130KG",185000,185000,0,0
TIKI,thoi-trang-nam,183691492,"Quần Âu Nam Hàn Quốc Màu Đen Mẫu Mới 2022",115000,115000,0,0
TIKI,thoi-trang-nam,99482156,"Quần jean nam rách vảy sơn cao cấp vải co dãn hàng quảng châu PHUONGNAMSHOP cao cấp kv51x",199000,199000,0,0
TIKI,thoi-trang-nam,19242497,"Bộ 5 Chiếc Quần Đùi Nam Mắc Nhà Phối Sọc",96000,96000,0,0
TIKI,thoi-trang-nam,146935717,"[HÀNG XỊN ] Quần âu nam, quần tây nam chất vải chéo cao cấp co giãn , đường may chuẩn, kiểu dáng sang trọng ,lịch lãm",59000,59000,0,0
TIKI,thoi-trang-nam,76091452,"Áo thun One Piece Luffy Mũ Rơm T13 mẫu mới cực đẹp, có size bé cho trẻ em / áo thun Anime Manga Unisex Nam Nữ, áo phông thiết kế cổ tròn basic cộc tay thoáng mát",45000,45000,0,0
TIKI,thoi-trang-nam,52150342,"Bộ vest nam màu đen form ôm body chất liệu vải mềm mịn tặng combo phụ kiện",650000,1300000,650000,50
TIKI,thoi-trang-nam,74531596,"Quần khaki nam 1 ply ống đứng màu da bò Khatoco Q2M468R1-VNMA016-1908-1",169000,468000,299000,64
TIKI,thoi-trang-nam,73667467,"Áo sơ mi cổ bẻ dài tay hàn quốc, sơ mi nam trắng dáng ôm body chất lụa thái thấm hút mồ hôi, co giãn nhẹ, size áo từ 45-80 kg",68000,68000,0,0
TIKI,thoi-trang-nam,91009116,"Quần Kaki Ống Suông Unisex Nam Nữ  Kiểu quần Baggy nam nữ mềm co dãn",76000,76000,0,0
TIKI,thoi-trang-nam,174029817,"ÁO SƠ MI KAKI NAM NỮ",259000,259000,0,0
TIKI,thoi-trang-nam,20518214,"Quần Short Nam Khatoco Q3M318R0-VNMA034-2009-020",129000,318000,189000,59
TIKI,thoi-trang-nam,164157919,"Áo Thể Thao Nam TSIMPLE cổ tròn tay ngắn tập gym vải thun lạnh thoáng mát co giãn chuẩn form MSSAHP009",95000,165000,70000,42
TIKI,thoi-trang-nam,110309352,"ÁO LÓT TAY NGẮN COTTON CATRIO LÀ ÁO THUN, ÁO PHÔNG, ÁO NGẮN TAY CỦA NAM TỪ 50KG ĐẾN 83KG thuộc đồ mặc đi ngủ, mặc ở nhà, mặc lót bên trong áo sơ mi, vải 100% cotton an toàn",65000,65000,0,0
TIKI,thoi-trang-nam,14064627,"Combo 2 Áo phông ba lỗ thoát nhiệt Nhật Bản , áo lót nam hàng hiệu cao cấp xuất khẩu",258000,258000,0,0
TIKI,thoi-trang-nam,133864555,"Quần Lót Nam Boxer Cotton 4 Chiều Lưng Thái Cao Cấp, Quần Sịp Đùi Nam, Co Giãn Và Thấm Hút Tốt CITYMEN - ( Màu Ngẫu Nhiên )",56000,56000,0,0
TIKI,thoi-trang-nam,67905472,"Quần Tây nam Đen, Quần âu nam dáng côn hàn quốc, vải không xù, nhăn, loại đẹp",39000,39000,0,0
TIKI,thoi-trang-nam,73214429,"Áo Khoác Nam Áo Khoác Dù Nam Nữ Hai Lớp Chống Nước Chống Nắng Chống Gió Phối Nón Cao Cấp QD54 - ShopN6 (Nhiều Màu)",159000,189000,30000,16
TIKI,thoi-trang-nam,196551211,"Áo polo nam YODY phông tay ngắn basic, cổ bẻ mắt chim co giãn 4 chiều thoải mái APM5431",349000,349000,0,0
TIKI,thoi-trang-nam,73335809,"Áo Khoác Nam Big Size Áo Khoác Dù Nam Cổ Cao Chống Lạnh Chống Gió Chống Nắng Tia UV Cao Cấp Nam Tính Hàn Quốc QM19 - ShopN6 (Nhiều Màu)",169000,255000,86000,34
TIKI,thoi-trang-nam,140523294,"Quần Tây Âu Nam - dáng hàn quốc Slim Fit không đường ly vải co giãn form ôm",99000,99000,0,0
TIKI,thoi-trang-nam,114144333,"Quần đùi MAY 10 loại mở moi, có cúc cài thuận tiện (giao màu ngẫu nhiên)",45000,45000,0,0
TIKI,thoi-trang-nam,82518270," Quần jean nam đen trơn chất bò mỏng nhẹ ống côn cao cấp, phù hợp mùa hè, alex cool",129000,129000,0,0
TIKI,thoi-trang-nam,75142258,"Quần jean nam cao cấp vải xịn",110000,110000,0,0
TIKI,thoi-trang-nam,115124831,"áo ba lỗ nam áo lót nam chất cotton mỏng siêu mát hàng Hà Nội Việt Nam",15000,15000,0,0
TIKI,thoi-trang-nam,7170169,"Bộ 5 Quần Sịp Tam Giác Nam Nhật Bản (Nhiều mầu) - 5Star",100000,100000,0,0
TIKI,thoi-trang-nam,178107571,"Quần tây học sinh việt tiến cấp 2 - 3",162000,162000,0,0
TIKI,thoi-trang-nam,81513561,"Quần Kaki Nam Chất Cao Cấp Siêu nhẹ Dáng Âu ZERO Phong Cách Công Sở",200000,338000,138000,41
TIKI,thoi-trang-nam,67516317,"Áo Khoác Kaki Nam Áo Khoác Nam Hai Lớp FS Chống Nắng Chống Lạnh Cao Cấp KK46 - ShopN6 (Nhiều Màu)",189000,240000,51000,21
TIKI,thoi-trang-nam,125777295,"Bộ bơi nam 408(30_100kg)",209000,209000,0,0
TIKI,thoi-trang-nam,164756938,"Áo thun nam Polo có cổ ngắn tay Atuner ATN01 (4 Màu) trẻ trung, năng động, áo phông nam cao cấp chất liệu mềm mịn, siêu thấm hút mồ hôi, thoáng mát – Hàng chính hãng",145000,229000,84000,37
TIKI,thoi-trang-nam,157256582,"Áo lót nam đông xuân xuất khẩu 100% COTTON đủ size",39000,39000,0,0
TIKI,thoi-trang-nam,4027231,"Áo Khoác Dù Nam Phối Dây Kéo - K2015",124000,124000,0,0
TIKI,thoi-trang-nam,78924987,"Quần Jean Nam đẹp dẫn đầu xu hướng Thương Hiệu Chandi , mẫu mới form đẹp tôn dáng không quá ôm mẫu MR9007",165000,250000,85000,34
TIKI,thoi-trang-nam,176663149,"Áo khoác dù cách nhiệt GOKING cho nam nữ, áo khoác gió hàng hiệu Việt Nam cao cấp, chống gió lạnh, giữ ấm cơ thể",222000,222000,0,0
TIKI,thoi-trang-nam,97809476,"áo khoác dù chữ Seven zia, áo khoác dù chữ S, áo khoác bomber chữ S tay phối, Áo khoác dù nam nữ mặc / áo khoác gió nam nữ mặc / áo khoác dù kiểu bomber / áo khoác cặp đôi / áo khoác form rộng unisex ullzang",99000,99000,0,0
TIKI,thoi-trang-nam,110751273,"Quần jean baggy nam, quan jeans bò ống suông rộng SR_01 HotHit 2021",59000,59000,0,0
TIKI,thoi-trang-nam,20518136,"Quần Short Nam Khatoco Q3M378R0-CNMK005-2103-021",302400,378000,75600,20
TIKI,thoi-trang-nam,85087452,"Áo sơ mi nam ngắn tay vải chống nhăn",108000,108000,0,0
TIKI,thoi-trang-nam,81141012,"Quần Jean Nam cao cấp chất bò siêu co dãnThương Hiệu Chandi, form đứng dáng đẹp mẫu mới siêu hot MR9031",160550,169000,8450,5
TIKI,thoi-trang-nam,85256106,"Áo sơ mi nam dài tay hai màu đen trắng, chất vải cotton cao cấp chống nhăn",145000,145000,0,0
TIKI,thoi-trang-nu,84821877," Quần Lót Băng Lụa Siêu Mỏng Không Đường May P344",45000,45000,0,0
TIKI,thoi-trang-nu,25420783,"Bộ Quần Áo Nữ - Bd040519",299000,299000,0,0
TIKI,thoi-trang-nu,87714848,"Áo choàng ngủ xuyên thấu sexy kiểu kimono in hoa văn độc đáo",115000,115000,0,0
TIKI,thoi-trang-nu,13568062,"Sơ Mi Nữ Dài Tay",129000,129000,0,0
TIKI,thoi-trang-nu,161208804,"Quần lót cạp cao Bigsize (XL-6XL)",63000,63000,0,0
TIKI,thoi-trang-nu,24198767,"Quần Lót Nữ Ren Thêu Hoa Hồng Trước Cao Cấp",29000,29000,0,0
TIKI,thoi-trang-nu,161958734,"Bộ đồ lót bikini mỏng lọt khe sexy",35000,35000,0,0
TIKI,thoi-trang-nu,180606499,"Đồ bộ mặc nhà chất kate hàn",170000,170000,0,0
TIKI,thoi-trang-nu,162210593,"Quần lót chữ C thiết kế hở độc đáo gợi cảm cho nữ",45000,45000,0,0
TIKI,thoi-trang-nu,68418522,"Đầm ôm body 2 dây xoắn ngực",207000,207000,0,0
TIKI,thoi-trang-nu,196206538,"Áo Kiểu Nữ Cho Mẹ Chất Liệu Lụa Hàn Châu Phom Dáng Cực Chuẩn Đủ Size từ 45kg tới 68kg - Tuấn Tú Store",170000,170000,0,0
TIKI,thoi-trang-nu,155789100,"Áo thun nữ ngắn tay, áo phông nữ cộc tay chất vải Modal tự nhiên mát lạnh nhiều màu mã A0238",119000,119000,0,0
TIKI,thoi-trang-nu,161960735,"Cosplay lưới liền thân - Bộ đồ ngủ sexy che khuyết điểm",45000,45000,0,0
TIKI,thoi-trang-nu,190539038,"Bộ Đồ Pijama Nữ, đồ bộ Mặc Nhà Quần đùi tay cộc VILADY B152 Chất liệu Lụa Pháp (Lụa Latin) cao cấp Họa tiết Tim Bi Màu Hồng cam",349000,450000,101000,22
TIKI,thoi-trang-nu,161707218,"Quần lót nữ ONOFF sợi Microfiber siêu mảnh mát mịn, mỏng nhẹ 16UJ22A001",71000,99000,28000,28
TIKI,thoi-trang-nu,73514367,"Váy ngủ sexy mỏng có kèm quần lót - Đen",45000,45000,0,0
TIKI,thoi-trang-nu,124630709,"Áo vest nữ, áo blazer nữ mỏng tay lỡ phong cách Hàn Quốc Ak05",199000,199000,0,0
TIKI,thoi-trang-nu,78880034," Quần Lót Nữ Đẹp - Q1028",83000,83000,0,0
TIKI,thoi-trang-nu,118496431,"Áo nhung ấm ấp cho người già",350000,350000,0,0
TIKI,thoi-trang-nu,154202461,"Đầm 6 mảnh trung niên (size 47-67kg)",129000,129000,0,0
TIKI,thoi-trang-nu,34623864,"Áo Khoác Len Cardigan Nữ KN73 KN74",350000,350000,0,0
TIKI,thoi-trang-nu,113045965,"Đầm suông linen tay lỡ cổ tim tím nhạt sang trọng ArcticHunter, thời trang thương hiệu chính hãng",260000,260000,0,0
TIKI,thoi-trang-nu,176689206,"Đồ Bộ Nữ, Đồ Bộ Mặc Nhà, Pijama Kimono Tay Ngắn Cotton Thái Freesize dưới 65kg",70000,70000,0,0
TIKI,thoi-trang-nu,165237019,"Quần legging đùi MOLA nữ thun cạp cao biker lửng ngố đồ mặc nhà dáng ôm bó lưng bigsize tập gym yoga",99000,99000,0,0
TIKI,thoi-trang-nu,18012620,"Quần thun dài nữ jogger Phúc An 3011",99000,99000,0,0
TIKI,thoi-trang-nu,89501043,"Áo thun nữ trơn vải dày mịn Hàn Quốc (Có 16 Màu 9-95Kg)",54000,54000,0,0
TIKI,thoi-trang-nu,148551676,"Quần legging giữ nhiệt nữ chất vải siêu co giãn 4 chiều cạp liền màu đen",65000,65000,0,0
TIKI,thoi-trang-nu,165600199,"Quần lót nữ gợi cảm QL1690 - Quần lót nữ sexy",19000,30000,11000,37
TIKI,thoi-trang-nu,95253537,"Áo Khoác Dù 7ZIA Unisex Form Rộng Vải Dù Mero 2 Lớp",96000,96000,0,0
TIKI,thoi-trang-nu,1921325,"Áo Ngực Triumph Corsina 01 HP CS-TL - Da (Size",199000,199000,0,0
TIKI,thoi-trang-nu,100000804,"ÁO KIỂU TRUNG NIÊN SIZE LỚN DẠNG ÁO SƠ MI TRUNG NIÊN, THỜI TRANG U50-60, ÁO TẶNG MẸ TRUNG NIÊN 3A17",193000,219000,26000,12
TIKI,thoi-trang-nu,129818733,"Áo len nữ form rộng cổ tim thu đông - Xám",99000,99000,0,0
TIKI,thoi-trang-nu,120858390,"Hình thật áo lá học sinh áo lót học sinh không mút chất liệu cotton cao cấp vải 2 lớp loại đẹp",38000,40000,2000,5
TIKI,thoi-trang-nu,23239851,"[Chọn màu] Quần lót nữ ren xẻ đáy cực sexy nóng bỏng",35000,35000,0,0
TIKI,thoi-trang-nu,20350092,"Quần độn mông dây tam giác nâng mông đẹp",73000,73000,0,0
TIKI,thoi-trang-nu,184072273," Bikini Hai Mảnh Tay Dài Che Nắng Họa Tiết Bunny AT2O9 MayHomes Đồ Bơi Kiểu Korea Ôm Dáng, Long Sleeves Women Swimwear Set, UPF 50 Sun Protection",288000,288000,0,0
TIKI,thoi-trang-nu,104510848,"ÁO CARDIGAN NỈ NGOẠI Thêu Puppy (HD1910 - Kèm Ảnh Thật)",95000,95000,0,0
TIKI,thoi-trang-nu,186252222,"Váy Đầm Trung Niên Dáng Suông Form Rộng  Chất Linen Thoáng Mát Đũi Việt Dv165",282555,299000,16445,6
TIKI,thoi-trang-nu,184683527,"Đầm linen hè nữ, Đầm suông nữ dáng dài kèm dây thắt eo Haint Boutique Da82",299000,299000,0,0
TIKI,thoi-trang-nu,89347682,"Áo khoác bomber in hình unisex form rộng style ulzzang - Áo khoác bóng chày màu đen, nâu, xanh Nấm Store",104000,104000,0,0
TIKI,thoi-trang-nu,71062419,"Combo 3 Chiếc Quần Lót Nữ Chân Ren ATUNER QL010, Cao Cấp, Họa Tiết Thời Trang, Mềm Mại, Thoáng Mát (Giao Màu Ngẫu Nhiên) - Hàng Chính Hãng",169000,237000,68000,29
TIKI,thoi-trang-nu,87616804,"Áo Lót Mút Mỏng Vừa Phối Ren Habpy Lady By Sabina HBXLP0003",191500,383000,191500,50
TIKI,thoi-trang-nu,128302215,"Bộ đồ ngủ 2 dây chất phi bóng mềm mịn có mút ngực viền ren hai bên mã 5",58000,58000,0,0
TIKI,thoi-trang-nu,86882405,"( HÀNG SẴN) Áo Thun Nữ Trung Niên Dài Tay Thanh Lịch SM09 - Hàng Quảng Châu Cao Cấp",198000,198000,0,0
TIKI,thoi-trang-nu,190320583,"Đầm linen suông dáng dài, Đầm sơ mi nữ ngắn tay kèm dây thắt eo nhiều màu lựa chọn ARCTIC HUNTER AH75",299000,299000,0,0
TIKI,thoi-trang-nu,49524530,"Áo kiểu nữ cổ V đơn giản DV116",147075,159000,11925,8
TIKI,thoi-trang-nu,95474110," Đầm xoà dự tiệc lụa bi",137000,137000,0,0
TIKI,the-thao-da-ngoai,193003821,"Dây kháng lực tập gym tập mông Cabasports",23000,40000,17000,43
TIKI,thoi-trang-nu,150693884,"(HÀNG SẴN) Áo Khoác Len Trung Niên Sang Trọng AL65- Hàng Quảng Châu Cao Cấp",389000,389000,0,0
TIKI,thoi-trang-nu,118085215,"Chân váy xòe caro phối nút sang trọng - nhiều size và màu, form dáng chuẩn thích hợp mặc đi làm, dạo phố",142450,185000,42550,23
TIKI,the-thao-da-ngoai,21030046,"Găng Tay Boxing Trẻ Em Chính Hãng miDoctor - Găng Tay Đấm Bốc",99000,99000,0,0
TIKI,the-thao-da-ngoai,117062013,"Combo 3 Dụng Cụ  Hỗ Trợ Tập Yoga - YOGA QG:  2 Gạch Tập Yoga Trơn, Không Họa Tiết + 1 Dây Đai Tập Yoga Sợi Cotton",98000,125000,27000,22
TIKI,thoi-trang-nu,193093307,"Áo bra áo ngực không gọng mút mỏng chất cotton tăm mềm mại thoáng mát Lá Bralette A29",42000,49500,7500,15
TIKI,the-thao-da-ngoai,257855333,"Xà Đơn Treo Tường 60-150cm Gắn Cửa Đa Năng Độ Dài Tùy Chỉnh Giúp Bạn Tập Gym, Tập Cơ Bụng, Cơ Vai, Cơ Xô treo tường gắn cửa độ dài tùy chỉnh (hàng nhập khẩu)",91000,179000,88000,49
TIKI,thoi-trang-nu,58127744,"Áo Blazer Nữ Linen Hồng Pastel Túi Tay Lỡ Hàn Quốc",320000,320000,0,0
TIKI,the-thao-da-ngoai,59080455,"Giày Thể Thao Nam Biti's Hunter Street Mid Americano DSMH03600DEN Màu",700000,761000,61000,8
TIKI,the-thao-da-ngoai,68683364,"Cặp Vợt Cầu Lông Fuwin 6975",220000,220000,0,0
TIKI,the-thao-da-ngoai,35367014,"Thảm Tập YoGa TPE Dày 6mm Gym miDoctor + Bao Thảm Tập Yoga + Dây Thảm Tập Yoga (Túi, Dây Giao Màu Ngẫu Nhiên)",125000,125000,0,0
TIKI,thoi-trang-nu,16525501,"Áo khoác vest blazer nữ cao cấp NA38",408000,408000,0,0
TIKI,thoi-trang-nu,7145243,"Đai Nịt Bụng Thông Hơi Chống Cuộn 3 Hàng Khóa Cài Cao Cấp - 5STAR",38000,38000,0,0
TIKI,the-thao-da-ngoai,146499071,"[LOẠI TỐT - HÀNG CAO CẤP] Thảm Tập Yoga 8mm, Tập Gym dộ dày 5-8mm 2 Lớp không mùi chống trơn trượt - Chính hãng dododios",99000,99000,0,0
TIKI,the-thao-da-ngoai,135462170,"Hộp Phụ Kiện Câu Cá Phụ Kiện Dây Trục Câu Đài Câu Đơn HPK11",35000,35000,0,0
TIKI,the-thao-da-ngoai,106521570,"Kính bơi người lớn 958 thiết kế Panorama, không gọng, chống sương, chống tia UV",199000,199000,0,0
TIKI,the-thao-da-ngoai,52508450,"Quần tập Yoga Gym dài nâng mông có 2 túi bên hông cho nữ Thiết kế cao cấp Hibi Sports Mã QD307",216000,270000,54000,20
TIKI,the-thao-da-ngoai,151506141,"Túi lưới đựng bóng AOLIKES A-TB002",38000,69000,31000,45
TIKI,the-thao-da-ngoai,168467782,"Viên Muối Điện Giải GU Roctane Electrolyte Capsules - (50 viên/Hũ)",330000,330000,0,0
TIKI,the-thao-da-ngoai,127597034,"[Loại Tốt – Lõi Thép] Dây nhảy thể dục có thể điều chỉnh dây, Dây nhảy lõi thép, không bị rối dùng để tập thể dục độ dài 2.9m, hỗ trợ giảm cân – Chính hãng miDoctor",29000,29000,0,0
TIKI,the-thao-da-ngoai,155055738,"Con lăn massage giãn cơ foam roller body Massage, Gym, Fitness, Yoga",125000,125000,0,0
TIKI,the-thao-da-ngoai,103209746,"[TẶNG HỘP CẦU] Cặp vợt cầu lông cán liền nhôm carbon siêu nhẹ chính hãng Agnite -  Tặng hộp cầu nhựa và bao đựng - F2132",932400,932400,0,0
TIKI,the-thao-da-ngoai,147406452,"Xà Đơn Treo Tường Gắn Cửa Điều Chỉnh Độ Dài Linh Hoạt, Mẫu Mới Chất Liệu Thép Không Gỉ Chịu Lực 150kg, Tay Cầm Bọc Đệm PVC Chống Trượt - Chính hãng dododios",319000,319000,0,0
TIKI,the-thao-da-ngoai,56640430,"Trụ gập bụng Giảm Mỡ Bụng Dụng cụ tập eo - Giao màu ngẫu nhiên",63000,63000,0,0
TIKI,the-thao-da-ngoai,60423086,"Ghế Xếp Gọn Naturehike Câu Cá Dã Ngoại NH18X004-Y",520000,520000,0,0
TIKI,thoi-trang-nu,32380112,"Áo len nữ ngắn tay trơn cổ tròn nhiều màu Haint Boutique Al15",122550,129000,6450,5
TIKI,the-thao-da-ngoai,172977285,"Trùm Balo Bọc Balo Đi Mưa Chống mưa CHỐNG NƯỚC",25000,25000,0,0
TIKI,the-thao-da-ngoai,72931922,"Áo Tank Top Thể Thao Nữ Mẫu Mới Hot - Áo Lưới Tập Gym,Yoga, Đi Chơi",152000,152000,0,0
TIKI,thoi-trang-nu,184135820,"Quần lót cotton quả dâu cute co dãn 4 chiều được chọn màu chọn mẫu Q4",35000,35000,0,0
TIKI,the-thao-da-ngoai,173167744,"Trùm Balo Bọc Balo Đi Mưa Chống mưa CHỐNG NƯỚC",25000,25000,0,0
TIKI,the-thao-da-ngoai,16719308,"Quần Bơi Nam Thiết Kế Vảy Cá Mập Yesure Chống Thấm Nước , Nhanh Khô  Tặng Kèm Nón Bơi và Bịt Tai Silicon Cao Cấp",116000,201000,85000,42
TIKI,thoi-trang-nu,58524619,"Bộ bơi bikini nữ 2 mảnh cao cấp gợi cảm, áo gọng mềm nâng đẩy dễ chịu, quần váy cách điệu xinh xắn, chất bơi Lycra siêu đẹp | KT046",480000,480000,0,0
TIKI,thoi-trang-nu,112228024,"Áo Khoác Hoodie MISS.OUT. Ulzzang Unisex - Áo Chống Nắng Chát Nỉ Bông Khoác Nữ rẻ Đẹp Siêu Hot - HIỀN LINH SHOP ÁO KHOÁC",93000,93000,0,0
TIKI,thoi-trang-nu,197551618,"Áo khoác gió nam nữ Studios Unabated chất dù 2 lớp form rộng ô vuông, ÁO KHOÁC UNIXEX FROM RỘNG CÁ TÍNH (MS ô vuông), Áo Khoác Dù LOGO   Nam Nữ Ulzzang Unisex",99000,99000,0,0
TIKI,thoi-trang-nu,8448325,"Váy, Đầm Cho Người Trung Niên, Người Lớn Tuổi NG40D - Size",261000,261000,0,0
TIKI,thoi-trang-nu,192717710,"YU CHERRY | Áo nữ Cindy Pattern Top YA350",305000,305000,0,0
TIKI,thoi-trang-nu,91969994,"Áo bra, áo croptop ba lỗ có mút ngực cực xinh",41000,41000,0,0
TIKI,the-thao-da-ngoai,21731611,"[QUÀ TẶNG] Sữa tăng cơ Wheylabs Pro Standard Whey Protein hũ 5lbs (2.2kg) ( 73 lần dùng)",1450000,1450000,0,0
TIKI,thoi-trang-nu,105619777,"váy suông sát nách cổ tròn dáng dài 3 màu xinh xắn",89000,89000,0,0
TIKI,thoi-trang-nu,68662296,"Áo Thun cặp Nam-Nữ in hình mèo cực dễ thương , thích hợp cho các cặp đôi trẻ trung, năng động, cho các nhóm bạn đi đêm, đi phượt, bão, nhìn đã mắt, bao ngầu, bao chất, (giá trên dành cho 1 sản phẩm) - S",156000,156000,0,0
TIKI,thoi-trang-nu,119285172,"Combo 3 áo lót học sinh ngắn không mút iBasic VA111",180000,207000,27000,13
TIKI,thoi-trang-nu,114847614,"Quần tây cạp cúc khoá chun lưng nhiều màu tuyêt mưa ( Giá sỉ + ảnh thật )",69000,69000,0,0
TIKI,the-thao-da-ngoai,3729941,"Quả bóng đá Động Lực Cơ bắp UCV 3.05 số 5 (Tiêu chuẩn thi đấu, Kèm kim bơm và lưới đựng bóng).",284500,284500,0,0
TIKI,the-thao-da-ngoai,53209010,"Dụng Cụ Tập Cổ Tay - Hỗ trợ cổ tay ",67000,69000,2000,3
TIKI,thoi-trang-nu,131489429,"(Size M) Quần lót nữ thun lạnh mini brief tam giác viền ren mông SP002766",89000,89000,0,0
TIKI,thoi-trang-nu,77948739,"Áo sơ mi nữ ARCTIC HUNTER thiết kế cổ V kẻ sọc AH13",148029,159000,10971,7
TIKI,thoi-trang-nu,1479593,"Combo 2 Quần Lót Miley Lingerie Modal Dây chéo FDS0100_FDS0200",66000,130000,64000,49
TIKI,the-thao-da-ngoai,13787289,"Băng Quấn Cổ Tay Đàn Hồi Hỗ Trợ Khớp Cổ Tay Khi Chơi Thể Thao Sports Bandage AOLIKES YE-1535",26000,26000,0,0
TIKI,the-thao-da-ngoai,56868245,"Xe đạp tập thể dục tại nhà - xe đạp chạy tại nhà",1599000,1599000,0,0
TIKI,thoi-trang-nu,69165620,"Set 2 Quần Lót Gen Nịt Bụng Nâng Mông MN02",46800,46800,0,0
TIKI,the-thao-da-ngoai,117058199,"Dây Đai Tập Yoga Sợi Cotton, Dây Kéo Tập Yoga - YOGA QG, Hỗ Trợ Kéo Giãn Chân Tay, Uốn Người Tập Yoga, Giúp Bạn Có Một Cơ Thể Dẻo Dai",12000,45000,33000,73
TIKI,thoi-trang-nu,50139926,"Áo khoác nữ chống nắng che mặt",84000,84000,0,0
TIKI,the-thao-da-ngoai,181786149,"TÚI BỌC BALO CHỐNG NƯỚC MƯA DUNG TÍCH 45 LÍT",33000,33000,0,0
TIKI,thoi-trang-nu,97619158,"Đồ Ngủ Hai Dây Lụa Satin Cao Cấp Sexy Quyến Rũ Thương Hiệu Baw, Chất Liệu Lụa Mát Mịn Nhẹ Nhàng Cực Kỳ Lôi Cuốn NT708 (hình thật shop tự chụp)",169000,169000,0,0
TIKI,the-thao-da-ngoai,28050767,"Đồ Chơi Bóng Rổ Trẻ Em Cho Bé Trụ Sắt Kèm 2 Bóng - Chính Hãng Amalife",255000,255000,0,0
TIKI,thoi-trang-nu,108423829,"Quần short nữ cạp cao nhiều màu chất tuyết mưa",70000,70000,0,0
TIKI,the-thao-da-ngoai,37989729,"Bộ 2 Vợt Bóng Bàn Chính Hãng Amalife + Túi Đựng Vợt Bóng Bàn + 3 Bóng",175000,175000,0,0
TIKI,thoi-trang-nu,190301991,"(Fullsize) Áo Phông Nam Nữ Form Rộng Tay Lỡ Vải Cotton Mịn Mát - UNDER BROKEN (Fulltag cổ - tay áo)",149000,149000,0,0
TIKI,the-thao-da-ngoai,23420280,"Gậy bẻ tập cơ tay Power Twister",39000,39000,0,0
TIKI,the-thao-da-ngoai,68726892,"BỘ ĐÔI TẠ NẶNG  20KG TẠ  MIẾNG NHỰA ĐEN CAO CẤP ĐA NĂNG ",448000,459000,11000,2
TIKI,thoi-trang-nu,70156105,"Quần tây công sở nữ",130000,130000,0,0
TIKI,the-thao-da-ngoai,146385324,"Tạ tay nữ 1kg lõi gang đặc bọc cao su tập gym yoga chống trơn trượt, xước sàn( màu ngẫu nhiên)",55000,95000,40000,42
TIKI,thoi-trang-nu,24552815,"Áo lót nâng ngực multiway 7 kiểu mặc (kèm dây tạo 7 kiểu)",69000,69000,0,0
TIKI,the-thao-da-ngoai,96362741,"Viên uống tăng cường sức bền Endurance BCAA Hammer Nutrition - Tổng hợp Protein, kéo dài thời gian tập luyện, chạy bộ",1500000,1500000,0,0
TIKI,the-thao-da-ngoai,113912890,"Bạt Cắm Trại, lều chữ A,tấm trải đi phượt,bạt che xe ô tô, tăng mái che lều, che võng dựng lều dã ngoại, che mưa rằn ri",99000,99000,0,0
TIKI,the-thao-da-ngoai,130743716,"Quả bóng đá ngoại hạng Anh 2020-2021 - Banh bóng đá da số 5 - Tặng bơm, túi rút, kim bơm và túi lưới",149000,215000,66000,31
TIKI,the-thao-da-ngoai,135462577,"Dụng Cụ Gỡ Lưỡi Câu Cá Cao Cấp Chuyên Dụng DCC10",26600,26600,0,0
TIKI,thoi-trang-nu,53705155,"Set Váy Ngủ Lưới Mỏng Ren Áo Choàng Ngủ Sexy 3 Chi Tiết Cao Cấp",89000,89000,0,0
TIKI,thoi-trang-nu,185867085,"Bộ quần áo ngắn cho mẹ Xanh mạ linen - AICDMEMIBLBV - AIN Closet",310000,415000,105000,25
TIKI,thoi-trang-nu,34500807,"Quần Jean Trắng Nữ",159000,159000,0,0
TIKI,thoi-trang-nu,96252355," Áo croptop cổ tim cá tính",19000,19000,0,0
TIKI,the-thao-da-ngoai,22055881,"Xà Đơn Xếp Khánh Trình Dành Cho Người Cao Từ 1m40 - 1m80 Model KT1.1518 - Xà Đơn Tằng Chiều Cao- Xà Đơn Tập Stress Workout - Xà Đơn Hỗ Trợ Điều Trị Bệnh Xương Khớp - Thoái Hoá Cột Sống",1580000,1580000,0,0
TIKI,thoi-trang-nu,2918675,"Bikini Kèm Quần Lót Trong Cao Cấp BK88",168000,168000,0,0
TIKI,thoi-trang-nam,32988061,"Hộp Combo 5 Sịp Đùi Loại Đẹp",199000,199000,0,0
TIKI,thoi-trang-nam,34543749,"ÁO SƠ MI NAM HỌA TIẾT CHIẾC LÁ - HÀNG CAO CẤP 100% UY TÍN",92000,92000,0,0
TIKI,thoi-trang-nam,48042781,"Áo sơ mi nam form rộng cổ 2 ve, thời trang trẻ, phong cách Hàn Quốc",159000,159000,0,0
TIKI,thoi-trang-nam,66897309,"ÁO THUN NAM CỔ LỌ",170000,170000,0,0
TIKI,thoi-trang-nam,95059515," Áo thu sát nách unisex form rộng 1975 nam nữ ulzzang Wind",88000,88000,0,0
TIKI,thoi-trang-nam,71659029,"Áo Khoác Nam Nữ form cực rộng, Áo cặp hoodie nam nữ từ 46kg đến 68kg",96900,96900,0,0
TIKI,thoi-trang-nam,196297504,"Áo thun cổ tròn tay ngắn thời trang nam, chất cotton 100%, thấm mồ hôi cực tốt, thun co giãn 4 chiều - FORMEN SHOP - FMPS194",179000,350000,171000,49
TIKI,thoi-trang-nam,87011090,"Áo Thun Nam Ngắn Tay Chandi, Chất Thun Cotton Xịn Mẫu Mới NT18",123000,199000,76000,38
TIKI,thoi-trang-nam,52848986,"Combo 2 quần short nam thể thao thun lạnh cao cấp thoải mái, năng động, trẻ trung - FORMEN SHOP - FMCB3PS094",279000,380000,101000,27
TIKI,thoi-trang-nam,51638534,"Áo Sơ Mi Nam Trơn Ngắn Tay Form Chuẩn",138000,138000,0,0
TIKI,thoi-trang-nam,163928733,"Ăn chơi là phải có hội, mã TB1. Áo thun team building đồng đội, áo phông đẹp cho lớp nhóm, công ty. Áo phông hàng hiệu Goking, form unisex cho nam nữ, trẻ em, bé gái trai",69000,69000,0,0
TIKI,thoi-trang-nam,130745782,"Combo 4 Quần Lót Nam Boxer Cotton 4 Chiều Lưng Thái Cao Cấp, Quần Sịp Đùi Nam Thoáng Mát - ( Giao Màu Ngẫu Nhiên )",190000,190000,0,0
TIKI,thoi-trang-nam,14848656,"Combo 2 Áo phông trơn basic, form unisex cho nam nữ. Áo thun hàng hiệu Goking, quà tặng cao cấp cho gia đình, cặp đôi, lớp nhóm, doanh nghiệp, người nước ngoài",259000,259000,0,0
TIKI,thoi-trang-nam,6187707,"Bộ 5 quần sịp đùi xuất Nhật chất lụa cao cấp",74098,74098,0,0
TIKI,thoi-trang-nam,15054744,"Áo Sơ Mi Nam Ngắn Tay SMH98 - SMH98D",180000,180000,0,0
TIKI,thoi-trang-nam,68961881,"Quần lót boxer nam thun lạnh cực mát Nhật Bản",39000,39000,0,0
TIKI,thoi-trang-nam,84866436,"Quần Lót Nam Lọt Khe Siêu Gợi Cảm Boxers Brave Person B1181",99000,200000,101000,51
TIKI,thoi-trang-nam,12218705,"Áo sơ mi caro nam nữ 4young phong cách Hàn Quốc SM13",117000,117000,0,0
TIKI,thoi-trang-nam,169679982,"Quần jean nam CO GIÃN chất bò ống suông trung niên rộng rãi thoải mái loại quần jean ống đứng QJEAN22",155000,155000,0,0
TIKI,thoi-trang-nam,184072326,"Áo Gile nam, Áo Gile phối dây đai 2 bên Ngực cách điệu, lịch lãm, trẻ trung, phong cách. Mã N41",269000,269000,0,0
TIKI,thoi-trang-nam,161494286,"quần lót nam relax underwear thun lạnh cao cấp chính hãng, quần sip nam rltk16",86000,86000,0,0
TIKI,thoi-trang-nam,192032418,"Quần nam lửng, lưng thun kaki Amazing, sọt lưng thun nam dáng thể thao unisex, quần đùi có dây rút",159000,239000,80000,33
TIKI,thoi-trang-nam,149684151,"ÁO KHOÁC DÙ CAO CỔ NAM NỮ TMS MIDSIDE",95000,95000,0,0
TIKI,thoi-trang-nam,177275239,"Áo sơ mi form rộng nam nữ tay dài unisex phong cách hàn quốc trẻ trung vải lụa mềm mịn mát - MRD02",105000,190000,85000,45
TIKI,thoi-trang-nam,179163908,"(Big size <130kg) quần tây nam form slim fit big size đủ màu",330000,330000,0,0
TIKI,thoi-trang-nam,192683632,"ÁO SƠ MI TAY NGẮN-V46-014619-GY5",2990000,2990000,0,0
TIKI,thoi-trang-nam,93233783,"Áo Khoác Big Size Nam Nữ Unisex Áo Khoác Dù Nam 2 Lớp Chống Nắng Chống Lạnh Chống Gió Thời Trang Phom Body Phối Màu Hàn Quốc Cao Cấp AD73 - ShopN6",149000,180000,31000,17
TIKI,thoi-trang-nam,188579845,"Áo Thun Trơn Couple TX Cổ Tròn Basic Nam MTS 1132",159000,159000,0,0
TIKI,thoi-trang-nam,98625822,"Quần Short Nam Rách️️ Quần Short Bò Nam Cao Cấp - Sọt Jean Co Giãn Mẫu Mới Hàng VNXK Tô Tồ Shop-QSJN02-Mã 211",179000,179000,0,0
TIKI,thoi-trang-nam,179161511,"SƠ MI BBR TAY NGẮN BIG SIZE NAM TỚI 130KG ĐỦ MÀU",255000,255000,0,0
TIKI,thoi-trang-nam,111586884,"Áo sơ mi đũi nam cổ tầu form rộng mở khuy tay lỡ, thời trang phong cách trẻ",189000,189000,0,0
TIKI,thoi-trang-nam,74493882,"Áo thun unisex tay lỡ form rộng - phông thêu 4 logo",79000,125000,46000,37
TIKI,thoi-trang-nam,195949063,"Quần âu nam hàn quốc màu đen ADINO vải cotton không bai không xù co giãn dáng công sở slimfit ống đứng hơi côn QA140",249000,380000,131000,34
TIKI,thoi-trang-nam,90415269,"ÁO SƠ MI NAM XẾP LY",99000,99000,0,0
TIKI,thoi-trang-nam,112969165,"COMBO 4 QUẦN LÓT BOXER NAM ROSSO 0002 - UNDERWEAR MÀU NGẪU NHIÊN",480000,480000,0,0
TIKI,thoi-trang-nam,163902635,"Áo Sơ Mi Nam Xanh Dương Kẻ Caro Ngắn Tay Công Sở Trung Niên Thương Hiệu Anton Vải Sợi Tre - GD566",355000,355000,0,0
TIKI,thoi-trang-nam,263040176,"Bộ áo bà nam truyền thống đỏ đô - Có bộ bà ba Bigsize- may sỉ bà ba toàn quốc - May bộ bà ba theo yêu cầu",199000,199000,0,0
TIKI,thoi-trang-nam,151799597,"QUẦN LÓT NAM - Tam Giác Bikini Bản Nhỏ Gọn - Thun Lạnh Sọc Siêu Mát",39000,39000,0,0
TIKI,thoi-trang-nam,193762563,"Viettien - Quần tây nam màu xám sáng 1R4034 - 1R4035 - 1R4036 loại có ly và không ly - Quần âu cao cấp Việt Tiến",710000,710000,0,0
TIKI,thoi-trang-nam,144526512,"Áo dạ nam - kiểu dáng hiện đại, style Hàn Quốc (R8)",299000,299000,0,0
TIKI,the-thao-da-ngoai,19700091,"Combo 4 Bánh Đèn Led Đơn Sắc (Màu Ngẫu Nhiên)",140000,140000,0,0
TIKI,the-thao-da-ngoai,149585251,"Hạ Lóng Cần Tay CHIXUAN Đại Lý Đồ Câu Cá Chất Liệu Hợp Kim Nhôm Chống Gỉ Sét Chuyên Dụng Câu Đài",55100,55100,0,0
TIKI,the-thao-da-ngoai,10784674,"Ghế xếp du lịch, dã ngoại cao cấp ( GX01 )",100000,100000,0,0
TIKI,the-thao-da-ngoai,196853380,"Dụng Cụ Tập Cơ Hàm Mặt Nâng Cơ Mặt Làm Săn Chắc Da",22000,22000,0,0
TIKI,the-thao-da-ngoai,148570091,"cước câu cá cước trục thẻo 3D tàng hình 100m NANO",22100,22100,0,0
TIKI,the-thao-da-ngoai,138701224,"Phao Câu Cá",3400,3400,0,0
TIKI,the-thao-da-ngoai,198326138,"đai chống gù lưng cao cấp mi01 - Chính hãng DoDoDios",249000,249000,0,0
TIKI,the-thao-da-ngoai,156013691,"Chuông Báo Cá Điện Tử Gắn Đèn LED Báo Động Cá Cắn Câu PK15 đồ câu FISHING_HD",30900,30900,0,0
TIKI,the-thao-da-ngoai,163780335,"Lưỡi Lục Đồng Đúc Hàng Thửa Cao Cấp - Đồ Câu DULI",38000,38000,0,0
TIKI,the-thao-da-ngoai,139919299,"Cước Câu Cá 500m của Mỹ Trilene Big Game đủ size siêu bền chống sờn hàng cao cấp",59499,59499,0,0
TIKI,the-thao-da-ngoai,189476021,"Lều thú tự bung có kèm túi đựng gấp gọn- Lều cho bé vui chơi trong nhà- Cắm trại ngoài trời- Kích thước 86*96*182",240000,240000,0,0
TIKI,the-thao-da-ngoai,195968541,"Ba lô leo núi Sportslink - 68L",627000,690000,63000,9
TIKI,the-thao-da-ngoai,149628951,"Hộp bộ phao câu đài kèm phao và phụ kiện câu đài- cần tay_hộp phao xanh+tặng kèm phao câu đêm",105733,105733,0,0
TIKI,the-thao-da-ngoai,127120578,"Cầu đá cao cấp Hải đông",40000,40000,0,0
TIKI,the-thao-da-ngoai,95195162,"Thảm tập yoga, tập gym 2 lớp TPE cao cấp chống trượt 6MM không bám mùi - giao màu ngẫu nhiên",103950,142065,38115,27
TIKI,the-thao-da-ngoai,172573862,"Báo động cá cắn câu V3",100000,100000,0,0
TIKI,the-thao-da-ngoai,196280275,"Máy Phát Hiện Nói Dối Gian Xảo Polygrapha ",184000,184000,0,0
TIKI,the-thao-da-ngoai,140951541,"Bàn gấp dã ngoại NH19Z027-Z phù hợp du lịch dã ngoại, cắm trại, câu cá",775000,775000,0,0
TIKI,the-thao-da-ngoai,101323855,"Bộ 2 sản phẩm bình lắc shake bottle và hộp đựng whey ishake protein funnel ON Gold Standard",69000,69000,0,0
TIKI,the-thao-da-ngoai,138713408,"Bịch 20 Hạt Chặn Phao Câu Cá",3400,3400,0,0
TIKI,the-thao-da-ngoai,243032258,"Gậy vẩy mồi câu cá chất liệu cacbon  siêu nhẹ",69000,69000,0,0
TIKI,the-thao-da-ngoai,160872466,"Túi đựng điện thoại Túi chạy bộ Túi đeo hông Túi đựng bình nước chạy bộ Túi đeo bình nước Túi đeo điện thoại thể thao ye",60000,60000,0,0
TIKI,the-thao-da-ngoai,42832927,"Bình nước chạy bộ, dã ngoại, đạp xe Rimix 3302 (2 Lít)",139000,215000,76000,35
TIKI,the-thao-da-ngoai,193760886,"Quần Jogger Nam Thể Thao - Thương Hiệu X9 - Tập Gym Chạy Bộ Đi Chơi Cotton Co Giãn - X007",720000,720000,0,0
TIKI,the-thao-da-ngoai,172668957,"Quần lửng Minatex nâng mông chất đẹp 3 màu tập gym yoga chạy bộ",148000,148000,0,0
TIKI,the-thao-da-ngoai,139941935,"Chuông báo cá đẹp",1200,1200,0,0
TIKI,the-thao-da-ngoai,9972345,"Quần dài Jogger thể thao nữ tập gym yoga Angel01 xám",249000,249000,0,0
TIKI,the-thao-da-ngoai,45597085,"Giày Đá Bóng Vải TL Cỏ Nhân Tạo - Trắng",89000,89000,0,0
TIKI,the-thao-da-ngoai,812325,"Túi Đựng Cho Thảm Yoga Từ Sportslink (8mm) - Chấm Bi Đen",54000,60000,6000,10
TIKI,the-thao-da-ngoai,127120536,"Cầu đá cao cấp - số 1",55000,55000,0,0
TIKI,the-thao-da-ngoai,68375583,"Lưới tập đánh golf di động 3M-LXW013: Thiết kế mới với 3 lỗ đục, hai màu lựa chọn",800000,950000,150000,16
TIKI,the-thao-da-ngoai,262726083,"Băng Khuỷu Tay bóng chuyền, cầu lông, Đôi Băng bảo vệ tay chính hãng Aolikes 7146 (1 đôi) magic",46700,46700,0,0
TIKI,the-thao-da-ngoai,172075918,"Máy tập phục hồi chức năng 4 trong 1 (4 IN1) cho người tai biến",3149000,3149000,0,0
TIKI,the-thao-da-ngoai,12000549,"Bảo Hộ Tay Chân Trẻ Em Chính Hãng Cougar",155000,155000,0,0
TIKI,the-thao-da-ngoai,101324171,"Bình lắc 3 ngăn bình nước thể thao Spider Bottle - màu Đỏ",89000,89000,0,0
TIKI,the-thao-da-ngoai,126509392,"CẦU ĐÁ CAO CẤP số 1",55000,55000,0,0
TIKI,the-thao-da-ngoai,140961662,"Vèo nuôi cá, ếch - Không nắp - 2x1, Cao 1 mét",89380,109000,19620,18
TIKI,the-thao-da-ngoai,138711658,"(Combo 5 Chiếc) Chân Cắm Phao Câu Cá Dùng Cho Câu Đơn, Đài Có Khóa Link",6700,6700,0,0
TIKI,the-thao-da-ngoai,217519103,"Khăn choàng tắm , đi biển , đi bơi có mũ trùm , hình ngộ nghĩnh , màu sắc tươi sáng",79000,79000,0,0
TIKI,the-thao-da-ngoai,23442506,"Bộ Nhảy Dây Tập Thể Dục - Giao màu ngẫu nhiên",32998,32998,0,0
TIKI,thoi-trang-nam,163712959,"Áo Sơ Mi Nam Công Sở Trung Niên Thương Hiệu Anton Dài Tay Vải Cotton Xanh Đậm Trơn Có Túi - A13",225000,280000,55000,20
TIKI,thoi-trang-nam,109545851,"Quần đùi nam xuất khẩu mặc nhà, quần đùi nam, quần short, quần sọc nam vải kate cotton 100% thương hiệu Fezzio",64500,129000,64500,50
TIKI,thoi-trang-nam,110139205,"Áo Gile Nam Lính Mỹ U869 Phong Cách US ARMY - HÀNG CHÍNH HÃNG",361000,798000,437000,55
TIKI,thoi-trang-nam,100897026,"Bộ Mặc Nhà Nam Mùa Hè Mát Mẻ Cao Cấp Thời Trang ZERO",209000,300000,91000,30
TIKI,thoi-trang-nam,191926050,"Quần đùi nam thể thao vải gió siêu nhẹ, quần short nam vải gió cao cấp QD01 - PROMAN",80000,80000,0,0
TIKI,thoi-trang-nam,134615733,"Quần lót nam ARISTINO dáng Brief, quần sịp tam giác chất liệu Modal tự nhiên, mềm mại và thoáng mát gấp 2 lần so với sợi vải thông thường - ABF1616",79500,95000,15500,16
TIKI,thoi-trang-nam,114193983,"Quần dài thể thao nam Jogger 3 sọc ống bo trẻ trung năng động Micado",150000,150000,0,0
TIKI,thoi-trang-nam,44003425,"Áo sơ mi nam tay dài thêu họa tiết mới nhất",85000,85000,0,0
TIKI,thoi-trang-nam,73161713,"áo hoodie nam nữ",100000,100000,0,0
TIKI,thoi-trang-nam,168224742,"[COMBO 3 QUẦN] Quần Lót Nam Boxer Thun Lạnh Lados 4116 - Thun lụa co giãn, dai, thoáng mát, thấm hút mồ hôi tốt",180000,180000,0,0
TIKI,thoi-trang-nam,167431552,"Quần Bò Nam cao cấp thương hiệu Chandi, chất jean co dãn mẫu mới nhất MS27",165000,300000,135000,45
TIKI,thoi-trang-nu,3075019,"Váy đầm lanh (tole) Vicci TVN004.12 vải xước họa  tiết hoa hoa nền tím (Size",150000,299000,149000,50
TIKI,thoi-trang-nam,104109417,"Hộp 5 Quần Lót Nam lưng Hàn Quốc hiệu CITYMEN vải cotton co giãn 4 chiều cao cấp, sịp nam - LMTK-HANAC",190000,190000,0,0
TIKI,thoi-trang-nam,178058234,"Áo thun nam có cổ trơn cao cấp LADOS-9084 vải poli siêu mát mẻ, thấm hút mồ hôi tốt, form đẹp",139000,199000,60000,30
TIKI,thoi-trang-nam,102122394,"Combo 4 Quần lót boxer nam - Quần sịp đùi su đúc lụa sữa cao cấp không đường may Micado",280000,280000,0,0
TIKI,thoi-trang-nu,129821682,"Ao sơ mi thô Linen nữ form rộng cổ bẻ 2 túi ngực trẻ trung, thời trang phong cách trẻ",189000,189000,0,0
TIKI,thoi-trang-nam,133810672,"Áo Khoác Nam Trung Niên Chất Đẹp Không Nhăn Mẫu Mới",450000,450000,0,0
TIKI,thoi-trang-nu,114327253,"Đầm xòe / Đầm dự tiệc phối voan kiếng siêu sang chảnh có đủ size S M L XL XXL",39000,39000,0,0
TIKI,thoi-trang-nu,189686556,"Bộ đồ ngủ nữ vải Cotton lanh lụa tự nhiên mềm mịn mát lạnh, set đồ nữ hai dây quần đùi mặc nhà mặc mùa hè mã BD0180",139000,139000,0,0
TIKI,thoi-trang-nam,273121056,"QUẦN JEAN TRUNG NIÊN ỐNG SUÔNG CO GIÃN TG",270000,270000,0,0
TIKI,thoi-trang-nu,200021713,"ĐỒ LAM ĐI CHÙA trang nhã",155220,155220,0,0
TIKI,thoi-trang-nu,129573733,"Áo Hoodie mắt chữ X siêu chất, Áo nỉ unisex ulzzang dày dặn, áo nỉ nam nữ đẹp, áo hoodie, áo đôi, Áo Marshmello hoodie dài tay mũ trùm đầu, Áo hoodie phản quang trẻ trung, năng động form dưới 70kg",125000,125000,0,0
TIKI,thoi-trang-nu,116481096,"Bản Nịt ngực TomBoy",75000,75000,0,0
TIKI,thoi-trang-nu,6535769,"Quần Đùi Mặc Váy Cotton Phối Ren",23000,25000,2000,8
TIKI,thoi-trang-nu,120147544,"GOTI - Áo Sơ Mi Quý Bà Voan Dáng Rộng Dáng Áo Kiểu Trung Niên Vạt Nhọn In Hoa - ÁO TRUNG NIÊN CAO CẤP 3A14",193000,219000,26000,12
TIKI,thoi-trang-nam,20518565,"Quần Short Nam Khatoco Q3M318R0-VNMA031-2009-018",129000,318000,189000,59
TIKI,thoi-trang-nam,164239110,"Áo Thể Thao Nam TSIMPLE cổ tròn tay ngắn tập gym vải thun lạnh thoáng mát co giãn chuẩn form MSSAHP010",165000,165000,0,0
TIKI,thoi-trang-nam,121622214,"Áo khoác dù 2 mặt 2 lớp chống trượt nước Lados - 2015 form unisex trẻ trung đơn  dễ phối",229000,399000,170000,43
TIKI,thoi-trang-nam,193988328,"Quần Jean nam Leman xanh trơn JD16 - Slim Form",455000,549000,94000,17
TIKI,thoi-trang-nu,117902311,"Áo HOODIE KHÓA ZIP NAM NỮ CON MỰC Unisex hoodie,Áo HOODIE NỮ MÀU ĐỎ ĐEN DÁNG RỘNG VẢI DÀY ĐẸP Hoodie unisex,Áo Hoodie Zip In Hình Unisex - Hoodie Dây Kéo Dáng Rộng",118000,118000,0,0
TIKI,thoi-trang-nu,174621819,"Quần Legging lửng nữ siêu tôn dáng giúp nâng mông , co giãn 4 chiều thoải mái, chất liệu thoáng mát , có đủ size lựa chọn",70000,70000,0,0
TIKI,thoi-trang-nu,175849223,"Vải áo dài in họa tiết hoa anh đào nhí",205000,205000,0,0
TIKI,thoi-trang-nam,163716292,"Bộ bơi nam khóa kéo size lớn, quần áo bơi bigsize cho nam giới, chất thun bơi lạnh Hàn dầy dặn, dáng thể thao mạnh mẽ | BN016",480000,480000,0,0
TIKI,thoi-trang-nu,181449415,"Váy ngủ hở lưng thoáng mát",105000,105000,0,0
TIKI,thoi-trang-nu,192717821,"YU CHERRY | Áo nữ Wings Top YA343",280000,280000,0,0
TIKI,thoi-trang-nu,13672976,"Quần Lót Triumph Sloggi Zero Hipster Màu Da (86-VN)",235000,299000,64000,21
TIKI,thoi-trang-nu,75372394,"Combo 2 quần lót su đúc cao cấp, lưng cao, không đường may và ôm sát vòng 3 của bạn LYEQ003",118000,118000,0,0
TIKI,thoi-trang-nam,75320881,"Quần short kaki nam Amazing, màu sắc trẻ trung, bigsize, vải co giãn, lưng thun có dây rút",239000,239000,0,0
TIKI,thoi-trang-nu,69984675,"Áo lót Bigsize định hình nâng ngực Quả lớn (sz 34-44DE)",187000,187000,0,0
TIKI,thoi-trang-nu,38705224,"Quần nữ kết dây sexy lọt khe gợi cảm - Màu hồng đậm ",25000,25000,0,0
TIKI,thoi-trang-nu,174309468,"Váy ngủ lụa khoét ngực cao cấp Q140 -  Đầm ngủ lụa hai dây sexy - Váy ngủ nữ - Đồ ngủ mặc nhà",149000,230000,81000,35
TIKI,thoi-trang-nu,83033098,"Quần Gen Nịt Bụng Cạp Cao 3 Nấc Cài Chống Cuộn",145000,195000,50000,26
TIKI,thoi-trang-nam,20868674,"Áo Thun Nam Tay Dài D404",95000,95000,0,0
TIKI,thoi-trang-nam,197170229,"Áo khoác nam unisex cổ đứng vải dù 2 lớp phối màu độc lạ họa tiết chữ HEBFN đi mưa,cản gió,chống nắng, Áo khoác dù nam nữ màu 3 sọc chất liệu dù gió 2 lớp cao cấp dáng from bóng chày bomber đẹp",95000,95000,0,0
TIKI,thoi-trang-nam,76013601,"ÁO KHOÁC KAKI NAM 020",195000,195000,0,0
TIKI,thoi-trang-nu,68958661,"Áo thun nữ form rộng, áo phông tay lỡ ATL219",55000,55000,0,0
TIKI,thoi-trang-nam,184910578,"Viettien - Quần kaki nam màu be không ly 6R6008 regular",785000,785000,0,0
TIKI,thoi-trang-nu,76654209,"Áo Thun Sweater Nữ Kiểu Tay Dài Bo Trơn",120000,120000,0,0
TIKI,thoi-trang-nu,185466170,"ÁO SƠ MI KHOÁC NGOÀI NAM NỮ NHUNG TĂM GÂN FORM RỘNG , ÁO SOWMI UNISEX NHUNG GÂN MÀU BE",158000,158000,0,0
TIKI,thoi-trang-nu,181714293,"Áo Thun Nữ Cao Cấp Organic Cotton Regular Fit Aaa Jeans",249000,249000,0,0
TIKI,thoi-trang-nam,183718179,"Áo sơ Mi, Áo sơ Mi Nam cổ Vest, dài tay, mới lạ và sang trọng. Chất liệu Cotton cao cấp, nhẹ, mát mẻ, thấm mồ hôi, không nhăn, không nhàu,mã N34",199000,199000,0,0
TIKI,thoi-trang-nu,70492925,"QUẦN LÓT REN SEXY MÃ 2164",32000,32000,0,0
TIKI,thoi-trang-nu,129829407,"Đầm suông linen dáng chữ A cổ V tay lỡ xanh than, chất thô mềm mát, thời trang phong cách Hàn Quốc",250000,250000,0,0
TIKI,thoi-trang-nam,178000089,"Quần bơi nam cao cấp may 2 lớp chắc chắn chất thun đẹp trẻ trung lưng có dây rút rất tiện lợi khi mặc",126300,126300,0,0
TIKI,thoi-trang-nu,3706473,"Sơ mi công sở nữ phối kẻ tay sm150",151050,159000,7950,5
TIKI,thoi-trang-nu,194198425,"Bộ đồ bơi bikini nữ 2 mảnh tắm biển kín đáo sexy quyến rũ kèm váy choàng - B.46",255550,269000,13450,5
TIKI,thoi-trang-nu,111070059,"QUẦN YẾM NGẮN NỮ PHONG CÁCH MỚI LẠ TB4",125000,125000,0,0
TIKI,thoi-trang-nam,150695791,"Áo Thể Thao Nam TSIMPLE cổ tròn tay ngắn tập gym vải thun lạnh thoáng mát co giãn chuẩn form For Run MSSAHP3",95000,165000,70000,42
TIKI,thoi-trang-nam,160417810,"quần lót nam relax cotton siêu xin cao cấp chính hãng, quần sịp nam relax underwear rltk48",99000,99000,0,0
TIKI,thoi-trang-nam,78945617,"Quần Jean Nam cao cấp co dãn 4 chiều Thương Hiệu Chandi, phong cách hàn quốc trẻ trung cá tính MR9019",184000,299000,115000,38
TIKI,thoi-trang-nam,45818196,"Quần Short Đùi Nam Boxer Tập Gym Mặc Ngủ Super Body New Colour",75050,79000,3950,5
TIKI,thoi-trang-nu,187659649,"Áo Ngực Không Gọng Chất Liệu Cotton Cao Cấp, Áo Bra  Mẫu Mới Siêu Đẹp Thương Hiệu Baw Mã ANM16",180000,180000,0,0
TIKI,thoi-trang-nu,154135520,"Đầm xòe phom chữ A thiết kế thun co giãn 4 chiều cao cấp (hàng có size) cho bạn nữ đi tiệc - đi làm đều sang trọng",420000,420000,0,0
TIKI,thoi-trang-nu,26303961,"Quần jogger nữ mùa đông chất umi",80000,80000,0,0
TIKI,thoi-trang-nu,174622192,"Áo 2 Dây Nữ bản to Lụa Hàn Cao Cấp Madela, vải lụa Hàn mềm mịn thoáng mát , kiểu dáng basic dễ phối đồ phong cách trẻ trung , có đủ màu và size để lựa chọn - AKT04",90000,90000,0,0
TIKI,thoi-trang-nam,94850989,"Quần Lót Nam Cao Cấp Brave Person B1112 - Chất liệu cotton cao cấp, thoáng mát, thấm hút mồ hôi tối đa - Thiết kế ôm trọn vòng 3, tôn lên vẻ nam tính",133000,199000,66000,33
TIKI,thoi-trang-nu,8448446,"Bộ Đồ Nữ Cho Người Trung Niên, Người Lớn Tuổi NGT13 - Size",420000,420000,0,0
TIKI,thoi-trang-nam,4426117,"Quần Dài Jogger Nam Phối Sọc 1041_xanh",95000,95000,0,0
TIKI,thoi-trang-nu,77953998,"Váy ngủ beo hồng hàng lụa cao cấp",238000,238000,0,0
TIKI,thoi-trang-nam,89264090,"Áo khoác bomber nam nữ kaki oversize Áo bomber form rộng Áo khoác bóng chày Candle unisex - Gin Store",98000,98000,0,0
TIKI,thoi-trang-nam,113115714,"Áo lót nam 100% cotton trắng LEDATEX siêu rẻ, siêu đẹp",54000,54000,0,0
TIKI,thoi-trang-nu,194115003,"Đầm Suông Đuôi Cá 2 Dây De Leah",399000,725000,326000,45
TIKI,thoi-trang-nam,90961454,"Combo 3 Quần Lót Nam Cotton Mềm Mịn Siêu Thoáng Mát, Co Giãn 4 Chiều Cao Cấp Dokafashion EZQLH03",61000,109000,48000,44
TIKI,thoi-trang-nu,146768705,"(BIG SIZE) Chân váy xếp ly kẻ cạp cao C045",180000,180000,0,0
TIKI,thoi-trang-nam,82646137,"Áo Sơ Mi Nam Ngắn Tay Phối Caro",163000,163000,0,0
TIKI,thoi-trang-nu,191428297,"Sơ mi nữ linen form rộng trễ vai trẻ trung ArcticHunter, thời trang thương hiệu chính hãng",250000,250000,0,0
TIKI,thoi-trang-nu,75544734,"Đồ Bơi Nữ Hai Mảnh Tay Dài Chống Nắng Dễ Thương AT209 MayHomes Đồ Bơi Kiểu Hàn Quốc Ôm Thân, Long Sleeves Women Swimwear Set, UPF 50 Sun Protection",288000,288000,0,0
TIKI,thoi-trang-nam,117583109,"ÁO KHOÁC DÙ DÀY NAM PHONG CÁCH HÀN QUỐC",169000,169000,0,0
TIKI,thoi-trang-nam,4382605,"Quần Dài Jogger Nam Phối Sọc 1041",95000,95000,0,0
TIKI,thoi-trang-nu,5868963,"Quần Độn Mông Su Dạng Đùi Mặc Trong Váy F222",75000,75000,0,0
TIKI,bach-hoa-online,98190526,"Nấm Hương Khô Cao Bằng 100g",36000,36000,0,0
TIKI,bach-hoa-online,181978842,"Đặc Sản Sóc Trăng - Bánh Hạnh Nhân Hộp Giấy 300G, Bánh Hạnh Nhân Tân Huê Viên Sóc Trăng, Bánh Bột Đậu, BáNh KẹO ĂN VặT Sài Gòn",55800,62000,6200,10
TIKI,bach-hoa-online,57512128,"Bát ăn kèm bình uống nước tự động cho chó mèo - Kiểu dáng dễ thương",59000,59000,0,0
TIKI,bach-hoa-online,73559847,"Trà Xanh Cầu Đất - Túi 110Gr",68000,70000,2000,3
TIKI,bach-hoa-online,53706414,"Hạt ngũ hoa",55000,55000,0,0
TIKI,bach-hoa-online,20761487,"Socola Đen Vỏ Cam Thanh Lớn 80 gram, Nguyên Chất, Đắng Vừa | Dark Chocolate Orange Peel Alluvia",115000,115000,0,0
TIKI,bach-hoa-online,149998191,"1KG HẠT KÊ BÓNG ĐỎ (KÊ ĐỎ HẠT TO) CHO CHIM CẢNH, VẸT, YẾN PHỤNG (1KG)",33000,33000,0,0
TIKI,bach-hoa-online,26027110,"Hạt Chia Shots hữu cơ Smile Nuts gói nhỏ tiện dụng (8g x 10 gói) - Organic Chia Seed Shots (8g x 10 bag) ",39000,47000,8000,17
TIKI,bach-hoa-online,192794665,"Combo 2 chai dầu ăn dinh dưỡng Ranee Cá Hồi 950ml (950ml/chai x 2 chai)",134000,185900,51900,28
TIKI,bach-hoa-online,99078181,"Rong biển sấy mè rang vị truyền thống Ottogi 30g",36800,36800,0,0
TIKI,bach-hoa-online,112250377,"Bắp Mỹ Rang Bơ, Bắp Nỗ Rạp Chiếu Phim TETE 1kg (Nổ Hình Nấm) ",73000,73000,0,0
TIKI,bach-hoa-online,12414460,"Bịch Bông Atisô Sấy Khô L'angfarm (225g)",269000,269000,0,0
TIKI,bach-hoa-online,155255740,"Tương ớt gói Cholimex 10g siêu tiện lợi (01 túi gồm 50 gói)",31000,31000,0,0
TIKI,bach-hoa-online,14977762,"Đậu hà lan xanh nguyên hạt Whole Green Peas",16150,17000,850,5
TIKI,bach-hoa-online,140173620,"Vòng Cổ Nhiều Màu Sắc Có Lục Lạc Khóa Có Thể Điều Chỉnh Cho Mèo Chó Nhỏ (giao màu ngẫu nhiên)",11888,11888,0,0
TIKI,bach-hoa-online,4681147,"Hộp Bột ngũ cốc dinh dưỡng cao cấp 22 Complete Nutrimix - Wheat Grass (Mầm lúa mì) - 750g",522500,522500,0,0
TIKI,bach-hoa-online,178256483,"Muối Hồng Himalaya Xay Nhuyễn Vipep Hũ Nhựa 200g",25000,25000,0,0
TIKI,bach-hoa-online,73330911,"Da cá trứng muối 105g IRVINS - Small Salted Egg Fish Skin",201000,201000,0,0
TIKI,bach-hoa-online,163716525,"Combo 2 hộp Trà hoa cúc gạo lứt Quê Việt + bình đựng nước thanh nhiệt, ngủ ngon, điều hoà huyết áp (2 hộp x 600gr/hộp)",348000,690000,342000,50
TIKI,bach-hoa-online,10229393,"Gạo Hữu Cơ Hoa Nắng - Vàng Lúa Chín 2kg",158000,158000,0,0
TIKI,bach-hoa-online,6956839,"Hạt Nêm Youki Nhật Bản 500g",222500,222500,0,0
TIKI,bach-hoa-online,29263840,"Trân châu trắng Gaban 100g",135000,135000,0,0
TIKI,bach-hoa-online,72506287,"Muối Ớt Sấy 110g Dh Foods",19980,19980,0,0
TIKI,bach-hoa-online,55703852,"Hạt Quinoa Mix 3 Màu Smile Nuts Túi 2kg (Còn được gọi là Hạt Diêm Mạch) - Nhập khẩu từ Peru (Gồm Quinoa trắng, Quinoa đen và Quinoa đỏ), túi 2kg tiện dụng và tiết kiệm hơn",339000,490000,151000,31
TIKI,bach-hoa-online,72879677,"TINH BỘT BIẾN TÍNH DISTARCH PHOSPHATE (INS1412) I Gói 1kg",20000,20000,0,0
TIKI,bach-hoa-online,90027987,"Sữa bột Diabetic Gold Care-400gr- Dinh dưỡng cho người tiểu đường",170000,170000,0,0
TIKI,bach-hoa-online,179575858,"SHIN Cà Phê - Cà phê túi nhúng tiện lợi hộp 10 gói",70000,70000,0,0
TIKI,bach-hoa-online,40936043,"Trà Diệp Hạ Châu Điều Trị Viêm Gan B , Mỡ Máu - Nguyên Thái Trang (Bịch 100 Túi Lọc X2Gr )- Thảo Dược Thiên - Nhiên Tốt Cho Sức Khỏe",70000,70000,0,0
TIKI,thoi-trang-nam,188382233,"Áo Gile nam, Áo Gile T&T phối sơ mi độc đáo, đứng dang, không phai màu, không nhăn mã N43",260000,260000,0,0
TIKI,bach-hoa-online,101585635,"Tấm Thơm ( Tấm Gạo ST25 ) Ông Thọ 1Kg - Cơm mềm dẻo, nấu cơm ăn dặm cho bé, nấu cháo dinh dưỡng cho người già và trẻ nhỏ, cơm tấm gia đình",25000,25000,0,0
TIKI,thoi-trang-nam,178785868,"Áo phông nam phong cách Hàn Quốc mã TX20",229500,459000,229500,50
TIKI,bach-hoa-online,141654153,"G-BiO 20ML Chống Nhiễm khuẩn, Lở Loét Ngoài Da, Thối Vây.... Ở Cá. Hàng mới về",33250,35000,1750,5
TIKI,bach-hoa-online,198197816,"Dâu tằm sấy dẻo ít đường Kentary - sấy nguyên vị chua chua ngọt ngọt - đồ ăn vặt healthy",125000,125000,0,0
TIKI,bach-hoa-online,139011518,"Cỏ bạc hà Catnip viên xoay tròn, có nắp đậy, giúp tiêu búi lông",32222,32222,0,0
TIKI,thoi-trang-nam,55163582,"Quần Bơi Nam Họa Tiết Cá Tính AT171 MayHomes Thun Lạnh Co Giãn Tốt, Mạnh Mẽ Cá Tính",114810,129000,14190,11
TIKI,thoi-trang-nam,115955390,"Áo thun dài tay cổ tim nam",78000,78000,0,0
TIKI,thoi-trang-nam,3714997,"Combo 5 Quần Lót Boxer Nam Freeman 6516-CB5-L (Size",340000,425000,85000,20
TIKI,bach-hoa-online,34642587,"Con Sứa Giả Trang Trí Bể Cá",25000,25000,0,0
TIKI,bach-hoa-online,198091362,"Quần áo Tết cho chó mèo, áo dài Tết vải gấm cho thú cưng",109000,109000,0,0
TIKI,bach-hoa-online,172657045,"Muối ớt Natas Hũ 90g-Muối Đa Năng",17000,17000,0,0
TIKI,thoi-trang-nam,138750990,"Áo Phông Nam cổ tim Chất cotton mềm Mịn Dáng Ôm Nhẹ Thời Trang",74260,79000,4740,6
TIKI,thoi-trang-nam,41654783,"Áo Len Cổ Lọ Nam Phong Cách Hàn Quốc Siêu Ấm SAL222",118000,118000,0,0
TIKI,thoi-trang-nam,113166943,"Áo sơ mi nam cổ tàu dài tay màu đen",142800,142800,0,0
TIKI,thoi-trang-nam,179163530,"(big size<130kg) Áo sơ mi nam tay dài big size màu đen",185000,185000,0,0
TIKI,thoi-trang-nam,188916571,"Tất nam cổ trung Fasvin mềm mịn co giãn tốt TN21902.HN",19000,36000,17000,47
TIKI,bach-hoa-online,73622134,"Thịt Bò 2 Lát Hạ Long - 150g",22950,25500,2550,10
TIKI,thoi-trang-nam,159382275,"Áo polo nam trơn cổ bẻ - Áo thun nam vải cá xấu cotton tay ngắn thoáng mát<Hàng Cao Cấp",79000,79000,0,0
TIKI,thoi-trang-nam,196184514,"Áo Blue, Blouse trắng Dáng Ngắn Ngang Đùi Nam Nữ Dài Tay, Cộc Tay Hàng Đẹp Loại 1 Dành Cho Y Tá, Dược Sĩ, Điều Dưỡng",138000,138000,0,0
TIKI,bach-hoa-online,94426094,"Trà Xanh Túi Lọc Tân Cương Xanh - Trà túi lọc thượng hạng, dùng pha chế, tiện lợi dùng văn phòng, đi công tác",52500,52500,0,0
TIKI,thoi-trang-nam,174301048,"Quần Kaki Nam Ống Suông Cao Cấp Chất Liệu Co Dãn Dáng Âu Phong Cách Công Sở Thương Hiệu CHANDI JK1",194000,229000,35000,15
TIKI,thoi-trang-nam,125784347,"Quần bơi lững nam 881(30-100kg)",60000,60000,0,0
TIKI,thoi-trang-nam,73365866,"Bộ 10 Quần Lót Nam vải cotton 2 chiều co giãn nhiều lưng hiệu CITYMEN, màu ngẫu nhiên, đồ lót - LMTK-MULTI2C",180000,180000,0,0
TIKI,bach-hoa-online,137527721,"Bỉm cho chó mèo thú cưng - hahale -familypetshop.vn",6000,9000,3000,33
TIKI,bach-hoa-online,198205553,"Áo Tết cho chó mèo, áo dài Tết vải gấm cho thú cưng",109000,109000,0,0
TIKI,thoi-trang-nam,183682463,"ÁO LÓT NGẮN TAY CATRIO là áo phông trắng, áo thun ngắn tay cho bố, ông, người trung tuổi, vải 100̀% cotton mặc lót bên trong áo sơ mi, mặc ở nhà, đi ngủ",65000,65000,0,0
TIKI,bach-hoa-online,42989489,"Bột Chanh Gia Vị 400g (Chavi - Bao bì mới)",106000,106000,0,0
TIKI,thoi-trang-nam,139002166,"Quần jean Baggy ống suông, rộng nam, nữ TR01 hottrend hàn quốc 2021",115000,115000,0,0
TIKI,thoi-trang-nam,171451574,"Quần Sọt Nam, Quần Short Tây Âu Nam Co Giãn Nhẹ Dáng Ôm, Quần Ngố Nam Lịch Sự Phù Hợp Dạo Phố Du Lịch Thương Hiệu Chandi Mã TA19",132050,139000,6950,5
TIKI,thoi-trang-nam,179161990,"(big size < 130kg) sơ mi nam tay dài màu xanh đen big size",185000,185000,0,0
TIKI,thoi-trang-nam,58587472,"quần âu nam công sở dạo phố cao cấp co giãn nhẹ, quần tây nam dáng ôm",119000,119000,0,0
TIKI,thoi-trang-nam,178577763,"Áo khoác bóng chày form rộng vải dù cao cấp ️Áo Khoác Dù 2 Lớp PENTA.Q Ulzzang Nam Nữ Unisex Form Rộng Bomber Jacket",100000,100000,0,0
TIKI,thoi-trang-nam,196389374,"Combo 2 Quần lót nam boxer CITYMEN lưng Sọc vải thun lạnh 4 chiều - Giao màu ngẫu nhiên",80000,80000,0,0
TIKI,thoi-trang-nam,197629108,"COUPLE TX - Áo Khoác Nam Dù Trượt Nước Ombre Loang Màu MOP 1023",799000,799000,0,0
TIKI,thoi-trang-nam,169569534,"Áo bơi tay dài nam hàng cao cấp thun xịn đường kim mũi chỉ chắc chắn",230500,230500,0,0
TIKI,thoi-trang-nam,68630251,"Quần bơi nam Lan Hạnh 50123-DE0103",238000,238000,0,0
TIKI,thoi-trang-nam,89631305,"ÁO SƠ MI CARO ĐỦ MÀU NAM NỮ",92000,92000,0,0
TIKI,thoi-trang-nam,196313090,"Áo khoác dù chống nắng nam, có 3 ngăn túi khóa kéo nón có thể tách rời tiện lợi - FORMENSHOP - FMTHT050",159000,300000,141000,47
TIKI,thoi-trang-nam,24864749,"Quần Tây Âu Màu Trơn Cho Nam",90000,90000,0,0
TIKI,thoi-trang-nam,77745744,"Quần Lót Nam nhiều lưng co giãn 2 chiều vải cotton hiệu CITYMEN, màu ngẫu nhiên, đồ lót - LMTK-MULTI2C",15000,15000,0,0
TIKI,thoi-trang-nam,190355591,"Combo 3 quần lót boxer nam CITYMEN lưng Hàn Quốc cao cấp vải lạnh co dãn 4 chiều mềm mại thoáng khí thấm hút tốt, quần xịp sịp đùi nam - Giao màu ngẫu nhiên",140000,140000,0,0
TIKI,thoi-trang-nam,164011222,"Áo Sơ Mi Nam Công Sở Trung Niên Dài Tay Thương Hiệu Anton màu Nâu Đậm Vải Cotton - YAC128",215000,215000,0,0
TIKI,thoi-trang-nam,15992824,"Áo Khoác Nam Áo Khoác Dù Nam Cao Cấp-AD27",159000,270000,111000,41
TIKI,thoi-trang-nam,57758774,"Quần short nam có Big Size 115kg lưng thun co giãn 4 chiều ,quần đùi nam thể thao cao cấp ShopN6 - QSB1 (sọc ngẫu nhiên)",59000,105000,46000,44
TIKI,thoi-trang-nam,125996824,"Quần Ống Rộng Quần Jeans Baggy Quần Jean Nam Quần Bò Ống Đứng Style 2021",59000,59000,0,0
TIKI,thoi-trang-nam,109956995,"QUẦN KAKI NAM MÀU ĐEN TÚI MỸ VIỀN",150000,150000,0,0
TIKI,thoi-trang-nam,146289287,"Áo thun nam có cổ ngắn tay phối tay hoạ tiết sang trọng, phù hợp với mọi lứa tuổi - FORMEN SHOP - FMPS160",159000,250000,91000,36
TIKI,thoi-trang-nam,163552063,"Áo Thun Nam PoLo Ngắn Tay Có Cổ Kiểu Dáng Thời Trang Cao Cấp AVIANO",129000,258000,129000,50
TIKI,thoi-trang-nam,110948866,"Quần đùi nam chất kate cotton thương hiệu Fezzio chính hãng",64500,129000,64500,50
TIKI,thoi-trang-nam,106714415,"Combo 3 quần đùi nam May 10 loại có túi 2 bên",195000,195000,0,0
TIKI,thoi-trang-nam,7189521,"Bộ 2 Quần Boxer Đúc Nam Nhật Bản - 5Star",85000,85000,0,0
TIKI,the-thao-da-ngoai,169731291,"Set đồ tập yoga - tập gym PYM Sports - PYMS005 áo croptop tay lửng buộc vạt sau eo, quần dáng alibaba - 2 màu đen và đỏ",225000,450000,225000,50
TIKI,the-thao-da-ngoai,149635797,"{Xả kho} máy câu cá yomoshi AL 3000-7000",45200,45200,0,0
TIKI,the-thao-da-ngoai,127201377,"HỘP QUẸT BẬT LỬA Z660 HỘP QUÀ CAO CẤP",264000,264000,0,0
TIKI,the-thao-da-ngoai,107034349,"Vòng treo gỗ Gymnastic Rings Cleacco có vạch kẻ số , khóa cài thông minh tiện lợi , chắc chắn treo xà đơn , các bài tập dip rings , street workout , bảo hành 12 tháng - BORO SPORT",499000,799000,300000,38
TIKI,the-thao-da-ngoai,97883098,"Áo tập gym nữ, áo tanktop phối lưới lưng siêu đẹp (TY)",125000,125000,0,0
TIKI,the-thao-da-ngoai,45777072,"Combo Bao trụ đấm bốc tự đứng thế hệ mới + Găng tay đấm bốc mma hở ngón cao cấp - Thiết bị tập đấm bốc chuyên nghiệp dành cho boxing, mma, muay, sparring, trainning, và đối kháng",1700000,1700000,0,0
TIKI,the-thao-da-ngoai,69307352,"Quần short nam thể thao đồ gym thun cotton 4 chiều, quần đùi nam mặc nhà thể thao cao cấp ShopN6 - QSB2 (Nhiều Màu)",59000,105000,46000,44
TIKI,the-thao-da-ngoai,33789344,"Bộ Ván trượt mặt nhám cỡ nhỏ trẻ em + Kèm bộ bảo hộ (Giao màu ngẫu nhiên)",269000,400000,131000,33
TIKI,the-thao-da-ngoai,76753500,"Bảng Dụng Cụ Tập Hít Đất , Tập Chống Đẩy Theo Màu Sắc, Mỗi Màu Sắc Sẽ Tương Ứng Với Bài Tập Khác Nhau Thiết Kế Dày Nhiều Bài Tập - Hàng Chính Hãng BORO SPORT",164000,389000,225000,58
TIKI,the-thao-da-ngoai,117391128,"máy câu cá yomoshi.máy câu LC7000 .máy câu cá yomoshi LC-7000",139000,139000,0,0
TIKI,the-thao-da-ngoai,186748592,"[HÀNG CÓ SẴN][CAIRBULL] Nón Bảo Hiểm Xe Đạp Thoáng Khí Dành Cho Nam Nữ Đạt Tiêu Chuẩn, An Toàn, Chất Lượng Chính Hãng_Rubik/Mũ Bảo Hiểm Đi Xe Đạp Leo Núi Chuyên Nghiệp",330000,550000,220000,40
TIKI,the-thao-da-ngoai,2066915,"Viên sủi điện giải  -  Hammer  Nutrition Endurolytes Fizz Vị  Chanh HM299",179000,179000,0,0
TIKI,the-thao-da-ngoai,160744859,"Giày Chạy Bộ Nam Biti's Hunter Running TIGER DSMH08300CAM (Cam)",903000,981000,78000,8
TIKI,the-thao-da-ngoai,156039630,"Bộ cần câu tay trúc nâu dài 2m7, 3m6, 4m5, 5m4, 6m3 kèm đủ phụ kiện",86120,86120,0,0
TIKI,the-thao-da-ngoai,118324307,"Phao bơi naturehike đồ cắm trại thể thao du lịch kiêm túi tắm chống nước phao hồ bơi campout A070",550000,550000,0,0
TIKI,the-thao-da-ngoai,149618003,"Phao Câu Đài_ Bộ 3 Phao Câu Đài Nano_ Phao Kim Câu Cá",54000,54000,0,0
TIKI,the-thao-da-ngoai,91750863,"Máy Chạy Bộ,Máy Đi Bộ Trên Không Cỡ Lớn DNS008 Đại Nam Sport Chịu Lực 150kg Hàng Việt Nam Chất Lượng Cao",1399000,2000000,601000,30
TIKI,the-thao-da-ngoai,194864438,"[Chính hãng] OstroVit BCAA Instant (400g) Hỗ trợ phục hồi - Chống dị hóa - Giảm đau nhứt cơ",420000,420000,0,0
TIKI,the-thao-da-ngoai,187057014,"Cần câu đài Hắc Điếu Sư độ dài từ 4m5 đến 12m độ cứng 8H mã CD35",690000,690000,0,0
TIKI,the-thao-da-ngoai,154944451,"ô dù câu cá 1m8 xoay 360° cao cấp",147346,147346,0,0
TIKI,the-thao-da-ngoai,103209804,"Vợt Cầu Lông Cán Liền Chính Hãng Agnite - Khung Carbon Cao Cấp - Kèm Túi Đựng Vợt - F2115",359000,790200,431200,55
TIKI,the-thao-da-ngoai,117002169,"Dây Kéo Đàn Hồi Tập Tay Vai Hình Số 8 - YOGA QG, Chất Liệu Cao Su Dẻo Dai, Đàn Hồi Tốt, Giúp Bạn Có Một Cơ Thể Cân Đối, Khỏe Mạnh",33000,44900,11900,27
TIKI,the-thao-da-ngoai,2282609,"Bộ Đá Và Bấc Cho Bật Lửa Zippo",90000,90000,0,0
TIKI,the-thao-da-ngoai,148925566,"CẦN CÂU CÁ 8h  HAN-DING",305495,305495,0,0
TIKI,the-thao-da-ngoai,36710696,"Móc khoá đa năng tiện ích",98000,98000,0,0
TIKI,the-thao-da-ngoai,165640986,"Móc Khóa Kèm Dao Mini Có Túi Đựng",55000,59000,4000,7
TIKI,the-thao-da-ngoai,67240015,"Bộ Dây Cao Su Đàn Hồi Ngũ Sắc Tập Gym Tại Nhà Móc To (Tặng kèm Kìm Bóp Cơ Tay) Bộ Dây Kháng Lực Tập Thể Hình Ngẫu Nhiên Dành Cho Mọi Đối Tượng Dễ Dàng Sử Dụng Có Hướng Dẫn Đi Kèm",195000,209000,14000,7
TIKI,the-thao-da-ngoai,21388705,"Túi Đai Đeo Bụng Chạy Bộ Chống Nước Có Dải Phát Quang",32670,47190,14520,31
TIKI,the-thao-da-ngoai,8582344,"Bộ 2 tạ nhựa tay 10kg",160000,265000,105000,40
TIKI,the-thao-da-ngoai,139912196,"Mồi giả ruồi nhỏ chuyên câu cá rô cá lóc cá chuối  cá thiểu  cá chim",21660,21660,0,0
TIKI,the-thao-da-ngoai,100270977,"Lưỡi Câu Cá Titan 7 Màu CJF Có Ngạnh Đuôi Dẹp siêu cứng, siêu bén",45000,45000,0,0
TIKI,the-thao-da-ngoai,179445531,"Túi đeo bụng, đai đeo điện thoại chạy bộ chính hãng Goodfit GF10X chống nước, phản quang, sức chứa lớn",129000,199000,70000,35
TIKI,the-thao-da-ngoai,163741693,"Túi Đựng Cần Câu Gấp Gọn Túi Đựng Cần Câu Có Túi Phụ, Đồ ĐỰng Cần Câu Cá",45000,45000,0,0
TIKI,the-thao-da-ngoai,103209960,"[TẶNG 3 CẦU + QUẤN CÁN] Vợt cầu lông siêu nhẹ Agnite tặng kèm hộp cầu và túi đựng vợt - 2 chiếc - F2136",466200,466200,0,0
TIKI,the-thao-da-ngoai,140744653,"100 Quả Bóng Bàn Tập Luyện Hueison / Loki 3 sao 40+ - Hàng Chính Hãng",180000,180000,0,0
TIKI,the-thao-da-ngoai,117391753,"cần câu tay xích long 6H catbon tặng ngọn phụ",161000,161000,0,0
TIKI,the-thao-da-ngoai,273868091,"Sữa Tăng Cân Labrada Muscle Mass Gainer 12Lbs (5.4kg), Hỗ Trợ Tăng Cân Tăng Cơ Nhanh",1595000,1920000,325000,17
TIKI,the-thao-da-ngoai,163863432,"Cước Câu Cá Tàng Hình Nylon CF Dây Câu Cá 500m Siêu Bền, Dây Dù Câu Cá",143100,143100,0,0
TIKI,the-thao-da-ngoai,52247278,"Áo tập Yoga Gym croptop 2 dây đan chéo Hibi Sports Mã CR806 có mút nâng ngực bên trong",182000,260000,78000,30
TIKI,the-thao-da-ngoai,139830479,"Nutrex Outlift Pre-Workout 30 Liều, Tăng Sức Mạnh Sức Bền, Năng Lượng Trước Tập, Citrulline, BCAA, Creatine, Beta-Alanine, Taurine",990000,1150000,160000,14
TIKI,the-thao-da-ngoai,139948349,"Bình Nước Thể Thao Giữ Nhiệt 500ml INOX Không Gỉ Gắn Trên Xe Đạp / Ô tô / Xe Hơi Có Ống Hút",155000,155000,0,0
TIKI,the-thao-da-ngoai,63582110,"Vòng Lắc Eo Giảm Mỡ Bụng, Vòng Lắc Eo Thon Massage Giảm Mỡ Bụng - Hàng Chính Hãng (màu ngẫu nhiên)",119000,119000,0,0
TIKI,the-thao-da-ngoai,157970644,"Đĩa Xoay Eo - YOGA QG, Có Hình Bàn Chân, Xoay 360 Độ, Thiết Kế Nhỏ Gọn, Tiện Dụng, Chất Lượng Chịu Lực Cao Cấp, Có Hạt Massage Giúp Lưu Thông Khí Huyết - Hàng chính hãng",59000,65000,6000,9
TIKI,the-thao-da-ngoai,134843549,"Gạch Tập Yoga Chọn Màu Chính Hãng Amalife Cao Cấp – Gối Tập Yoga Gạch Yoga Loại Nặng",39000,39000,0,0
TIKI,the-thao-da-ngoai,116806264,"Dụng Cụ Tập Đùi - YOGA QG, Kẹp Tập Cơ Đùi, Gập Tay Chân, Hỗ Trợ Tập Gym, Yoga, Giúp Thu Gọn Bắp Tay, Vòng Đùi",120000,149000,29000,19
TIKI,the-thao-da-ngoai,137016973,"Mồi Câu Cá TRẮM , CHÉP ,TRÔI ,DIẾC ,RÔ PHI Dạng Hạt Siêu Nhạy  - SANAMI FISHING",22987,22987,0,0
TIKI,the-thao-da-ngoai,74227711,"Bg Xe đạp tập thể dục trong nhà Mẫu YS02 BLACK mới 2021 (hàng nhập khẩu)",1588000,1588000,0,0
TIKI,the-thao-da-ngoai,67455374,"Đai lưng tập gym, đai bảo vệ cột sống chống đau lưng thanh nẹp lò xo GoodFit GF722WS",249000,329000,80000,24
TIKI,the-thao-da-ngoai,172411955,"Lưỡi Câu Cá Rô Thép Trắng Đặc Biệt Làm Thủ Công Có Ngạnh Xỏ Lỗ Vỉ 10 Cái Nhiều Kích Thước",27000,27000,0,0
TIKI,the-thao-da-ngoai,58457607,"Bó gối thể thao, băng đầu gối, đai bảo vệ đầu gối tập gym GoodFit đệm bảo vệ dày dặn, silicone chống trượt GF516K",99000,129000,30000,23
TIKI,the-thao-da-ngoai,53405655,"Bộ 3 dây kháng lực tập cơ mông đùi chân Hip Resistance bands Aolikes YE-3604",149000,149000,0,0
TIKI,the-thao-da-ngoai,17904209,"Găng tay thủ môn Reush Xanh đen",249000,249000,0,0
TIKI,the-thao-da-ngoai,9840511,"Combo 5 cuộn cuốn cán vợt cầu lông, tennis chính hãng VS (màu ngẫu nhiên)",49000,87000,38000,44
TIKI,the-thao-da-ngoai,175146761,"Phao tập bơi liền thân cho bé 2-10 tuổi, Áo phao tập bơi trẻ em, Phao tay đỡ ngực bé trai bé gái - Chính hãng MINIIN (Giao họa tiết, mẫu ngẫu nhiên)",148000,175000,27000,15
TIKI,the-thao-da-ngoai,57789702,"Set đồ tập Yoga Gym 8 dây Thiết kế cao cấp Hibi Sports Mã H101 - Áo bra 8 dây - Quần lưng cao phối lưới tôn dáng - Áo có mút nâng ngực",329000,420000,91000,22
TIKI,the-thao-da-ngoai,133168110," Bình Nước Thể Thao Cao Cấp Đựng Nước Nóng Lạnh Dung Tích 750ml ",105000,105000,0,0
TIKI,the-thao-da-ngoai,91754469,"Con Lăn Tập Cơ Bụng Thế Hệ Mới Trợ Lực Bằng Lò Xo Kép Chính Hãng Đại Nam Sport + Kèm Tấm Thảm Lót",286000,550000,264000,48
TIKI,the-thao-da-ngoai,163677665,"Redcon1 Isotope Whey Isolate (71 Serings), Hỗ Trợ Tăng Cơ - Đốt Mỡ, Hấp Thu Nhanh, Bổ Sung 25g Protein, 13.5g EAA, 6.4g BCAA, Không Lactose, Hộp 5Lbs (2.4Kg)",1650000,1890000,240000,13
TIKI,the-thao-da-ngoai,146553463,"Dây Ngũ Sắc Tập Gym Chính Hãng dododios - Bộ 5 Dây Ngũ Sắc Đàn Hồi Tập Thể Hình Đa Năng Tại Nhà",215000,215000,0,0
TIKI,the-thao-da-ngoai,146281703,"Quả Bóng Rổ Da Molten Gg7X Cao Cấp",239000,279000,40000,14
TIKI,the-thao-da-ngoai,4495417,"Bình Nước Thể Thao Gymlink G88 500ml Sportslink (Màu ngẫu nhiên)",70000,77000,7000,9
TIKI,the-thao-da-ngoai,167022842,"Cước câu cá tàng hình dây câu cá Nylon Gofishing tải cá tốt dùng làm dây trục câu cá DC7",28000,28000,0,0
TIKI,the-thao-da-ngoai,169549326,"Set đồ tập yoga gym Luxury Hibi Sports H145 4 dây đan VX, màu Đen và Tím Nhạt kèm mút ngực, vải cao cấp Hi Fabric",649000,950000,301000,32
TIKI,the-thao-da-ngoai,191375822,"Lều cắm trại tự bung , lều du lịch dã ngoại dành cho 3-5 người hoặc 6-8 người, chống thấm nước",945000,945000,0,0
TIKI,the-thao-da-ngoai,147209392,"Tạ Tay Thép King Box Loại 5KG",350000,350000,0,0
TIKI,the-thao-da-ngoai,155230260,"Cần Câu Cá HutsMan , dạng rút , pass cắm máy kim  loại dạng xoáy rất bền , cấu trúc cần khỏe chịu tải  rất tốt ( đồ câu a lâm )",129998,129998,0,0
TIKI,the-thao-da-ngoai,36391594,"Bình Nước Thể Thao Nhựa TRITAN Nắp 2 Lớp Chống Rỉ Nước Kèm Ống Hút",149000,149000,0,0
TIKI,the-thao-da-ngoai,146996011,"Kính Thể Thao Bảo Vệ Mắt - Kính Chơi Thể Thao Cao Cấp dododios - Có Thể Thay Mắt Kính Cho Người Cận",19000,19000,0,0
TIKI,the-thao-da-ngoai,76181551,"Dây kéo lưng hỗ trợ tập deadlift cho người tập gym, dây kéo tạ, dây hỗ trợ lên xà - Lifting Straps",55000,145000,90000,62
TIKI,the-thao-da-ngoai,148937405,"Băng quấn bảo vệ cổ tay tập gym yoga street workout wrist tránh chấn thương cổ tay , tăng khả năng vận động CLEACCO - Hàng chính hãng  BORO SPORT",84000,154000,70000,45
TIKI,the-thao-da-ngoai,184281596,"Đèn LED COB Mini 800 Lumens Có Móc Khóa Di Động Đa Ứng Dụng",35000,35000,0,0
TIKI,the-thao-da-ngoai,147999789,"Băng quấn bó gối ( 1 cái ) bảo vệ đầu gối , khớp gối 2 trong 1 , Giúp tránh chấn thương , tăng khả năng vận động linh hoạt CLEACCO  - Hàng chính hãng BORO SPORT",112000,194000,82000,42
TIKI,the-thao-da-ngoai,188915910,"Quần đùi nam ngắn chạy bộ Fasvin R21451.HN vải Dù Gió nhẹ mát tiện dụng thể thao hay mặc nhà",85000,138000,53000,38
TIKI,the-thao-da-ngoai,25066058,"Kính Bơi Nam Nữ Người Lớn Cao Cấp miDoctor",72000,72000,0,0
TIKI,the-thao-da-ngoai,197641742,"Thảm Picnic Du Lịch Dã Ngoại Gấp Gọn Chống Thấm Nước-CL022",342000,342000,0,0
TIKI,the-thao-da-ngoai,113912889,"Dây dù tròn bền,chắc 28m dây loại tốt không tơi (buộc đồ,cắm trại,leo núi...)",22000,22000,0,0
TIKI,the-thao-da-ngoai,52021481,"Giày Trượt Patin Trẻ Em Cougar 835L",699000,699000,0,0
TIKI,the-thao-da-ngoai,88074604,"Bao, Túi đựng Điện Thoại tới 6.5 Inch Đeo tay chạy bộ ,Tập thể dục Rhino B101 Kháng nước, chống thấm, có thể cắm tai nghe phù hợp điện thoại Samsung, Iphone, Sony, Xiaomi,... - Hàng chính hãng",82000,99000,17000,17
TIKI,the-thao-da-ngoai,189465174,"Xà Đơn Gắn Cửa FED-0228 | Kích thước 90-115cm (Chịu lực 400kg - Có chốt khóa an toàn khi gắn xà - Dễ dàng tháo lắp không cần khoan tường)",585000,690000,105000,15
TIKI,the-thao-da-ngoai,53598503,"Đá zippo chính hãng mỹ mẫu mới",45000,45000,0,0
TIKI,thoi-trang-nam,141109930,"Quần jogger unisex thể thao, quần ống rộng kiểu dáng jogger mặc nhà nam nữ vải TỔ ONG 3 màu năng động",83000,83000,0,0
TIKI,thoi-trang-nam,172120849,"Áo Polo Nam kiểu dáng Vintage Slub hãng JohnSton&Murphy hàng xuất Mỹ đủ màu phù hợp cả trang phục công sở lịch lãm",375000,375000,0,0
TIKI,thoi-trang-nam,107338883,"Áo thun Nam Nữ Vonesa, áo phông Unisex Nam Nữ có Size từ 25-84kg B7",40000,40000,0,0
TIKI,thoi-trang-nam,113233457,"Quần đùi nam xuất khẩu, quần đùi mặc nhà chất kate cotton cao cấp  thương hiệu Fezzio",42500,85000,42500,50
TIKI,thoi-trang-nam,31594559,"Áo khoác da cá GOKING 6 túi, form unisex cho nam nữ, trẻ em. Áo chống lạnh, giữ ấm, chống nắng. Hàng hiệu cao cấp vnxk",295000,295000,0,0
TIKI,thoi-trang-nam,66683004,"Áo Khoác Nam Vải Kaki 2 Lớp Mặc Bốn Mùa Kiểu Dáng Thời Trang",474050,499000,24950,5
TIKI,thoi-trang-nam,75945178,"áo hoodie hoạt hình, áo hoodie cute, áo hoodie han quốc, áo hoodie cá tính, áo hoodie nam nữ, áo hoodie nữ, áo hoodie nam, áo hoodie ulzzang, áo hoodie unisex",100000,100000,0,0
TIKI,thoi-trang-nam,83489010,"Áo Khoác Nam, Khoác Dù Nam 2 lớp phối nón thời trang hàn quốc trẻ trung cuốn hút Thương Hiệu Chandi chất liệu thấm hút mồ hôi dày dặn mặc thoáng mát mẫu M123",143000,299000,156000,52
TIKI,thoi-trang-nam,100868615,"Áo sơ mi FLANNEL kẻ caro Unisex phong cách streetswear, Kẻ Caro Nam Nữ Form rộng Phong Cách, Áo Sơ Mi Khoác Ngoài Cao Cấp Siêu Đẹp, Áo khoác sowmi unisex form rộng CARO nam nữ phong cách ulzzang",95000,95000,0,0
TIKI,thoi-trang-nam,176789536,"Áo bơi tay ngắn nam 401",119000,119000,0,0
TIKI,thoi-trang-nam,19639438,"quần jean dài nam trơn thời trang",110000,110000,0,0
TIKI,thoi-trang-nam,14450071,"Quần Bò Nam Đen Rách Gối RACHGOI97 (Rách Gối)",168000,168000,0,0
TIKI,thoi-trang-nam,181113990,"Áo polo nam có cổ cao cấp LADOS-9089 thêu đầu hươu, phối 2 màu trắng đen sang trọng, thoáng khí siêu mát mẻ",169000,318000,149000,47
TIKI,thoi-trang-nam,59556296,"Combo 3 Chiếc Quần Lót Nam Cao Cấp Aristino ABF01807 Chất liệu Cotton Chitosan Thuần Khiết (Giao Màu Ngẫu Nhiên) - Hàng Chính Hãng",255000,315000,60000,19
TIKI,thoi-trang-nam,74385119,"Áo Khoác Nam Big Size Áo Khoác Dù Nam Hai Lớp Cổ Cao Chống Nắng Chống Lạnh Chống Gió Chống Tia UV Hàn Quốc Cao Cấp QD62 - ShopN6 (Nhiều Màu)",135000,240000,105000,44
TIKI,thoi-trang-nam,87094676,"Bộ bơi đôi dài tay Nam và Nữ, set 3 chi tiết quần dài chống nắng, đồ bơi cho couple, có size nhỏ cho bé mặc đồ gia đình | KT022 | BN022",520000,520000,0,0
TIKI,thoi-trang-nam,13677604,"Áo khoác nam không bo lai Phúc An 2026",195000,195000,0,0
TIKI,thoi-trang-nam,98986504,"Áo thun Teeworld Sài Gòn - Everything you need to know Form Rộng Unisex Nam Nữ",299000,299000,0,0
TIKI,thoi-trang-nam,74554228,"Áo Khoác Big Size Áo Khoác Dù Dày Bomber Nam Nữ Chống Nắng Chống Lạnh Chống Gió Lót Nỉ Hai Lớp Hàn Quốc Cao Cấp QD66 - ShopN6",155000,235000,80000,34
TIKI,thoi-trang-nam,13629284,"Quần Short unisex Nam Cotton SV2",63000,63000,0,0
TIKI,thoi-trang-nam,174001966,"Quần Jean nam Leman xanh trơn JD03 - Slim Form",455000,549000,94000,17
TIKI,thoi-trang-nam,190154616,"Quần kaki dài nam việt tiến màu xám sáng có 1ly và không ly 6R6013 - 6R6012 Regular",785000,785000,0,0
TIKI,thoi-trang-nam,72747384,"Áo khoác dù nam form rộng",127900,127900,0,0
TIKI,thoi-trang-nam,31202048,"Quần tây nam không ply ống đứng Khatoco Q1M528R0-CNMA032-2105-0",422400,528000,105600,20
TIKI,thoi-trang-nam,163896997,"Áo Sơ Mi Nam Trắng Trơn Dài Tay Công Sở Trung Niên Thương Hiệu Anton Vải Nano Chống Nhăn - SRD05",295000,355000,60000,17
TIKI,thoi-trang-nam,130029611,"Áo Hoodie Nỉ Nam Nữ From Rộng Unisex In Dạ Quang Phát Sáng Hình Gấu Cực Hot Chất Nỉ Ngoại Dày Dặn (bear)",113000,113000,0,0
TIKI,thoi-trang-nam,75358011,"Big size, short kaki lưng thun unisex, quần sọt nam thương hiêu Amazing, phong cách thể thao",159000,239000,80000,33
TIKI,thoi-trang-nam,193976862,"Quần Jean nam Leman xanh mài rêu JD12 - Slim Form",455000,549000,94000,17
TIKI,thoi-trang-nam,98624377,"Quần Sọt Nam ️️ Quần Short Jean Nam Đen Phối Rách Chất Bò Cao Cấp Chuẩn Hàng Shop Tô Tồ Shop - QSJNM232",138000,138000,0,0
TIKI,thoi-trang-nam,197675716,"Áo sơ mi nam dài tay màu đen dáng suông May 10 mã 010122912L2",295000,295000,0,0
TIKI,thoi-trang-nam,169621343,"Viettien - Áo sơ mi nam ngắn tay họa tiết vạt bầu 1N1868 regular",395000,395000,0,0
TIKI,thoi-trang-nam,67201856,"Set 2 áo ba lỗ nam, áo 3 lỗ nam, sợi cotton mềm mịn, thấm hút mồ hôi tốt, thoáng mát, mặc thoải  mái",36000,36000,0,0
TIKI,thoi-trang-nam,196603717,"Quần tây nam 0Ply Novelty màu đen Regular fit NQTMMDNTRR2202880",479000,479000,0,0
TIKI,thoi-trang-nam,150748227,"Áo Thể Thao Nam TSIMPLE cổ tròn tay ngắn tập gym vải thun lạnh thoáng mát co giãn chuẩn form MSSAHP5",165000,165000,0,0
TIKI,thoi-trang-nam,111990270,"Quần Kaki Nam Đẹp Dáng Hàn Lưng Thun Tiện Dụng Form Slim Fit Cực Đẹp QK045",103000,103000,0,0
TIKI,thoi-trang-nam,84872072,"Set đồ bơi nam full 5 chi tiết kèm túi đựng, Quần bơi da cá + Kính bơi + Mũ + Bịt tai + Kẹp mũi, hàng xịn đẹp chuẩn | BN009",320000,320000,0,0
TIKI,thoi-trang-nam,52863921,"Áo vest nam phong cách Hàn Quốc nhiều màu",185000,185000,0,0
TIKI,thoi-trang-nam,195192891,"Quần Gió Nam Thể Thao FASVIN Vải Gió Đẹp Hàng Nhà Máy Chất Lượng Cao Dùng Khi Thể Thao Hay Mặc Nhà DC20423.HN",185000,298000,113000,38
TIKI,thoi-trang-nam,92807600,"Quần short kaki Amazing, lưng thun có giây rút, vải kaki dày dặn, co giãn nhẹ, nhiều màu, có size lớn",159000,239000,80000,33
TIKI,thoi-trang-nam,160407346,"Viettien - Quần dài kaki nam màu xám sáng có 1ly regular 6Q6051",630000,630000,0,0
TIKI,thoi-trang-nu,68961617,"Quần lót nữ lọt khe xẻ đáy",33000,33000,0,0
TIKI,thoi-trang-nu,44336042,"ÁO LÓT SU NỮ, MỀM, MỊN, THOÁNG MÁT SIÊU ĐẸP ALS01",69000,69000,0,0
TIKI,thoi-trang-nu,104794829,"Quần lót 1407 - Free size Form XL - Quần chip big size, vải mềm mặc thoải mái",35000,35000,0,0
TIKI,thoi-trang-nu,167652790,"Bộ đồ bơi đôi dài tay nam nữ khoá kéo đen lườn xanh 5 mảnh siêu xịn",550000,550000,0,0
TIKI,thoi-trang-nu,140138812,"Váy đầm nữ bidy sườn xám in họa tiết",156000,156000,0,0
TIKI,thoi-trang-nu,93046821,"Chân váy chữ A ngắn xẻ trước kèm quần trong vải tuyết mưa 3 màu",62000,62000,0,0
TIKI,thoi-trang-nu,84826202,"Áo Bralette Cotton Siêu Mỏng Dây Chéo Không Móc, Áo Lót Không Gọng Không Đệm Mềm Mịn Tự Nhiên Cá Tính B246",81000,81000,0,0
TIKI,thoi-trang-nu,120421062,"Áo chống nắng toàn thân nữ vải bò Jean 2 lớp dài kín chân - ao chong nang toan than nu vai bo 2 lop",349000,349000,0,0
TIKI,thoi-trang-nu,88769661,"Đồ bơi đôi nam nữ đi biển đẹp, phong cách trẻ trung, áo khoác khóa dài tay, quần sooc đùi thể thao, nữ có áo trong | BN021 | KT021",350000,350000,0,0
TIKI,thoi-trang-nu,103356842,"Quần Lọt Khe Nữ Ren SEXY C41 - Quần lót lọt khe cotton - Quần lọt khe siêu sexy - Quần lót xuất xịn",33000,33000,0,0
TIKI,thoi-trang-nu,192862109,"Quần jeans nữ suông đứng rách gối HQJeans mẫu mới nhất",350000,350000,0,0
TIKI,thoi-trang-nu,176529912,"Áo khiêu vũ Latin co giãn thấm hút mồ hôi cực tốt mặc được 2 mặt siêu đẹp",150000,150000,0,0
TIKI,thoi-trang-nu,76463862,"Áo Nịt Ngực Dây Kéo Trước Cao Cấp Dành Cho Tomboy SB Trans - Áo Lót Bó Ép Nịt Làm Nhỏ Ngực Tomboy Thể Thao Gym Thun Ba Lỗ Gen Thun Không Viền Dây Khóa Kéo Trước Bigsize Nguyễn Nguyên",299000,299000,0,0
TIKI,thoi-trang-nu,71074020,"Combo 2 Quần Lót Nữ Modal Phối Ren Trước Remix - Màu Trắng & Hồng FCM0204-1204",86000,210000,124000,59
TIKI,thoi-trang-nu,39969258,"Quần lót nữ sexy - màu xanh",25000,25000,0,0
TIKI,thoi-trang-nu,112084786,"GOTI – Áo Kiểu Nữ Thời Trang Công Sở - Áo Sơ Mi Trắng Nữ Dáng Rộng Kiểu Áo Lụa Nữ Cao Cấp 3A10",229000,229000,0,0
TIKI,thoi-trang-nu,125415293,"Áo Khoác dây kéo viền trắng/ Hoodie Zip WEST {màu Đen/ Xanh/ Hồng} Form rộng Unisex Nam/Nữ cực đẹp chất xịn",106000,106000,0,0
TIKI,thoi-trang-nu,115707331,"Đầm body 2 dây, váy nữ body hở lưng màu đen cá tính",87000,87000,0,0
TIKI,thoi-trang-nu,70565482,"Áo Lót Nữ Mút Vừa Móc Cài Trước Không Gọng Nâng Ngực Trơn (Mustoto MA09)",299000,299000,0,0
TIKI,thoi-trang-nu,104793958,"Quần lót Thái lan 1406 - Free size Form XL - Quần chip bigsize, vải mềm mặc thoải mái",35000,35000,0,0
TIKI,thoi-trang-nu,83033887,"Quần Gen Bụng Cạp Cao Dáng Đùi Mặc Váy Chống Cuộn Chống Gập",175000,180000,5000,3
TIKI,thoi-trang-nu,55038758,"Áo sơ mi nữ cổ bèo tay búp sen, chất vải cát mềm mịn thích hợp mùa hè, thời trang trẻ, phong cách Hàn Quốc",50000,50000,0,0
TIKI,thoi-trang-nu,101949462,"Combo 10quần 10màu siêu sốc",140000,140000,0,0
TIKI,thoi-trang-nu,98079800,"Đồ bộ dạo phố mặc nhà nữ áo thêu chữ quần sọc caro thun cotton mát mịn trẻ trung năng động size từ 40-64kg",99000,99000,0,0
TIKI,thoi-trang-nu,188834786,"Quần độn hông và mông Lylylorem QD001",258000,258000,0,0
TIKI,thoi-trang-nu,87670677," Áo Chống Nắng 6 Túi Cao Cấp Vải Cotton (L02IM)",163000,163000,0,0
TIKI,thoi-trang-nu,108926855,"Áo vải lưới móc gài hông trái Tomboy Transguy",118000,118000,0,0
TIKI,thoi-trang-nu,160825055,"[KIM VÀNG] Bộ đồng phục y tá, spa, điều dưỡng đồng phục bệnh viện tay ngắn chất liệu kaki thun - Màu xanh két",450000,450000,0,0
TIKI,thoi-trang-nu,161978910,"Bộ đồ lót đồ ngủ liền thân voan hoa xuyên thấu cao cấp sexy",199000,199000,0,0
TIKI,thoi-trang-nu,121748552,"Áo len nữ,áo len lưới mỏng ngắn tay thu đông AH30",199000,199000,0,0
TIKI,thoi-trang-nu,86881225,"( HÀNG SẴN) Áo Phao Nữ Ngắn Siêu Nhẹ Trung Niên Thanh Lịch AK112 - Hàng Quảng Châu Cao Cấp ( (Ảnh thật cuối hình)",325000,325000,0,0
TIKI,thoi-trang-nu,112810572,"Áo Thun Dài Tay Cổ Tròn, Ống Tay Bo, Dáng Suông Chất Vải Mềm Mịn Freesize AT02",58000,58000,0,0
TIKI,thoi-trang-nu,196230849,"Áo phông - áo thun form rộng nữ tay lỡ Bảo Bảo Store, áo polo nữ có cổ màu xanh nhạt hot nhất 2022",73000,100000,27000,27
TIKI,thoi-trang-nu,97238349,"chân váy công sở xếp ly đính khuy 3 màu xinh xắn",65000,65000,0,0
TIKI,thoi-trang-nu,119613886,"Áo Bra Thun Gân Len Tăm Khoét Lưng Chữ U Siêu đẹp",55000,55000,0,0
TIKI,thoi-trang-nu,163803666,"Áo kiểu nữ M12",90000,95000,5000,5
TIKI,thoi-trang-nu,161207989,"Áo Lót Bigsize Không Đệm Không Gọng",234000,234000,0,0
TIKI,thoi-trang-nu,81579779,"Quần Bơi Nữ Ngắn Quần Bơi Rời Short Thun Lạnh Co Giãn Tốt AT212 MayHomes Quần Short Đa Năng Thể Thao, Bơi Lội, GYM, Spa",126490,139000,12510,9
TIKI,thoi-trang-nu,101615200,"Đầm suông linen dáng cơ bản cổ tròn tay lỡ xẻ tà gấu không kén dáng mặc LAHstore - M",250000,250000,0,0
TIKI,thoi-trang-nu,142994286,"Áo croptop tay dài cổ vuông ôm nữ , crt thun gân 100% cotton màu trơn đen trắng free size dưới 52 kg",64900,64900,0,0
TIKI,bach-hoa-online,59178463,"Cà phê Sáng tạo 2 (340gr)",80000,86363,6363,7
TIKI,bach-hoa-online,168561896,"Cà phê Trần Quang NGON cafe sữa uống liền bịch 24 gói",54000,54000,0,0
TIKI,bach-hoa-online,181134349,"Cà Phê Robusta Lâm Đồng Rang Mộc Nguyên Chất- Hộp 250Gr (Dạng Bột)",111000,130000,19000,15
TIKI,bach-hoa-online,179921782,"Nước yến thật BRAND'S Không Đường",439000,439000,0,0
TIKI,bach-hoa-online,184429270,"Bột gạo lứt nguyên chất Goce - 180g (18 gói x 10g)",96000,120000,24000,20
TIKI,bach-hoa-online,1820321,"Bột ngũ cốc dinh dưỡng Calsome hương Sô cô la",63000,70000,7000,10
TIKI,bach-hoa-online,46221303,"Trái cây sấy khô thập cẩm Huynh Đệ Tề Hùng 1kg ( 2 túi 500g)",122550,129000,6450,5
TIKI,bach-hoa-online,181000438,"Đặc Sản Sóc Trăng - Bánh Pía Chay Đậu Xanh Sầu Riêng Tân Huê Viên Lớn 500G, Bánh Pía Sóc Trăng Ăn Chay Không Trứng Muối",94500,105000,10500,10
TIKI,bach-hoa-online,176491668,"Combo 2 chai dầu ăn Ranee Golden 2 lít (2 lít/chai x 2 chai)",179000,270000,91000,34
TIKI,bach-hoa-online,70092877,"Hạt Điều Rang Muối Loại Vỡ Thương Hiệu SK FOOD - Combo 1Kg 2 Hũ",97000,129000,32000,25
TIKI,bach-hoa-online,189604485,"Cà phê phin giấy Robusta Lâm Đồng DalatFarm - Hộp 10 túi x 10 g",105000,110000,5000,5
TIKI,bach-hoa-online,66948978,"Đặc Sản Phan Thiết - NướC MắM Nhỉ Làng Chài Xưa Truyền Thống Nhãn Đỏ Thùng 6 Chai Thủy Tinh 500Ml Cốt Nhỉ Đặc Biệt Vị Đậm Đà Gu Ông Bà Xưa Nước Mắm Nguyên Chất Sạch Nước Mắm Nhĩ Từ Thùng Lều Gỗ 100% Cá Cơm Tươi Muối Tinh Khiết Không Chất Bảo Quản",420000,590000,170000,29
TIKI,bach-hoa-online,165947055,"Hạnh Nhân Mỹ Tách Vỏ Pams, Rang Nguyên Vị, Ăn Kiêng Giảm Cân, Ngũ Cốc Dinh Dưỡng Bà Bầu",122000,225000,103000,46
TIKI,bach-hoa-online,64648273,"Lược Chải Lông Vệ Sinh Chó Mèo Màu Ngẫu Nhiên [Tặng Móc Dán Tường Treo Đồ]",38888,38888,0,0
TIKI,bach-hoa-online,8021230,"Ngũ cốc hoa quả Calbee Furugura Nhật Bản",137600,137600,0,0
TIKI,bach-hoa-online,57893764,"Yến Mạch Cán Mỏng DK Harvest Nhập Khẩu Úc - 2kg",119000,119000,0,0
TIKI,bach-hoa-online,65118142,"Bột gạo lứt đỏ (1Kg) Rang xay theo phương pháp thực dưỡng Ohsawa",95000,95000,0,0
TIKI,bach-hoa-online,76747171,"Trà vằng túi lọc lợi sữa - Giảm mỡ bụng Wonmom",69000,69000,0,0
TIKI,bach-hoa-online,88909463,"Mực xé tẩm gia vị siêu ngon - Hũ 200G hiệu TPS",89000,99000,10000,10
TIKI,bach-hoa-online,115250922,"Bộ 6 túi thức ăn cho chó lớn dạng sốt Pedigree vị gà 130g",114000,114000,0,0
TIKI,bach-hoa-online,3747989,"Đặc Sản Phan Thiết - Nước Mắm Tĩn Cá Cơm Than Nhãn Xưa 41N ( Tĩn Gốm 500Ml) Sánh Đặc Thịt Cá, Không Chất Bảo Quản",275000,320000,45000,14
TIKI,bach-hoa-online,74795579,"Combo 3 bịch cát vệ sinh cho mèo - Cát nhật 8L (được chọn mùi)",139999,139999,0,0
TIKI,bach-hoa-online,599733,"Trà Sữa Vị Trà Xanh Aik Cheong Matcha Café Art (12 Gói x 25g)",119000,129000,10000,8
TIKI,bach-hoa-online,73667907,"Nhân Hạt Bí Xanh Smile Nuts (265g - 500g) | Nhân bí xanh đã nướng nguyên vị, hàng nhập khẩu 100",88000,108000,20000,19
TIKI,bach-hoa-online,85557163,"Combo 2 Lon Sữa Đặc Có Đường Creamer Premium Alphana nhập khẩu Malaysia Lon 500g Giàu Protein Vitamin A D3 B1 - Không Cholesterol - Nắp Khui Tiện Dụng",64000,78000,14000,18
TIKI,bach-hoa-online,21477025,"Bánh Mochi Nhân Khoai Môn Japanese Style Taro Mochi 210g",60760,62000,1240,2
TIKI,bach-hoa-online,189586825,"Cà phê phin giấy Arabica Cầu Đất DalatFarm - Hộp 10 túi x 10 g",131000,150000,19000,13
TIKI,bach-hoa-online,270844874,"Sữa dành cho người tiểu đường Entrust Milk Bổ sung đầy đủ dinh dưỡng, cân bằng đường huyết, phòng loãng xương - QuaTangMe Extaste",490400,1022000,531600,52
TIKI,bach-hoa-online,99350540,"Rong biển vụn rắc cơm hữu cơ Ipsoon 30g nhập khẩu Hàn Quốc",53000,59000,6000,10
TIKI,bach-hoa-online,57524251,"Cà phê nguyên chất Arabica Cầu Đất, cafe mộc rang xay Beemo 500g - Đắng ít, chua thanh, thơm, hậu vị ngọt",150000,210000,60000,29
TIKI,bach-hoa-online,97377864,"Combo 3 gói Gia Vị Hoàn Chỉnh Barona - Bún Bò Huế 80g",54000,54000,0,0
TIKI,bach-hoa-online,51654679,"Hạt điều rang muối nhân trắng bể nửa sviet 500g",96000,96000,0,0
TIKI,bach-hoa-online,146292090,"Ngũ cốc hạt ăn liền Granola Min Min, ngũ cốc dinh dưỡng dạng hạt ăn liền (hộp 500g)",190000,190000,0,0
TIKI,bach-hoa-online,92710926,"Bộ 12 túi thức ăn cho mèo Whiskas vị cá thu 80g",150000,150000,0,0
TIKI,bach-hoa-online,181978846,"Đặc Sản Sóc Trăng - Bánh Hạnh Nhân Trứng Muối 300G, Bánh Hạnh Nhân Tân Huê Viên Sóc Trăng, Bánh Bột Đậu Trứng Muối, Bánh Kẹo Ăn Vặt",62100,69000,6900,10
TIKI,bach-hoa-online,190966039,"Combo 4 Hộp Bánh ChocoPie Tình ORION vị truyền thống 396G",233000,270000,37000,14
TIKI,bach-hoa-online,68141542,"HẠT ĐIỀU VỎ LỤA RANG MUỐI CAO CẤP THƯƠNG HIỆU SK FOOD - HỘP 500G",99000,99000,0,0
TIKI,bach-hoa-online,11960475,"Ngũ Cốc Ăn Sáng Kellogg's Mueslix Harvest Fruit 375g",131000,138000,7000,5
TIKI,bach-hoa-online,184432853,"Bột cải xoăn Kale nguyên chất Goce - 60g (20 gói x 3g)",176000,220000,44000,20
TIKI,bach-hoa-online,58797152,"Hạt Bí Xanh Đã Tách Võ (Đã Rang) TETE 500 gram",102000,103000,1000,1
TIKI,thoi-trang-nam,59178463,"Cà phê Sáng tạo 2 (340gr)",80000,86363,6363,7
TIKI,thoi-trang-nam,168561896,"Cà phê Trần Quang NGON cafe sữa uống liền bịch 24 gói",54000,54000,0,0
TIKI,thoi-trang-nam,179921782,"Nước yến thật BRAND'S Không Đường",439000,439000,0,0
TIKI,thoi-trang-nam,181134349,"Cà Phê Robusta Lâm Đồng Rang Mộc Nguyên Chất- Hộp 250Gr (Dạng Bột)",111000,130000,19000,15
TIKI,thoi-trang-nam,184429270,"Bột gạo lứt nguyên chất Goce - 180g (18 gói x 10g)",96000,120000,24000,20
TIKI,thoi-trang-nam,176491668,"Combo 2 chai dầu ăn Ranee Golden 2 lít (2 lít/chai x 2 chai)",179000,270000,91000,34
TIKI,thoi-trang-nam,189604485,"Cà phê phin giấy Robusta Lâm Đồng DalatFarm - Hộp 10 túi x 10 g",105000,110000,5000,5
TIKI,thoi-trang-nam,1820321,"Bột ngũ cốc dinh dưỡng Calsome hương Sô cô la",63000,70000,7000,10
TIKI,thoi-trang-nam,115250922,"Bộ 6 túi thức ăn cho chó lớn dạng sốt Pedigree vị gà 130g",114000,114000,0,0
TIKI,thoi-trang-nam,65118142,"Bột gạo lứt đỏ (1Kg) Rang xay theo phương pháp thực dưỡng Ohsawa",95000,95000,0,0
TIKI,thoi-trang-nam,146292090,"Ngũ cốc hạt ăn liền Granola Min Min, ngũ cốc dinh dưỡng dạng hạt ăn liền (hộp 500g)",190000,190000,0,0
TIKI,thoi-trang-nam,74795579,"Combo 3 bịch cát vệ sinh cho mèo - Cát nhật 8L (được chọn mùi)",139999,139999,0,0
TIKI,thoi-trang-nam,66948978,"Đặc Sản Phan Thiết - NướC MắM Nhỉ Làng Chài Xưa Truyền Thống Nhãn Đỏ Thùng 6 Chai Thủy Tinh 500Ml Cốt Nhỉ Đặc Biệt Vị Đậm Đà Gu Ông Bà Xưa Nước Mắm Nguyên Chất Sạch Nước Mắm Nhĩ Từ Thùng Lều Gỗ 100% Cá Cơm Tươi Muối Tinh Khiết Không Chất Bảo Quản",420000,590000,170000,29
TIKI,thoi-trang-nam,46221303,"Trái cây sấy khô thập cẩm Huynh Đệ Tề Hùng 1kg ( 2 túi 500g)",122550,129000,6450,5
TIKI,thoi-trang-nam,181000438,"Đặc Sản Sóc Trăng - Bánh Pía Chay Đậu Xanh Sầu Riêng Tân Huê Viên Lớn 500G, Bánh Pía Sóc Trăng Ăn Chay Không Trứng Muối",94500,105000,10500,10
TIKI,thoi-trang-nam,599733,"Trà Sữa Vị Trà Xanh Aik Cheong Matcha Café Art (12 Gói x 25g)",119000,129000,10000,8
TIKI,thoi-trang-nam,189586825,"Cà phê phin giấy Arabica Cầu Đất DalatFarm - Hộp 10 túi x 10 g",131000,150000,19000,13
TIKI,thoi-trang-nam,165947055,"Hạnh Nhân Mỹ Tách Vỏ Pams, Rang Nguyên Vị, Ăn Kiêng Giảm Cân, Ngũ Cốc Dinh Dưỡng Bà Bầu",122000,225000,103000,46
TIKI,thoi-trang-nam,57893764,"Yến Mạch Cán Mỏng DK Harvest Nhập Khẩu Úc - 2kg",119000,119000,0,0
TIKI,thoi-trang-nam,3747989,"Đặc Sản Phan Thiết - Nước Mắm Tĩn Cá Cơm Than Nhãn Xưa 41N ( Tĩn Gốm 500Ml) Sánh Đặc Thịt Cá, Không Chất Bảo Quản",275000,320000,45000,14
TIKI,thoi-trang-nam,21477025,"Bánh Mochi Nhân Khoai Môn Japanese Style Taro Mochi 210g",60760,62000,1240,2
TIKI,thoi-trang-nam,99350540,"Rong biển vụn rắc cơm hữu cơ Ipsoon 30g nhập khẩu Hàn Quốc",53000,59000,6000,10
TIKI,thoi-trang-nam,64648273,"Lược Chải Lông Vệ Sinh Chó Mèo Màu Ngẫu Nhiên [Tặng Móc Dán Tường Treo Đồ]",38888,38888,0,0
TIKI,thoi-trang-nam,181978846,"Đặc Sản Sóc Trăng - Bánh Hạnh Nhân Trứng Muối 300G, Bánh Hạnh Nhân Tân Huê Viên Sóc Trăng, Bánh Bột Đậu Trứng Muối, Bánh Kẹo Ăn Vặt",62100,69000,6900,10
TIKI,thoi-trang-nam,97377864,"Combo 3 gói Gia Vị Hoàn Chỉnh Barona - Bún Bò Huế 80g",54000,54000,0,0
TIKI,thoi-trang-nam,57524251,"Cà phê nguyên chất Arabica Cầu Đất, cafe mộc rang xay Beemo 500g - Đắng ít, chua thanh, thơm, hậu vị ngọt",150000,210000,60000,29
TIKI,thoi-trang-nam,190966039,"Combo 4 Hộp Bánh ChocoPie Tình ORION vị truyền thống 396G",233000,270000,37000,14
TIKI,thoi-trang-nam,70092877,"Hạt Điều Rang Muối Loại Vỡ Thương Hiệu SK FOOD - Combo 1Kg 2 Hũ",97000,129000,32000,25
TIKI,thoi-trang-nam,88909463,"Mực xé tẩm gia vị siêu ngon - Hũ 200G hiệu TPS",89000,99000,10000,10
TIKI,thoi-trang-nam,8021230,"Ngũ cốc hoa quả Calbee Furugura Nhật Bản",137600,137600,0,0
TIKI,thoi-trang-nam,76747171,"Trà vằng túi lọc lợi sữa - Giảm mỡ bụng Wonmom",69000,69000,0,0
TIKI,thoi-trang-nam,11960475,"Ngũ Cốc Ăn Sáng Kellogg's Mueslix Harvest Fruit 375g",131000,138000,7000,5
TIKI,thoi-trang-nam,270844874,"Sữa dành cho người tiểu đường Entrust Milk Bổ sung đầy đủ dinh dưỡng, cân bằng đường huyết, phòng loãng xương - QuaTangMe Extaste",490400,1022000,531600,52
TIKI,thoi-trang-nam,73667907,"Nhân Hạt Bí Xanh Smile Nuts (265g - 500g) | Nhân bí xanh đã nướng nguyên vị, hàng nhập khẩu 100",88000,108000,20000,19
TIKI,thoi-trang-nam,51654679,"Hạt điều rang muối nhân trắng bể nửa sviet 500g",96000,96000,0,0
TIKI,thoi-trang-nam,184432853,"Bột cải xoăn Kale nguyên chất Goce - 60g (20 gói x 3g)",176000,220000,44000,20
TIKI,thoi-trang-nam,85557163,"Combo 2 Lon Sữa Đặc Có Đường Creamer Premium Alphana nhập khẩu Malaysia Lon 500g Giàu Protein Vitamin A D3 B1 - Không Cholesterol - Nắp Khui Tiện Dụng",64000,78000,14000,18
TIKI,thoi-trang-nam,58797152,"Hạt Bí Xanh Đã Tách Võ (Đã Rang) TETE 500 gram",102000,103000,1000,1
TIKI,thoi-trang-nam,68141542,"HẠT ĐIỀU VỎ LỤA RANG MUỐI CAO CẤP THƯƠNG HIỆU SK FOOD - HỘP 500G",99000,99000,0,0
TIKI,thoi-trang-nam,92710926,"Bộ 12 túi thức ăn cho mèo Whiskas vị cá thu 80g",150000,150000,0,0
TIKI,the-thao-da-ngoai,222705121,"Tạ Tay + Tạ Đẩy kết hợp (2 in 1), 20kg bộ sản phẩm",510000,510000,0,0
TIKI,the-thao-da-ngoai,105619969,"[Chính Hãng BBT] Sữa Tăng Cân Tăng Cơ Labrada Muscle Mass Gainer (5.4kg)",1660000,1660000,0,0
TIKI,the-thao-da-ngoai,113056592,"Quần thể dục 3 sọc cho nam, đồ thể thao nam nữ các cấp, vải thun co giãn, thương hiệu Amazing",71000,114000,43000,38
TIKI,the-thao-da-ngoai,50351507,"Vỏ bao cát boxing tập đấm bốc boxing mma dài 105cm, Ø=35cm + găng bao tay đấm bốc boxing mma + bằng đa boxing mma + full 7 món phụ kiện đi kèm",350000,350000,0,0
TIKI,the-thao-da-ngoai,192139394,"Phao Câu Đài Săn Hàng DW tăm phao lớn, siêu nhạy, chống lóa mắt, mỏi mắt cao cấp PC12",53000,53000,0,0
TIKI,the-thao-da-ngoai,194372515,"Giày tập thể thao nam Super Flexi Anta 812237701",799000,1359000,560000,41
TIKI,the-thao-da-ngoai,95200246,"Bình nước cứng thể thao, chạy bộ GoodFit dung tích 250ml GF03RA",25000,35000,10000,29
TIKI,the-thao-da-ngoai,178226148,"Combo 2 tạ tay nhựa đúc hoàn chỉnh - Tạ tay nhựa Việt Nam Sportslink",18000,20000,2000,10
TIKI,the-thao-da-ngoai,161368303,"Giày Trượt Patin Trẻ Em, Giày Patin 4 Bánh Tặng Kèm Bảo Hộ cùng màu - Giày Batin khung hợp kim+ nhựa PP cứng chịu lực, chống mài mòn - Phù Hợp Cho Bé từ 5 tuổi trở lên",329000,329000,0,0
TIKI,the-thao-da-ngoai,115090166,"Vòng Tập YOGA Pilates Myring - YOGA QG, Nhựa ABS Cao Cấp, Hỗ Trợ Tập Yoga Và Massage Đa Năng",42750,45000,2250,5
TIKI,the-thao-da-ngoai,117371966,"Bộ 5 dây ngũ sắc kháng lực tập Gym - Dây cao su kháng lực hỗ trợ tập toàn thân",265000,265000,0,0
TIKI,the-thao-da-ngoai,58310856,"Bình Lắc Tập Gym Shaker Wave BiotechUSA - Hàng Chính Hãng",200000,200000,0,0
TIKI,the-thao-da-ngoai,51433824,"Giày Bata Vải Thể Thao Bình Minh",89900,89900,0,0
TIKI,the-thao-da-ngoai,66721817,"Đai Bảo Vệ Đầu Gối Đàn Hồi Amber (1 Đôi)",89000,89000,0,0
TIKI,the-thao-da-ngoai,116899852,"Mồi câu cá Lk Hòa | Thính Lk Câu cá chép trắm trôi siêu nhạy",50000,50000,0,0
TIKI,the-thao-da-ngoai,149612981,"Ghế ngồi câu cá đài đa năng, ghế dã ngoại xếp gọn cao cấp giá rẻ",22100,22100,0,0
TIKI,the-thao-da-ngoai,71518366,"Quần thể thao nam nữ phối sọc có size đại",59000,59000,0,0
TIKI,the-thao-da-ngoai,160745517,"Giày Chạy Bộ Nữ Biti's Hunter Running TIGER DSWH08300CAM (Cam)",736000,981000,245000,25
TIKI,the-thao-da-ngoai,98032682,"Giảm rung Babolat phát ra tiếng kêu vi vu khi vung vợt, vung vợt càng nhanh , tiếng kêu càng lớn Vỉ : 2 cái 2 màu",166000,199000,33000,17
TIKI,the-thao-da-ngoai,170753798,"Mũ Rộng Vành Dã Ngoại Naturehike NH17M005-A",220000,220000,0,0
TIKI,the-thao-da-ngoai,141299015,"Banh bóng chuyền da Parabol VB3300 - Loại da mềm - Quả bóng chuyền dán size 5",139000,139000,0,0
TIKI,the-thao-da-ngoai,51300180,"Ruột Zippo Gas Butane - Một Tia Lửa 65826",510000,510000,0,0
TIKI,the-thao-da-ngoai,198111491,"SET 3 dây tập gym, tập mông mini band GoodFit GF914MB",99000,99000,0,0
TIKI,the-thao-da-ngoai,12102753,"Tạ tay nhựa 5kg (1 chiếc)",46000,51000,5000,10
TIKI,the-thao-da-ngoai,57789139,"Túi đeo hông, đai chạy bộ nhiều ngăn chống nước, có phản quang Goodfit GF102RB",129000,200000,71000,36
TIKI,the-thao-da-ngoai,33393166,"Bộ Giày Trượt Patin Đại Nam Sport T20096 Bánh  Phát Sáng + Kèm bảo hộ (Chân,tay, mũ bảo hiểm)",569000,600000,31000,5
TIKI,the-thao-da-ngoai,20996392,"Bộ 5 mồi câu cá giả hình tôm có kèm lưỡi câu - Màu ngẫu nhiên",17000,17000,0,0
TIKI,the-thao-da-ngoai,170097878,"Parallettes - Dụng cụ hỗ trợ hít đất, chống đẩy (Một đôi)",129000,129000,0,0
TIKI,the-thao-da-ngoai,149597911,"Hộp Lưỡi Câu Cá ,Lưỡi Câu Đơn,Lưỡi Câu Đài, Lưỡi Câu Chép,Rô Phi",12200,12200,0,0
TIKI,the-thao-da-ngoai,48601188,"Xà đơn treo tường, gắn tường chốt chống xoay mẫu mới nhất(Màu ngẫu nhiễn-Mã TG)-2020",251000,329000,78000,24
TIKI,the-thao-da-ngoai,104100270,"Thiết Bị Phục Hồi Chức Năng Zasami KZ cải tiến có đai giữ cố định người bệnh 3 trong 1 ",2800000,3590000,790000,22
TIKI,the-thao-da-ngoai,3661963,"Sữa tăng cân MASS TECH EXTREME 2000 của MuscleTech hương chocolate thùng 10kg",2795000,3600000,805000,22
TIKI,the-thao-da-ngoai,135537810,"Lọ chiết mỹ phẩm, dầu gội du lịch 60ml Colorful X4 ROBNLIFE LN641",29000,29000,0,0
TIKI,the-thao-da-ngoai,114819576,"Bộ quần áo bóng đá đội tuyển quốc gia Việt Nam 2021 - Đồ bóng đá tuyển Việt Nam- Bộ đồ bóng đá đẹp",95000,150000,55000,37
TIKI,the-thao-da-ngoai,108883244,"Cặp vợt cầu lông giá rẻ chất lượng 7588 - ",350000,350000,0,0
TIKI,the-thao-da-ngoai,147209389,"Tạ Tay Thép King Box Loại 2.5KG",175000,175000,0,0
TIKI,the-thao-da-ngoai,155624556,"Dụng cụ luyện vung vợt tennis racquet drop assistant",255500,255500,0,0
TIKI,the-thao-da-ngoai,707405,"Thảm Tập Gym Và Yoga TPE 2 Lớp 6MM2L (6mm) - Tím",75000,75000,0,0
TIKI,the-thao-da-ngoai,11947863,"Xà đơn treo tường ",79000,117000,38000,32
TIKI,the-thao-da-ngoai,54387636,"Bóng Tập Yoga, Bóng Yoga Tròn Cỡ Đại 65cm Cao Cấp - Chính Hãng (Hàng nhập khẩu)",154000,200000,46000,23
TIKI,thoi-trang-nam,19290138,"Quần Jean Bạc Phong Cách Trẻ Trung JEANBAC02",145000,145000,0,0
TIKI,thoi-trang-nam,96363295,"[TUYỆT CHIÊU ] Quần Sịp Sơ Vin Thông Minh cao cấp AJIKO, Cuốn Hút, Độc Đáo",230000,230000,0,0
TIKI,thoi-trang-nam,48101769,"Quần Lót Nam Boxer Kiểu Jean 5964",75000,75000,0,0
TIKI,thoi-trang-nam,160814776,"quần lót nam relax thun lạnh cao cấp chính hãng, quần sipn nam relax rltk07 - M",104000,104000,0,0
TIKI,thoi-trang-nam,78488562,"Quần Jean Nam siêu cấp thương hiệu Chandi,  chất jean co dãn mẫu mới mã HD89",194000,299000,105000,35
TIKI,thoi-trang-nam,194022042,"Áo sơ mi nam ngắn tay Sans311 chất linen đũi trơn nhẹ thoáng mát đẹp cổ tàu trụ trắng xanh dương xám nhạt than be",189999,189999,0,0
TIKI,thoi-trang-nam,164309510,"The Cycling Lion, mã G73. Áo thun nam nữ in siêu đẹp. Áo phông thoát nhiệt GOKING hàng hiệu cao cấp",168000,168000,0,0
TIKI,thoi-trang-nam,158757427,"Quần đùi nam 2 lớp dù thoáng mát form chuẩn",135000,135000,0,0
TIKI,thoi-trang-nam,196954475,"Áo thun thời trang nam New Balance LIFESTYLE T-SHIRT M BLACK - MT23901BK (form quốc tế)",299000,299000,0,0
TIKI,thoi-trang-nam,19403766,"Áo sơ mi nam sọc trắng đen dài tay cổ vest",108000,108000,0,0
TIKI,thoi-trang-nam,115593847,"Quần Jogger Đen/Trắng Hoạ Tiết Hoạt Hình Ulzzang Nam Nữ 1hit_Unisex",147000,147000,0,0
TIKI,thoi-trang-nam,168303685,"Áo sơ mi nam vải lụa cao cấp không nhăn, form hàn quốc, phù hợp đi làm, đi tiệc, đi học, đi chơi",159000,159000,0,0
TIKI,thoi-trang-nam,83158705,"Áo Thun Nam Có Cổ Phối Logo",124000,124000,0,0
TIKI,thoi-trang-nam,95334507,"Quần short tây nam Novelty in họa tiết 2100090",284050,299000,14950,5
TIKI,thoi-trang-nam,118159890,"ÁO GIỮ NHIỆT NAM CỔ 3 PHÂN HÀNG CAO CẤP",150000,150000,0,0
TIKI,thoi-trang-nam,115754343,"Áo Sơ Mi Nam Dài Tay SM004",79000,79000,0,0
TIKI,thoi-trang-nam,83518858,"ÁO KHOÁC KAKI NAM 2 LỚP",349700,349700,0,0
TIKI,thoi-trang-nam,149684587,"ÁO KHOÁC DÙ BOMBER CAO CỔ 7ZIA",105000,105000,0,0
TIKI,thoi-trang-nam,148680632,"QUẦN LÍNH TÚI HỘP HÀN QUỐC CỰC ĐẸP, Quần Kaki Lính Rằn Ri Chất Vải kaki, Quần jogger kaki rằn ri - lính nam túi hộp, QUẦN JOGGER KAKI CO GIÃN HOẠT TIẾT LÍNH CAO CẤP, Quần kaki dài basic nam nữ lính",95000,95000,0,0
TIKI,thoi-trang-nam,164308730,"TOKYO JAPAN, mã G53. Áo thun nam nữ siêu đẹp. Áo phông thoát nhiệt Goking hàng hiệu",168000,168000,0,0
TIKI,thoi-trang-nam,171046883,"Quần Bò Nam cao cấp thương hiệu Chandi, chất jean co dãn mẫu mới nhất  MS64",194000,350000,156000,45
TIKI,thoi-trang-nam,192678290,"ÁO SƠ MI TAY NGẮN-V46-014618-BL3",3190000,3190000,0,0
TIKI,thoi-trang-nam,38629581,"Áo khoác nam",474000,499000,25000,5
TIKI,thoi-trang-nam,16311563,"Áo ba lỗ nam cao cấp mặc nhà, mặc ngủ Voga vải Modal",149000,149000,0,0
TIKI,thoi-trang-nam,22603926,"Quần short jean nam xanh bạc Q414 Muidoi",132000,132000,0,0
TIKI,thoi-trang-nam,114415816,"Áo khoác dù nam nữ mặc in nổi hình sói , áo khoác gió , áo khoác unisex vải dù 2 lớp, Áo khoác kiểu bomber nam , Áo khoác dù nam , áo khoác kiểu bomber nam , áo dù bomber , áo khoác nam vải dù 2 lớp",95000,95000,0,0
TIKI,thoi-trang-nam,113234818,"Combo 4 quần đùi nam xuất khẩu vải kate cotton 100% thương hiệu Fezzio",249500,499000,249500,50
TIKI,thoi-trang-nam,251562339,"JAPAN, mã G273. Áo thun in đẹp cho nam nữ, cặp đôi, gia đình. Áo phông Goking hàng hiệu cao cấp",69000,69000,0,0
TIKI,thoi-trang-nam,78965186,"Đồ bộ thể thao nam vải thun lạnh mềm mịn, Thời Trang Phong Cách Hàn - Lee’s Home (Freesize từ 45-70kg)-Nhiều kiểu lựa chọn",75000,75000,0,0
TIKI,thoi-trang-nam,197720684,"Áo khoác hoodie Kill System So Sad oversize có nón nam nữ, vải nỉ bông chân cua phong cách unisex, Hoodie Nỉ Ngoại Too Young Toneso Sad Unisex Jacket form rộng tay bồng kiểu dáng đường phố hàn quốc",100000,100000,0,0
TIKI,thoi-trang-nam,68936826,"Áo Sơ Mi Mam Dài Tay Hàn Quốc Dáng Ôm Sơ Cổ Bẻ Vải Lụa Thái Chống Nhăn Chống Xù",124000,124000,0,0
TIKI,thoi-trang-nam,54916506,"Áo thun nam form rộng unisex tay lỡ in chữ BJHG, chất thun cotton dày dặn thấm hút mồ hôi, thời trang trẻ, phong cách Hàn Quốc",89000,89000,0,0
TIKI,thoi-trang-nam,207394337,"OPEN YOUR MIND, mã G164. Áo thun nam nữ in chữ siêu đẹp. Áo phông GOKING hàng hiệu cao cấp, vải cotton và thun lạnh giá rẻ",99000,99000,0,0
TIKI,thoi-trang-nam,170270845,"Áo Polo Tay Ngắn Thiết Kế Phong Cách Năng Động Thời Trang AVIANO",99000,198000,99000,50
TIKI,thoi-trang-nam,85445120,"Áo thun nam tay lỡ có cổ vải cá sấu loại cao cấp mềm mịn co giãn tốt thấm hút mồ hôi mặc mát có nhiều size 55-85kg",39000,39000,0,0
TIKI,thoi-trang-nam,107039457,"Set Đồ Lam Đi Chùa Cao Cấp Cho Nam S1 #đồ lam đi chùa - đồ phật tử",300000,300000,0,0
TIKI,thoi-trang-nam,76725581,"Áo thun Polo nam Novelty màu đỏ NATMMTMT3R180079N",286000,395000,109000,28
TIKI,thoi-trang-nam,198304036,"SHORT THUN BIG SIZE NAM 80 ĐẾN 140KG CHỮ SPORT PRO",185000,185000,0,0
TIKI,thoi-trang-nam,165150012,"Quần tắm biển nam phong cách Nhật Bản 9850",99500,199000,99500,50
TIKI,thoi-trang-nam,177603771,"Quần Lót Nam Boxer Thun Lạnh Cao Cấp LUXIS, Quần Sịp Đùi Nam Co Giãn 4 Chiều Mềm Mịn Siêu thoáng mát - LD023",65000,85000,20000,24
TIKI,thoi-trang-nam,54762609,"Quần kaki nam 1 ply Khatoco Q2M528R1-INMA003-2106-1",422400,528000,105600,20
TIKI,thoi-trang-nam,189467654,"Quần Jeans nam dáng regular fit 6Q7092 - thương hiệu Viettien",645000,645000,0,0
TIKI,thoi-trang-nam,37650433,"ÁO KHOÁC KAKI NAM UNISEX -LLQAK01",120000,120000,0,0
TIKI,thoi-trang-nam,95053766,"Áo Khoác Big Size Nam Nữ Áo Khoác Kaki Unisex Chống Nóng Chống Nắng Chống Lạnh Chống Gió 2 Lớp Có Cổ Cao Thời Trang Nam Tính Hàn Quốc Cao Cấp QK36 - ShopN6",169000,235000,66000,28
TIKI,thoi-trang-nam,186290944,"Áo Sơ Mi nam sọc caro tím trắng dài tay NSMMCLMTCR212807D",303000,319000,16000,5
TIKI,thoi-trang-nam,197600242,"Hộp 4 quần lót nam boxer CITYMEN lưng Thái cao cấp vải thun lạnh co giãn 4 chiều - Giao màu ngẫu nhiên",180000,180000,0,0
TIKI,thoi-trang-nam,85086742,"Áo sơ mi nam cổ trụ dài tay sọc đẹp",159000,159000,0,0
TIKI,thoi-trang-nam,181422834,"Áo thun Classic nam 2018, hàng nhập Quảng Châu",69000,69000,0,0
TIKI,thoi-trang-nam,67545395,"Quần tây nam vải co giãn , quần âu nam vải tuyết mưa hàn quốc - xanh than - 33",115000,115000,0,0
TIKI,thoi-trang-nam,7823134,"Bộ 3 Quần Boxer Đúc Nam Nhật Bản (Nhiều màu) - 5Star",120000,120000,0,0
TIKI,thoi-trang-nam,187861992,"Quần bơi dài, lửng",95000,95000,0,0
TIKI,thoi-trang-nam,52311502,"Áo Khoác Cao Cấp, Áo Khoác Kaki Nam Hàn Quốc",163000,163000,0,0
TIKI,thoi-trang-nam,190321094,"Áo sơ mi, Áo sơ mi nam cổ đứng thêu hoa văn, vạt chéo tạo điểm nhấn cho chiếc áo của bạn, sang trọng, lịch lãm H37",199000,199000,0,0
TIKI,thoi-trang-nam,192413381,"Quần short đùi nam cao cấp TC với thiết kế logo thêu bền đẹp, chất cotton co dãn tốt, năng động, thể thao,thời trang-362",450000,450000,0,0
TIKI,thoi-trang-nam,147444526,"Áo Sơ Mi Nam Dài Tay Sọc Ngang Bảng To PONIVA",164000,164000,0,0
TIKI,thoi-trang-nam,161539220,"quần lót nam relax cotton cao cấp chính hãng, quần sịp nam relax underwear rltk23",89000,89000,0,0
TIKI,thoi-trang-nam,174369429,"Áo đũi nam cổ tầu phối túi ngực xếp ly trẻ trung, thời trang xuân hè 2022",179000,179000,0,0
TIKI,thoi-trang-nam,2630799,"Áo thun nam trơn cổ tròn - ( trắng)",39000,39000,0,0
TIKI,thoi-trang-nam,21190890,"Áo Sơ Mi Nam Ngắn Tay Hình Logo NTLG6895",165000,165000,0,0
TIKI,thoi-trang-nam,67733705,"Áo thun dài tay nam nữ",86000,86000,0,0
TIKI,thoi-trang-nam,177750772,"Bộ bơi nam 3 chi tiết quần áo dài tay chống nắng cao cấp",460000,460000,0,0
TIKI,thoi-trang-nam,192367917,"Quần short đùi nam cao cấp TC với thiết kế họa tiết logo thêu, kết hợp phần sọc bên hông quần tạo điểm nhấn, chất cotton mát, co dãn, phong cách trẻ trung, năng động, thể thao-364",450000,450000,0,0
TIKI,thoi-trang-nam,114056064,"Quần jogger 2 da cao cấp in hoạ tiết unisex nam nữ có dây rút ống thời trang Hàn",99000,99000,0,0
TIKI,thoi-trang-nam,98023604,"ĐỒ BỘ NAM MẶC Ở NHÀ, ĐI CHƠI ÁO BA LỖ IN CHỮ OFF CHẤT THUN LẠNH, QUẦN KAKI TÚI KHÓA, LÊN FORM CỰC ĐẸP, ĐỒ BỘ MẠC NHÀ SÁT NÁCH CHỮ OFF, BỘ ĐỒ THỂ THAO SÁT NÁCH, BỘ ĐỒ ĐÔI NAM NỮ,  BỘ ĐỒ NAM NỮ",115000,115000,0,0
TIKI,thoi-trang-nam,124554704,"Quần tây vải quần tây nam ống côn vải dãn dành cho học sinh, sinh viên có big size từ 26 đến 37",139000,139000,0,0
TIKI,thoi-trang-nam,48427720,"Quần Lót Nam Boxer Body Thể Thao Cam Đen 5969",61000,69000,8000,12
TIKI,thoi-trang-nam,99485511,"Quần jean nam rách cao cấp vải jean co dãn hàng chuẩn shop Phuongnamshop20 kvp58",125000,125000,0,0
TIKI,thoi-trang-nam,34158949,"Áo Sơ Mi Nam Sọc Trắng",99000,99000,0,0
TIKI,thoi-trang-nam,10776493,"Áo thun trơn basic, form unisex cho nam nữ. Áo phông hàng hiệu Goking, quà tặng cao cấp cho gia đình, cặp đôi, lớp nhóm, doanh nghiệp, người nước ngoài",138000,138000,0,0
TIKI,thoi-trang-nam,114285672,"Hộp 5 cái quần lót tam giác thông hơi nam - Sịp lưới nam thoáng mát",86600,86600,0,0
TIKI,thoi-trang-nam,137912762,"Áo Sơ Mi Nam Dài Tay Caro MR265 Thời Trang PONIVA Thiết Kế Nam Tính Lịch Lãm Hàng Chất Lượng XNK",169000,169000,0,0
TIKI,thoi-trang-nam,216901915,"Áo đồng phục công nhân, kỹ sư vải kaki Nam Định phối phản quang",110000,110000,0,0
TIKI,thoi-trang-nam,181423159,"Áo thun nam cotton cơ bản in hình sóc, chất vải cotton dày dặn, thời trang xuân hè 2021",35000,35000,0,0
TIKI,thoi-trang-nam,129297930,"quần short đũi nam trung niên ống suông đũng dài chất đẹp không nhăn không nhàu",199000,199000,0,0
TIKI,thoi-trang-nam,140579763,"QUẦN KAKI NAM NỮ CHẤT VẢI DÀY",229000,229000,0,0
TIKI,thoi-trang-nam,170726691,"Viettien - Áo sơ mi nam ngắn tay vạt bầu chấm bi 1Q1180 regular",490000,490000,0,0
TIKI,thoi-trang-nam,133875924,"Quần Lót Nam Boxer Thun Lạnh 4 Chiều Lưng Thái Cao Cấp, Quần Sịp Đùi Co Giãn Và Thấm Hút Tốt CITYMEN ( Màu Ngẫu Nhiên )",54000,54000,0,0
TIKI,thoi-trang-nam,124749863,"QUẦN TÂY MÀU XANH ĐEN VIỆT TIẾN",580000,580000,0,0
TIKI,thoi-trang-nam,126156231,"quần đi biển 1 hàng cao cấp , nhóm, du lịch mùa hè.hàng đẹp, vải mát, đồng phục đủ size cho cả nhà",45000,45000,0,0
TIKI,thoi-trang-nam,30768234,"Áo sơ mi nam cổ trụ chui đầu dài tay kẻ sọc trắng đen",159000,159000,0,0
TIKI,the-thao-da-ngoai,179534840,"[SIÊU GỌN] PARALLETTES GỖ - DỤNG CỤ HÍT ĐẤT, CHỐNG ĐẨY",150000,150000,0,0
TIKI,the-thao-da-ngoai,270766582,"Cần câu tay rút gọn 45cm đút cốp hạ lóng có thể thay đổi chiều dài cần tặng kèm ngọn phụ",320000,320000,0,0
TIKI,the-thao-da-ngoai,41825814,"GĂNG TAY THỂ THAO ADIDAS ADGB-1315",441000,456000,15000,3
TIKI,the-thao-da-ngoai,183530633,"[Mẫu mới] Bộ quần áo bóng đá câu lạc bộ Real Madrid - Áo bóng đá chất vải thun lạnh, dệt kim cao cấp",95000,175000,80000,46
TIKI,the-thao-da-ngoai,58341210,"Khăn Trùm Mặt Che Nắng Đi Phượt Đa Năng Cao Cấp Vải Thoáng Khí, Mau Khô, Dễ Mặc Cho Nam Và Nữ Dành Cho Phượt Thủ - Mai Lee",65892,69360,3468,5
TIKI,the-thao-da-ngoai,26106763,"Bộ 2 Vợt Bóng Bàn Chính Hãng miDoctor + Túi Đựng Vợt Bóng Bàn + 3 Bóng ",179000,179000,0,0
TIKI,the-thao-da-ngoai,166123372," Thanh rung thể thao đàn hồi có thể tháo rời Sportslink Feilishi Rod (Hàng loại 1)",222000,245000,23000,9
TIKI,the-thao-da-ngoai,186803059,"Quần Chạy Bộ Nam 2 Lớp DK22001 Có Túi Đựng Điện Thoại Bên hông,Túi Hậu Có Khóa Kéo",199000,199000,0,0
TIKI,the-thao-da-ngoai,138171420,"Lồng lưới phơi khô thực phẩm phơi cá chống côn trùng treo 4 tầng để phơi cá khô có thể xếp gọn",54997,54997,0,0
TIKI,the-thao-da-ngoai,191829779,"[Tặng Dây Đeo] Thảm Yoga Định Tuyến Cao Su Thiên Nhiên PU - YOGA QG, Chống Trơn Trượt, Độ Đàn Hồi Tốt, Mềm Mại, Thấm Hút Mồ Hôi, Đường Định Tuyến In Rõ Rét",351000,415000,64000,15
TIKI,the-thao-da-ngoai,81926362,"1 CUỘN  CUỐN CÁN  PRO OVERGRIP - Quấn cán cuộn 15 (WRZ4017WH) 15 DÂY MÀU NGẪU NHIÊN",549000,590000,41000,7
TIKI,the-thao-da-ngoai,43993416,"Viên Uống Giúp Tăng Tập Trung Và Tỉnh Táo - Mutant Caffeine Hộp 240 Viên",300000,300000,0,0
TIKI,the-thao-da-ngoai,58625585,"Quần Tập GYM Nam Cao Cấp SZone SQ492",69000,69000,0,0
TIKI,the-thao-da-ngoai,75345767,"Banh Bóng Rổ Da Geru Star Federation - Size 7 - Tặng kèm Balo rút + Bơm tay + Kim Bơm + Túi lưới",399000,399000,0,0
TIKI,the-thao-da-ngoai,190081204,"Kính bơi trẻ em POPO 360 góc nhìn PANORAMA bảo vệ mắt cản tia UV, hạn chế sương mờ ngăn nước tuyệt đối",82000,87000,5000,6
TIKI,the-thao-da-ngoai,155759318,"Vành Mũ Bảo Hộ Che Nắng - Màu Ghi Đậm",45000,45000,0,0
TIKI,the-thao-da-ngoai,2431543,"Nón cổ động bóng đá các đội tuyển Sportslink - Brasil",42000,47000,5000,11
TIKI,the-thao-da-ngoai,196960178,"Vòng tập Yoga bản rộng 33 x 20cm nhựa ABS cao cấp không gai , chịu lực 200kg hỗ trợ tập các tư thế khó trong Yoga ,  bề mặt TPE 8mm , phù hợp tập ở nhà và các CLB trung tâm Yoga",277000,295000,18000,6
TIKI,the-thao-da-ngoai,94930202,"Mồi Câu Cá Rô Phi , Combo 1kg Cám CNF + 1 Chai Tinh Mùi Thái Lan M21 Chuyên Câu Cá Rô Phi",115000,115000,0,0
TIKI,the-thao-da-ngoai,12723399,"Bóng Rổ Prostar size 7 màu cam tặng kèm kim bơm bóng",115000,169000,54000,32
TIKI,the-thao-da-ngoai,96211952,"Đai điều chỉnh cột sống AOLIKES A-3106 Back Posture Corrector chống gù lưng",292000,489000,197000,40
TIKI,the-thao-da-ngoai,158587773,"Balo túi rút chống nước bụi TSLA phù hợp đi tập Gym bơi lội chạy bộ chơi thể thao",60000,60000,0,0
TIKI,the-thao-da-ngoai,185466935,"Khung Hỗ Trợ Tập Lưng, Nắn Chỉnh Cột Sống, Khung Định Hình Cột Sống, Hỗ Trợ Điều Trị Thoát Vị Đĩa Đệm, Đau Lưng, Vai Gáy - Chính Hãng Amalife",48000,48000,0,0
TIKI,the-thao-da-ngoai,188318508,"Dây Trục Câu Đài Buộc Sẵn 3260 Cước Câu Cá Tàng Hình Chuyên Câu Đài Cao Cấp DC28",7000,7000,0,0
TIKI,the-thao-da-ngoai,79445921,"Custom Ring -1 vòng cao su Babolat băng cán vợt màu ngẫu nhiên  (710026)",33000,35000,2000,6
TIKI,the-thao-da-ngoai,94107848,"Bộ Quần Áo Gym Nam,Chạy Bộ,Chơi Thể ThaoTanktop Kết Hợp Quần 2 Lớp Và Áo 3 Lỗ",219000,219000,0,0
TIKI,the-thao-da-ngoai,127947330,"Gậy Rung Đàn Hồi Tập Gym Tập Toàn Thân Cao Cấp Chính Hãng Đại Nam Sport",129000,200000,71000,36
TIKI,the-thao-da-ngoai,139055358,"Tạ Chì đeo chân và tay Tập Thể Lực loại tốt 2kg - 1 cặp - LYLYSPORTS",149000,149000,0,0
TIKI,the-thao-da-ngoai,188914638,"Quần Đùi Nam BIG SIZE FASVIN Từ 80 Đến 120KG Vải Gió Đẹp Hàng Nhà Máy Dùng Khi Thể Thao Hay Mặc Nhà D22173.HN",119000,238000,119000,50
TIKI,the-thao-da-ngoai,88802057,"Bông Chuyên Dụng Zippo",37000,39000,2000,5
TIKI,the-thao-da-ngoai,156628745,"Cầu đá lông gà, Cầu đá ống tuyển trắng HD111 Sportslink",19000,21000,2000,10
TIKI,the-thao-da-ngoai,432921,"Kính Bơi Trẻ Em Balance F268 - Hồng",35000,35000,0,0
TIKI,the-thao-da-ngoai,133933412,"[Combo] Xỏ Khuỷu Tay và Bó gối có miếng đệm bảo vệ - Hỗ trợ tập Yoga, Gym, chơi thể thao",127710,129000,1290,1
TIKI,the-thao-da-ngoai,147962437,"Giày Bóng Bàn Cao Cấp Màu Xanh , Màu Trắng",520000,520000,0,0
TIKI,the-thao-da-ngoai,24244892,"Đĩa Xoay Eo Sắt Tập Thể Dục Giảm Mỡ Bụng Thanh Xuân (Tặng 10 Khẩu Trang Màu Sắc Ngẫu Nhiên)",186000,186000,0,0
TIKI,the-thao-da-ngoai,74152643,"Giày patin thê thao BEAR dành cho bé có 3 màu hấp dẫn",450000,450000,0,0
TIKI,the-thao-da-ngoai,794378,"Cầu Lông Nhựa A Ngắn OAN6 - Giao Màu Ngẫu Nhiên",85000,85000,0,0
TIKI,the-thao-da-ngoai,34411016,"Đai bó đầu gối co dãn có đai cao cấp Sport AB30 - Đen trắng",79000,79000,0,0
TIKI,the-thao-da-ngoai,132815026,"Áo Bơi Nam Tay Dài Grey Navy Sobie",430000,430000,0,0
TIKI,the-thao-da-ngoai,87789122,"Balo cầu lông chính hãng ProKennex PRO21B01",648000,888000,240000,27
TIKI,thoi-trang-nam,125831790,"Quần Jogger nam jean co giãn JN351",250000,250000,0,0
TIKI,thoi-trang-nam,156199686,"Combo 4 quần lót nam Briefs Mr Mitas Basics viền êm ái",159000,299000,140000,47
TIKI,thoi-trang-nam,273187200,"Miếng Dán, Băng Keo Dán Lai Quần Ống Quần, Sửa Quần Áo, Cắt Ngắn Không Cần May Legaxi",11000,11000,0,0
TIKI,thoi-trang-nam,181785318,"Áo bay dài tay màu cỏ úa - vàng cốm, áo lao động, áo tập QS loại đẹp",130000,130000,0,0
TIKI,thoi-trang-nam,50614559,"Combo 4 Sịp Đúc Nam Lụa Sữa Cao Cấp Vải Siêu Mát thiết kế U Lồi phía trước mặc Thoải Mái Dễ Chịu - Nhiều Size Nhiều Màu để lưa chọn",319000,319000,0,0
TIKI,thoi-trang-nam,112646706,"ÁO KHOÁC NỈ HOODIES NAM NỮ PHONG CÁCH SIÊU ĐẸP , HỌA TIẾT CỰC MỚI , DÀNH CHO CÁC BẠN TRẺ THỜI TRANG 1HITSTORE1",95000,95000,0,0
TIKI,thoi-trang-nam,105275706,"Áo Thun Nam Polo Có Cổ Tay Ngắn Trơn Cao Cấp ZERO 5 Màu Hàn Quốc",189000,300000,111000,37
TIKI,thoi-trang-nam,67294572,"Áo Sơ Mi Nam Dài Tay Vải Lụa Chống Nhăn",109000,109000,0,0
TIKI,thoi-trang-nam,144171958,"Quần đùi ngủ  nam chất kate cotton mặc mát",52000,56000,4000,7
TIKI,thoi-trang-nam,161455980,"Áo Thun Nam PoLo Phối Màu Kẻ Chéo Cao Cấp Thời Trang ZERO",189000,360000,171000,48
TIKI,thoi-trang-nam,54446837,"Quần dài nam thể thao GOKING, lưng thun và dây rút co giãn thoải mái. Hàng hiệu cao cấp xuất khẩu",225000,225000,0,0
TIKI,thoi-trang-nam,37580438,"Quần Jogger Kaki Nam Phong Cách Trẻ Trung Năng Động Thời Trang VICERO",144000,250000,106000,42
TIKI,thoi-trang-nam,138748093,"Áo thun nam cổ tim ngắn tay đẹp nhiều màu đủ size ( có size lớn cho người 100 kg )",74260,79000,4740,6
TIKI,thoi-trang-nam,77239444,"Áo Ba Lỗ Nam Thoáng Mát ABL01",29000,29000,0,0
TIKI,thoi-trang-nam,169120359,"Combo 5 quần sịp nam, kiểu dáng ôm mông chất thun cotton thấm hút co giãn tốt - FORMEN SHOP - FM5QS005",139000,245000,106000,43
TIKI,thoi-trang-nam,20534277,"Áo Sơ Mi Nam Tay Ngắn Khatoco A1MN378S1-CNCR009-2101-N-M - Hồng Phối Xá",302400,378000,75600,20
TIKI,thoi-trang-nam,97823540,"Áo Khoác Big Size Áo Khoác Dù Nam Có Cổ Trụ Chống Nắng Chống Nóng Chống Lạnh Chống Gió 2 Lớp Phối Logo Sọt Thời Trang Nam Tính Hàn Quốc Giá Tốt AD70",169000,169000,0,0
TIKI,thoi-trang-nam,85086740,"Áo sơ mi nam màu trắng ngắn tay vải chống nhăn",108000,108000,0,0
TIKI,thoi-trang-nam,111477677,"Áo Sơ Mi Nam Ngắn Tay Kiểu Dáng Cơ Trưởng U886 Thời Trang Hàn Quốc Chất Cotton Pha Lụa Mềm Mại, Thoáng Mát, Chống Nhăn, Trẻ Trung, Năng Động- HÀNG CHÍNH HÃNG",219000,498000,279000,56
TIKI,thoi-trang-nam,176599682,"Quần kaki Nam Cao Cấp, Quần jogger kaki nam Chuẩn Hàng Xuất - QJKN01",97000,97000,0,0
TIKI,thoi-trang-nam,30031323,"Quần Tây Nam Không Ply Ống Ôm xám đậm Khatoco Q1M528S0-CNMA006-2007-0",199000,528000,329000,62
TIKI,thoi-trang-nam,21242706,"Áo Sơ Mi Trắng Nam Họa Tiết Bên Vai Phải",95000,95000,0,0
TIKI,thoi-trang-nam,161413668,"Bộ Quần Áo Thể Thao Nam Thời Trang Thiết Kế Cao Cấp Kiểu Dáng ZERO",219000,430000,211000,49
TIKI,thoi-trang-nam,128276418,"Quần jogger kaki nam nữ chất đẹp, co giãn",90000,90000,0,0
TIKI,thoi-trang-nam,162212127,"Quần lót nam quyến rũ sexy gợi cảm",45000,45000,0,0
TIKI,thoi-trang-nam,132097555,"Áo Đồng Phục Đầu Bếp Màu Đen Tay Ngắn",97000,97000,0,0
TIKI,thoi-trang-nam,68918584," Áo thun phối tay Cali",79000,125000,46000,37
TIKI,thoi-trang-nam,141259191,"Quần jogger unisex thể thao, quần ống rộng kiểu dáng jogger mặc nhà nam nữ vải TỔ ONG 3 màu năng động",80000,80000,0,0
TIKI,thoi-trang-nam,35193606,"[FREEMAN] Combo 5 quần lót nam 6034",156000,195000,39000,20
TIKI,thoi-trang-nam,151922857,"Áo khoác Cardigan Unisex Nam Nữ Thêu gấu - Chất Nỉ Bông Ngoại Mềm Mịn Bomber Cardigan, áo cardigan phối viền, áo cardigan phối 2 túi đẹp, áo khoác cardigan chống nắng, mặc ấm màu thu đông dễ phối đồ",95000,95000,0,0
TIKI,thoi-trang-nam,110730140,"Áo thun nam có cổ tay ngắn vải Thun Cotton Mềm mịn co giãn thoáng mát",74000,78000,4000,5
TIKI,thoi-trang-nam,85305836,"Áo ba lỗ nam trơn đủ màu chất cotton co dãn mềm mịn mát mẻ",98000,98000,0,0
TIKI,thoi-trang-nam,23296068,"Quần Lót BOXER Nam",199000,199000,0,0
TIKI,thoi-trang-nam,150685095,"Áo Thun Nam Cổ Tròn TSIMPLE phông trơn tay ngắn vải Cotton cao cấp chống nhăn chuẩn form MSSATTCX",149000,215000,66000,31
TIKI,thoi-trang-nam,32389756,"QUẦN SHORT KAKI NAM CO GIÃN CAO CẤP LƯNG THUN BT02",39000,39000,0,0
TIKI,thoi-trang-nam,164085080,"Áo Thể Thao Nam TSIMPLE cổ tròn tay ngắn tập gym vải thun lạnh thoáng mát co giãn chuẩn form AHRBC002",99000,149000,50000,34
TIKI,thoi-trang-nam,14847948,"Áo thun nam thoát nhiệt Nhật Bản GOKING siêu thoáng mát, áo phông nam cao cấp thấm hút mồ hôi, mặc như không mặc",159000,159000,0,0
TIKI,thoi-trang-nam,115125727,"áo lót nam_áo ba lỗ nam ledatex chất cotton thấm hút mồ hôi",24000,24000,0,0
TIKI,thoi-trang-nam,176599627,"Áo polo nam ngắn tay có cổ Vicenzo regular fit chuẩn hàng xuất, áo phông thun polo nam tay ngắn",75000,75000,0,0
TIKI,thoi-trang-nam,104064189,"Quần Jean Nam Co Giãn Phong Cách Thời Trang Hàn Quốc Cao Cấp T&L store ms46",128000,128000,0,0
TIKI,thoi-trang-nam,132814989,"Quần Đi Biển Nam 2 lớp Sobie Black",331500,390000,58500,15
TIKI,thoi-trang-nam,75955335,"Áo Khoác Hoodie Heavy Màu Vàng [ TẶNG 1 NÓN HEAVY ] Chất Nỉ Mềm Mịn Kiểu Dáng Trẻ Trung Dành Cho Cả Nam Và Nữ Đủ Size Team Heavy",159000,159000,0,0
TIKI,thoi-trang-nam,138557111,"Bộ PIJAMA CAO CẤP chất liệu cotton SIÊU MỀM MỊN, Full size L-3XL, trơn màu phù hợp mọi lứa tuổi",540000,540000,0,0
TIKI,thoi-trang-nam,179575398,"Áo thun Polo nam Novelty 210060 màu xanh da trời",274550,289000,14450,5
TIKI,thoi-trang-nam,178554426,"Áo sơ mi màu hồng pastel hiệu Amazing, dáng trẻ slim fit, phong cách Hàn Quốc, vải bamboo mềm mịn",185000,269000,84000,31
TIKI,thoi-trang-nam,34327056,"Quần short đũi nam phối màu phong cách Hàn Quốc sq502",90000,90000,0,0
TIKI,thoi-trang-nam,111710197,"Áo Sơ Mi Nam Ngắn Tay Mẫu TNFS Thời Trang Cao Cấp PONIVA Phong Cách Hàn Quốc Trẻ Trung, Lịch Lãm",125000,125000,0,0
TIKI,thoi-trang-nam,195622075,"Quần nỉ Jogger thể thao nam hàng Quảng Châu cao cấp - Quần nỉ nam nót lông cừu siêu ấm - Hàng chính hãng D Danido",189000,300000,111000,37
TIKI,thoi-trang-nam,117583592,"(XẢ KHO DIỆP TẾT) ÁO KHOÁC DÙ DẦY MỚI PHONG CÁCH CAO CẤP",155000,155000,0,0
TIKI,thoi-trang-nam,152348255,"Quần short Nam sọc caro vải kate - A102",149000,149000,0,0
TIKI,thoi-trang-nam,155269199,"Áo thun nam Novelty dài tay cổ tròn 4 màu lựa chọn",189000,269000,80000,30
TIKI,thoi-trang-nam,144227349,"Quần jean baggy nam MĐ Q902 form rộng, trẻ trung phong cách",179000,179000,0,0
TIKI,thoi-trang-nam,171939108,"Quần jogger nam nữ thể thao 3 sọc form ống rộng để suông hoặc rút dây bo gấu vải mịn mềm mát",120000,120000,0,0
TIKI,thoi-trang-nam,20991311,"Áo sơ mi trơn tay ngắn",300000,300000,0,0
TIKI,thoi-trang-nam,193132125,"Áo Hoodie Nỉ Nam Nữ Trơn From Rộng Unisex Chất Nỉ Cotton Bao Dày Không Đổ Lông",88000,88000,0,0
TIKI,thoi-trang-nam,19550754,"Áo sơ mi nam trơn, tay dài - Trắng - XXL",90000,90000,0,0
TIKI,thoi-trang-nam,98186464,"Hộp 3 Quần sịp Đùi Nam Sợi Nano Kháng Khuẩn Thoáng Mát Thấm Hút Mồ Hôi 3A",45900,45900,0,0
TIKI,thoi-trang-nam,173718599,"Quần jean nam co giãn dáng suông đẹp màu xanh đậm mẫu mới jean nam co gian",240000,240000,0,0
TIKI,thoi-trang-nam,196033255,"Áo sơ mi nam form rộng tay dài kiểu trẻ trung hàn quốc chất lụa mềm mịn mát ít nhăn- MRD04",105000,210000,105000,50
TIKI,thoi-trang-nam,113235477,"Quần đùi nam kate, quần đùi mặc nhà nam cotton Fezzio chính hãng big size",119000,238000,119000,50
TIKI,thoi-trang-nam,155564740,"Quần bò dài nam trung niên dáng thụng có đến size 36+ẢNH THẬT",523500,523500,0,0
TIKI,thoi-trang-nam,82940840,"Hộp 3 quần lót 5D nam cao cấp 3A-Quần lót nam boxer kháng khuẩn cao cấp",149000,149000,0,0
TIKI,thoi-trang-nam,76705826,"Sơ mi dài tay trung niên hàng loại 1 cao cấp vải mịn siêu mát sơ mi nam trung niên somi trắng",112000,112000,0,0
TIKI,thoi-trang-nam,98623160,"Quần Jean Nam Đẹp ️️ Quần Bò Nam Mẫu Mới Chất Liệu Denim Cao Cấp Thời Trang Chuẩn Hàng Shop Tô Tồ Shop - QJN44",135000,135000,0,0
TIKI,thoi-trang-nam,47312339,"Bộ 4 quần lót nam Munafie hàng dệt kim cao cấp (Có túi zip) - Quần sịp tam giác- WS17",66000,66000,0,0
TIKI,thoi-trang-nam,28544814,"Áo Thun Nam Cotton Xanh Rêu",54000,54000,0,0
TIKI,thoi-trang-nam,20678306,"Quần short thun nam vải da cá nhập Phúc An 1065 có size lớn  (oversize)",79000,79000,0,0
TIKI,thoi-trang-nam,51563792,"Combo 3 Chiếc Quần Lót Nam Tam Giác Thời Trang Kwin KBF037, Mềm Mại, Kháng Khuẩn, Khử Mùi - Hàng Chính Hãng",155000,195000,40000,21
TIKI,thoi-trang-nam,194205679,"Quần tây short nam 0 ply màu rêu Regular fit NQSMMDMT3R2201180",356000,375000,19000,5
TIKI,thoi-trang-nam,66370023,"Áo Khoác Dù Nam Cho Mưa LẠnh",134000,134000,0,0
TIKI,thoi-trang-nam,19550746,"Áo sơ mi nam trơn, tay dài - Trắng - S",90000,90000,0,0
TIKI,thoi-trang-nam,71926285,"BỘ QUẦN ÁO THỂ THAO BỘ ĐỒ NAM NỮ SIZE M L CHẤT THUN LẠNH",103000,103000,0,0
TIKI,thoi-trang-nam,97099486,"Áo sơ mi trơn tay dài Amazing, form slimfit Hàn Quốc, màu sắc đa dạng, trẻ trung, vải bamboo mềm mượt, thoáng mát",185000,269000,84000,31
TIKI,thoi-trang-nam,79721593,"Áo khoác sơ mi nam nữ có nón",104000,104000,0,0
TIKI,thoi-trang-nam,6963665,"Set 3 quần sịp đùi trunks Voga",219000,219000,0,0
TIKI,thoi-trang-nam,203930542,"You steal my heart, mã G126. Áo thun polo Goking, form unisex cho nam nữ, đội nhóm, công ty. Áo phông cổ bẻ đồng phục cao cấp, vải cá sấu 3D",178000,178000,0,0
TIKI,thoi-trang-nam,91927413,"Áo Thun Chibi Hero Team Mini World",59000,59000,0,0
TIKI,thoi-trang-nam,191127039,"Áo Khoác Dù Unisex Chống Nắng Phối Hoa Văn Nam Nữ RẺ ĐẸPÁo Khoác Gió Mùa Đông Cặp Đôi Couple Cực Ngầu Jacktes",94000,94000,0,0
TIKI,thoi-trang-nam,168856937,"Viettien - Áo sơ mi nam dài tay họa tiết 1N2012 regular",580000,580000,0,0
TIKI,thoi-trang-nam,186080721,"Áo Gile Nam Màu Đen 8 Nút Form Ôm Body",250000,500000,250000,50
TIKI,the-thao-da-ngoai,10595144,"Xà đơn treo tường gắn cửa đa năng độ dài tùy chỉnh giúp bạn tập gym tại nhà dễ dàng - 60-110",85000,113000,28000,25
TIKI,the-thao-da-ngoai,161497492,"Bộ 2 Tạ Tay Nhựa Bát Giác 3kg REEFIT (2 tạ 3kg, tổng 6kg)",45000,45000,0,0
TIKI,the-thao-da-ngoai,68595188,"Thảm Yoga Cao Su Định Tuyến PU (Tặng kèm Túi đựng Thảm Và Dây Buộc Thảm)",395000,600000,205000,34
TIKI,the-thao-da-ngoai,141298963,"Bóng Chuyền Da Chính Hãng OMEGA2000 - Tặng bơm, kim bơm, túi lưới - Quả bóng chuyền tiêu chuẩn cho người mới tập",126000,159000,33000,21
TIKI,the-thao-da-ngoai,102760833,"Xà Đơn Treo Tường Đa Năng Di Động 8 Trong 1 Chính Hãng  + Tặng Kèm Dây Đàn Hồi Đa Năng",1258000,2220000,962000,43
TIKI,the-thao-da-ngoai,70675831,"Bóng Tập Yoga 65cm Cao Cấp Bóng Gai Tặng Bơm bóng và Bộ Kim bóng dự phòng Loại dày 2mm",136000,239000,103000,43
TIKI,the-thao-da-ngoai,107326537," (HÀNG XỊN) Quần áo thể thao_thun lạnh phối lưới siêu mịn mát_Quần áo tập gym, chạy bộ, du lịch",249000,249000,0,0
TIKI,the-thao-da-ngoai,118859634,"Bao cát đấm bốc boxing,tập võ 3 lớp siêu bền,boxing ,Bao cát đấm bốc boxing loại treo",160000,160000,0,0
TIKI,the-thao-da-ngoai,81610036,"Quần Đi Biển Nam SPEEDO - 8-124330001",565000,565000,0,0
TIKI,the-thao-da-ngoai,146396099,"[Loại Tốt - Cao Cấp] Thảm tập yoga định tuyến PU cao su tự nhiên chống trơn trượt thấm hút mồ hôi + Dây Buộc Thảm Yoga Chuyên Dụng + Túi Đựng Thảm Cao Cấp Có Quai Đeo - Chính hãng dododios",449000,449000,0,0
TIKI,the-thao-da-ngoai,44060751,"Khung nắn chỉnh định hình, kéo dãn cột sống cổ - diện chuẩn chuyên thoái hóa đốt sống cổ, đau, mỏi nhức cổ",88500,88500,0,0
TIKI,the-thao-da-ngoai,52700173,"Quần tập Yoga Gym cho nữ dài trơn thiết kế cao cấp Hibi Sports Mã QD308",216000,270000,54000,20
TIKI,the-thao-da-ngoai,38100602,"Bộ 5 Dây Đàn Hồi, Dây Kháng Lực Tập Gym Chính Hãng Amalife",85000,85000,0,0
TIKI,the-thao-da-ngoai,188282664,"Cước câu cá tàng hình Nylon CK POWER cao cấp dây trục câu cá siêu bền DC7",85000,85000,0,0
TIKI,the-thao-da-ngoai,146553543,"[Mall] Đai chống gù lưng cho người lớn nam nữ, cải thiện vóc dáng, có nẹp tăng cường hiệu quả - Chính hãng dododios",147000,147000,0,0
TIKI,the-thao-da-ngoai,146285515,"Khăn ống cổ đa năng đi phượt chống nắng bụi gió lạnh vải thun lạnh thoáng mát dùng như khẩu trang",29000,29000,0,0
TIKI,the-thao-da-ngoai,135464078,"Hộp Đựng Phao Câu Cá Hộp Phao Câu Đài Xám 45cm Chuyên Dụng Đa Năng HP4",50000,50000,0,0
TIKI,the-thao-da-ngoai,118962492,"Lưới Lồng Bát Quái Đánh bắt cá - lồng bát quái xăm, chã",86000,86000,0,0
TIKI,the-thao-da-ngoai,76673066,"Băng Bảo Vệ Khớp Gối Thể Thao 360º VN017 | ATHLETE'S KNEE PROTECTOR ( 1 ĐÔI ). Phù hợp đá banh, chạy bộ, bóng chuyền, bóng rổ, cầu lông, leo núi, đạp xe, tập luyện thể hình, chấn thương đau nhức gối",285000,500000,215000,43
TIKI,the-thao-da-ngoai,72625214,"(Bộ 2 chiếc) Dây cuốn cổ tay cho người tập Gym, Băng Cổ Tay, Bảo Vệ Chấn Thương - Phụ Kiện Thể Thao - Sọc đỏ đen",65000,65000,0,0
TIKI,the-thao-da-ngoai,42923502,"Tạ đeo cổ chân, cổ tay hỗ trợ tập thể thao, tập gym, chạy bộ",129000,129000,0,0
TIKI,the-thao-da-ngoai,94156554,"Bộ Nút Bịt Tai Và Kẹp Mũi Silicon Chống Nước Khi Bơi Lội Chính Hãng Đại Nam Sport",29000,50000,21000,42
TIKI,the-thao-da-ngoai,54901682,"Móc khóa đa năng KH5011KD  CAO CẤP 13IN1 - Giao ngẫu nhiên",134000,134000,0,0
TIKI,the-thao-da-ngoai,118407659,"Giày Tennis Nam chuyên dụng Jogarbola JG-21006",627000,780000,153000,20
TIKI,the-thao-da-ngoai,135461678,"Dây Bảo Vệ Cần Câu Cá 2m - 15m Giá Rẻ Dây Bảo Vệ Cần Câu Đài PK4",18900,18900,0,0
TIKI,the-thao-da-ngoai,139336794,"Đai Bảo Vệ Đầu Gối, Miếng Đệm Đầu Gối, Bó Gối - YOGA QG, Miếng Lót Đệm Dày, Co Giãn Tạo Cảm Giác Thoải Mái Khi Sử Dụng, Tránh Va Đập, Trầy Xước Đầu Gối - Hàng chính hãng",82000,98000,16000,16
TIKI,the-thao-da-ngoai,154279945,"Quấn Cổ Tay Xỏ Ngón Bảo vệ cổ tay, tránh chấn thương cổ tay khi tập GYM, Yoga (1 Đôi )",58000,58000,0,0
TIKI,the-thao-da-ngoai,140094785,"Thảm Yoga TPE 1 Lớp 8mm Cao Cấp - YOGA QG, Độ Bám Cao, Chống Trơn Trượt, Mềm Mại, Thân Thiện Với Môi Trường, An Toàn Khi Tiếp Xúc Với Da - Hàng chính hãng",164000,175000,11000,6
TIKI,the-thao-da-ngoai,196923593,"Bộ dụng cụ hít đấy chống đẩy 34 lỗ mới , tập theo màu sắc, mỗi màu hỗ trợ các vùng cơ khác nhau, gấp gọn, tay cầm thoải mãi, phiên bản quốc tế",147250,155000,7750,5
TIKI,the-thao-da-ngoai,105534641,"Bao, Túi đựng Điện Thoại tới 7 Inch Đeo tay chạy bộ, Tập thể dục Rhino B141 Kháng nước, có thể cắm tai nghe",96000,170000,74000,44
TIKI,the-thao-da-ngoai,95278227,"THUN GIỮ CUỐN CÁN VỢT TENNIS BABOLAT (giao màu ngẫu nhiên )",35000,39000,4000,10
TIKI,the-thao-da-ngoai,59375941,"Bình nước thể thao tập gym kết hợp bình lắc whey shaker chất liệu TRITAN  dung tích 800ml CLEACCO dòng SHOKE  dung tích 800ml- tặng bóng khuấy",149000,255000,106000,42
TIKI,the-thao-da-ngoai,128724510,"Đai Treo Xà Kéo Giãn Cột Sống An Cốt Nam Cho Người Thoái Hóa, Thoát Vị",245000,264900,19900,8
TIKI,the-thao-da-ngoai,6913429,"Tạ đeo chân tay chạy bộ thể thao tập gym , tập thể hình chuyên nghiệp ( 1 đôi 1kg/chiếc )",189000,189000,0,0
TIKI,the-thao-da-ngoai,193514009,"Giày Thể Thao Nam Biti's Hunter X DSMH09800REU (Rêu)",883000,981000,98000,10
TIKI,the-thao-da-ngoai,89227040,"Lưỡi câu cá chép cá rô cá trê hộp 50 đến 100 cái tùy theo size",45000,45000,0,0
TIKI,the-thao-da-ngoai,89877527,"BĂNG BẢO VỆ KHỚP ĐẦU GỐI 360º VNSPORT - VN019 (Pro) - KNEE SUPPORT 360º VN019 PROFESSIONAL. Độc Quyền Tại VNSport - Hàng Cao Cấp Chính Hãng (1 Chiếc )",390000,490000,100000,20
TIKI,the-thao-da-ngoai,106503117,"Tấm Tank Bạt Che Lều Tăng Lều Che Nắng Bạt Lót Cắm Trại Dày Kích Thước 3mx3m Có Combo Cây Chống Kèm Dây Với Túi Đựng",379000,379000,0,0
TIKI,the-thao-da-ngoai,74362927,"LƯỚI RÀN ĐỒ PHƯỢT, LƯỚI RÀN BÌNH XĂNG",45000,45000,0,0
TIKI,the-thao-da-ngoai,139054194,"Dây Nhảy Boxing Muay Thái tập thể lực dài 2.6m - 3m, Dây nhảy cao su bản to nặng 500g cán gỗ cao cấp - LYLYSPORTS",99000,99000,0,0
TIKI,thoi-trang-nam,191055924,"Áo thun polo thời trang nam phong cách trẻ trung, lịch lãm - FORMEN SHOP - FMPS191",189000,250000,61000,24
TIKI,thoi-trang-nam,99483979,"Quần jean nam xước cao cấp vải jean co dãn hàng chuẩn shop Phuongnamshop20 kvp13",199000,199000,0,0
TIKI,thoi-trang-nam,132084938,"Áo Bếp Tay Dài Đồng Phục Đầu Bếp Màu Trắng Đen",126000,126000,0,0
TIKI,thoi-trang-nam,167429610,"Bộ Pijama nam kẻ caro chất liệu cotton cao cấp dày mịn, thoáng mát, size L-3XL",660000,660000,0,0
TIKI,thoi-trang-nam,138749879,"Áo phông nam cổ tròn chất cotton thun lạnh mềm, mịn , dáng body thời trang",109980,117000,7020,6
TIKI,thoi-trang-nam,195302427,"Áo thun ba lỗ NAM HOẠ TIẾT HOẠT HÌNH CỰC ĐẸP 2021 MẪU MỚI NHẤT HIỆN NAY",73000,73000,0,0
TIKI,thoi-trang-nam,22760805,"Áo thun nam cổ bẻ vải cá sấu,combo 3 áo - EZ306",397000,397000,0,0
TIKI,thoi-trang-nam,19553990,"Combo 5 Quần Sịp Nam Xuất Nhật Thông Hơi Co Giãn 4 Chiều Thoáng Mát Chất Sịn",84900,84900,0,0
TIKI,thoi-trang-nam,14997358,"Quần Bò Nam Trắng Trơn Chất Co Giãn JEANTRANG98 (Jean Trắng)",125000,125000,0,0
TIKI,thoi-trang-nam,165219220,"Quần Jean Nam Co Giãn Ống Đứng Dáng Đẹp Màu Xanh Đậm",180000,180000,0,0
TIKI,thoi-trang-nam,16546849,"Combo 5 Quần Lót Nam Tam Giác Nhật",108000,108000,0,0
TIKI,thoi-trang-nam,138207299,"Quần tây nam dáng ôm Hàn Quốc vải chống nhăn co giãn nhẹ",114000,114000,0,0
TIKI,thoi-trang-nam,197172576,"Áo hoodie nỉ bông WISH NOW unisex nam nữ (Ảnh thật/Có sẵn)",108000,108000,0,0
TIKI,thoi-trang-nam,183491271,"Quần Jean nam hàng cao cấp kiểu rách bụi ống ôm vừa co giãn",294000,294000,0,0
TIKI,thoi-trang-nam,98623465,"Quần Jean Nam Đẹp️️ Quần Bò Nam Mẫu Mới Chất Liệu Denim Cao Cấp Thời Trang Chuẩn Hàng Shop Tô Tồ Shop - QJN65",199000,199000,0,0
TIKI,thoi-trang-nam,144381066,"Quần Lửng Nam Dáng Alibaba Thụng Chất Liệu Thô Đũi",360000,360000,0,0
TIKI,thoi-trang-nam,133916548,"Quần short jean co giãn cho nam, màu trắng và đen, phong cách Hàn Quốc trẻ trung, năng động",145000,145000,0,0
TIKI,thoi-trang-nam,117090822,"Set Bộ Mặc nhà Gấu Cặp Đôi Nam Nữ HOT RẺ ĐẸP Quần Đùi Phối Áo Thun Form Rộng Tay Lỡ -Đồ Bộ Thun Hoạt Hinh siêu Cute",91000,91000,0,0
TIKI,thoi-trang-nam,137668107,"Áo Bomber Jacket/ Áo Khoác Dù 2 Lớp Style Bóng Chày in Bmoody Unisex Nam Nữ Couple Hot Trend",107000,107000,0,0
TIKI,thoi-trang-nam,192217886,"VẢI COTTON 100% ÁO THUN NAM TAY DÀI CỔ TRÒN VÀ CỔ TIM MÀU ĐEN TRẮNG THỜI TRANG",66740,90000,23260,26
TIKI,thoi-trang-nam,115093722,"Quần boxer nam cotton mịn mỏng thoáng khí co giãn tốt cao cấp, quần lót nam, sịp cotton trẻ trung K117",59000,59000,0,0
TIKI,thoi-trang-nam,166081740,"Combo 6 quần sip đùi kháng khuẩn AAA chất coton cao cấp co giãn 4 chiều",89000,99000,10000,10
TIKI,thoi-trang-nam,148848665,"Đồ bộ thun thể thao nam",249000,249000,0,0
TIKI,thoi-trang-nam,251563600,"I DO WHAT I WANT, mã G239. Áo thun in đẹp cho nam nữ, cặp đôi, gia đình. Áo phông Goking hàng hiệu cao cấp",69000,69000,0,0
TIKI,thoi-trang-nam,100369140," Quần đùi ngắn nam Fasvin R21448.HN vải gió chun mềm mại co giãn thoải mái vận động",129000,159000,30000,19
TIKI,thoi-trang-nam,46640497,"QUẦN JOGGER NỈ NAM 1 SỌC JG02",75000,75000,0,0
TIKI,thoi-trang-nam,21532933,"Áo Khoác Da Lót Lông Nam AN92",298000,298000,0,0
TIKI,thoi-trang-nam,172284477,"ALWAYS COOL, mã G106. Áo thun nam nữ in siêu đẹp. Áo phông thoát nhiệt GOKING hàng hiệu cao cấp",168000,168000,0,0
TIKI,thoi-trang-nam,100369201," Quần short Big Size thể thao nam Fasvin D20267.HN chất liệu cao cấp mềm mịn, co giãn tốt",169000,209000,40000,19
TIKI,thoi-trang-nam,93212275,"Áo Khoác Kaki Jean Wash Nam Nữ Unisex Có Cổ Bẻ Chống Lạnh Chống Nắng Chống Gió Chống Tia Uv Dày 2 Lớp Thời Trang Hàn Quốc Cao Cấp KK52 - ShopN6",199000,245000,46000,19
TIKI,thoi-trang-nam,79876518,"Quần Lót Nam Dạng Lưới Mềm Mại Thoáng Mát - Thiết Kế 2 Màu Kết Hợp Ấn Tượng - Co Dãn 4 Chiều Cao Cấp Brave Person B1139",130000,289000,159000,55
TIKI,thoi-trang-nam,128125119,"Quần short, đùi chất linner nam thương hiệu Fezzio chính hãng",69500,139000,69500,50
TIKI,thoi-trang-nam,71942265,"Bộ quần áo thể thao nam nữ in DINK",90000,90000,0,0
TIKI,thoi-trang-nam,46694203,"QUẦN TÂY NAM CO GIÃN CAO CẤP DN20010510 - đen - 31",85000,85000,0,0
TIKI,thoi-trang-nam,72308045,"Quần kaki nam chất kaki co giãn 4 chiều, ống côn thời trang, dáng ôm body trẻ trung, không bai xù, giặt được máy giặt",119000,119000,0,0
TIKI,thoi-trang-nam,180990072,"ÁO SƠ MI TAY NGẮN MÀU XANH ĐEN BIG SIZE NAM TỚI 130KG",185000,185000,0,0
TIKI,thoi-trang-nam,55045485,"Áo sơ mi nam cổ sơ mi dài tay chất vải thô đũi, thời trang trẻ, phong cách lịch lãm",159000,159000,0,0
TIKI,thoi-trang-nam,181990263,"Quần jeans dài Vistino",165000,165000,0,0
TIKI,thoi-trang-nam,183916651,"Áo Khoác Nỉ Bomber Cardigan Form Rộng Nam Nữ Logo Kiểu Dáng Bóng Chày Thời Trang",120000,120000,0,0
TIKI,thoi-trang-nam,86310871," Quần lót nam boxer sịp đùi nam dạng lưới thông hơi cao cấp",114000,114000,0,0
TIKI,thoi-trang-nam,73611098,"Quần tây âu nam dáng ôm trẻ trung năng động, chất tuyết mưa dày dặn không bai xù, size từ 45-80 kg, quần baggy đen co dãn",117000,117000,0,0
TIKI,thoi-trang-nam,164344210,"Áo PoLo Nam Ngắn Tay 7 Màu Thiết Kế Phong Cách Thời Trang Cao Cấp AVIANO",189000,360000,171000,48
TIKI,thoi-trang-nam,81159816,"Quần Jean Nam cao cấp chất bò siêu co dãnThương Hiệu Chandi, form đứng dáng đẹp mẫu mới siêu hot MR9034",184000,299000,115000,38
TIKI,thoi-trang-nam,114323545,"Áo Khoác Dù Nam Nữ Kiểu Bomber Thêu TM 21 Unisex Form Rộng",96000,96000,0,0
TIKI,thoi-trang-nam,56903242,"Quần Short Nam Kaki Phong Cách Thời Trang VICERO",159000,298000,139000,47
TIKI,thoi-trang-nam,144232133,"Quần Jean nam baggy Ống Rộng - quần bò nam- Jean nam dày phong cách ( màu đen)",120000,120000,0,0
TIKI,thoi-trang-nam,177309367,"Combo 2 quần đùi nam mở moi May 10 - màu ngẫu nhiên",90000,90000,0,0
TIKI,thoi-trang-nam,151801291,"MIẾNG ĐỘN QUẦN LÓT NAM - ĐỘN TRƯỚC SEXY - Loaị Nổi 3D",29000,29000,0,0
TIKI,thoi-trang-nam,70937555,"Áo khoác kaki nam 2 lớp thời trang SITAKI cao cấp AKK18",175000,175000,0,0
TIKI,thoi-trang-nam,122559240,"Quần đùi đũi nam,quần short nam mát mẻ QD06",149000,149000,0,0
TIKI,bach-hoa-online,118146312,"Cà Phê Decaf Robusta tách 97% cafeine vị đắng nhẹ, thơm thích hợp với người dùng cà phê bị mất ngủ hay say cafe từ Message Coffee - Gói 250 Gram - Nguyên Hạt",120000,179000,59000,33
TIKI,thoi-trang-nam,105231685,"đồ bộ thể thao mặc nhà, đồ bộ dạo phố chất thun thoáng mát, set bộ thể thao unisex ulzzang phong cách hàn quốc, đồ bộ hàn quốc, đồ bộ nam nữ, BỘ ĐỒ NAM / BỘ ĐỒ NỮ / BỘ QUẦN ÁO NAM /BỘ QUẦN ÁO THỂ THAO BỘ ĐỒ NAM NỮ",99000,99000,0,0
TIKI,thoi-trang-nam,112099693,"Áo Sơ Mi Dài Tay Lính Mỹ U458 US ARMY, Chất Liệu Vải Kaki Cao Cấp Thiết Kế Túi Hộp Phong Cách Loại Xịn- HÀNG CHÍNH HÃNG",379000,800000,421000,53
TIKI,thoi-trang-nam,76538210,"Áo Sơ Mi Nam Trắng Trơn cao cấp lụa không nhắn thương hiệu Chandi, Dáng ôm phong cách trẻ trung Mẫu A1111",151000,220000,69000,31
TIKI,thoi-trang-nam,107707462,"Quần Lót Nam vải thun lạnh 4 chiều lưng Hàn Quốc hiệu CITYMEN cao cấp, sịp nam - LMTK-HANAL (Giao màu ngẫu nhiên)",21000,21000,0,0
TIKI,thoi-trang-nam,98902559,"Quần lót nam đùi ngắn cotton iBasic PANM078",79000,119000,40000,34
TIKI,bach-hoa-online,9856783,"Yến Mạch Quaker Oats 1 Minute dạng hạt cán vỡ 4.52kg",215000,215000,0,0
TIKI,thoi-trang-nam,68354319,"Áo khoác dù 2 mặt thời trang nam M.O.N Boutique",109000,109000,0,0
TIKI,thoi-trang-nam,115453581,"Quần Kaki Nam Lính Mỹ USARMY U629 Cao Cấp, Kiểu Dáng Quần Túi Hộp Phong Cách Cực Ngầu -HÀNG CHÍNH HÃNG",538000,1139000,601000,53
TIKI,thoi-trang-nam,163553232,"Áo Phông Nam PoLo Ngắn Tay 4 Màu Kiểu Dáng Thời Trang Cao Cấp AVIANO",129000,258000,129000,50
TIKI,thoi-trang-nam,107453690,"OWEN - Áo sơ mi trắng OWEN chất Nano không nhăn (REGULAR/SLIM)",580000,580000,0,0
TIKI,thoi-trang-nam,107643677,"Quần Lót Nam lưng Hàn Quốc vải cotton co giãn 4 chiều hiệu CITYMEN cao cấp, đồ lót - LMTK-HANAC",46000,46000,0,0
TIKI,thoi-trang-nam,182134920,"Viettien - Áo sơ mi công sở nam dài tay màu trắng mới 390 regular",390000,390000,0,0
TIKI,bach-hoa-online,136981696,"Cát Min 8L-Cát vệ sinh cho mèo công nghệ Nhật siêu vón, khử mùi",49500,90000,40500,45
TIKI,thoi-trang-nam,104913896,"áo khoác dù JACKET KILL SYSTEM, Áo khoác dù kiểu bomber logo Kill System phong cách, ÁO KHOÁC DÙ NAM NỮ FORM RỘNG KILL SYSTEM SIÊU CHẤT MỚI VỀ, ÁO KHOÁC DÙ CÓ NÓN UNISEX ULZZANG PHONG CÁCH HÀN QUỐC",99000,99000,0,0
TIKI,thoi-trang-nam,3714775,"Combo 5 Quần Lót Nam Freeman 6023-CB5-M (Size",316000,395000,79000,20
TIKI,thoi-trang-nam,13690239,"Áo Khoác Da Nam Đen Black Leather ShopN6 Cao Cấp AKD21",269000,299000,30000,10
TIKI,thoi-trang-nam,90219503,"Áo Thun Nam Nữ From Rộng - Hình Con Mèo Cực Dễ Thương",26000,26000,0,0
TIKI,bach-hoa-online,58136661,"[Thùng 30 gói x 50gram] Cháo Tổ Yến Thịt Bằm - Yến Đại Phát, Yến thật, thịt thật, 4 gói gia vị, ăn liền, tiện lợi",254000,384000,130000,34
TIKI,bach-hoa-online,148598286,"1kg vôi DOLOMITE chuyên dùng cho ốc bưu nuôi, mềm vỏ, chậm lớn..",9000,9000,0,0
TIKI,bach-hoa-online,138811616,"Bột cải xoăn kale Dalahouse 60gr (Mẫu mới gồm 20 tuýp tiện dụng) - Nguyên chất sấy lạnh - Detox thanh lọc cơ thể - Đạt tiêu chuẩn Châu Âu",130500,145000,14500,10
TIKI,bach-hoa-online,77283156,"Trà sữa trân châu đường đen Yoki 400g",61000,61000,0,0
TIKI,bach-hoa-online,73733859,"Mận Khô Smile Nuts hộp 315g | Nhập khẩu từ Chile (Khô tự nhiên trên cát nóng, giữ nguyên hương vị, khác biệt với loại sấy khô) | Chilean Prunes 315g",102000,136000,34000,25
TIKI,bach-hoa-online,105172383,"Combo 6 Gói Gia Vị Nêm Sẵn Aji-Quick® Bột Tẩm Khô Chiên Giòn 42g/Gói",39000,39000,0,0
TIKI,bach-hoa-online,152815132,"Hỗ trợ giảm đau họng Ricola Shweizer Krauterzucker chứa 13 loại thảo mộc đem đến cảm giác dịu nhẹ cổ họng và thơm mát (dạng kẹo) - OZ Slim Store",94000,208000,114000,55
TIKI,bach-hoa-online,271617966,"Thùng 24 Ly Mì Bò NGON NGON VIFON (60g / Ly)",69600,69600,0,0
TIKI,thoi-trang-nam,73236732," Áo thun tay lỡ cotton trơn [ áo thun tay lỡ unisex nam nữ mặc được",34000,34000,0,0
TIKI,thoi-trang-nam,145757423,"Quần Tây Nam Oscar Slim Fit - OCMPKSE 012 - GRY",449000,1290000,841000,65
TIKI,bach-hoa-online,273239458,"Bột Ngọt VEDAN 454g",38000,38000,0,0
TIKI,bach-hoa-online,20700960,"Trà Hoa Nhài Sấy Khô Mộc Sắc Nguyên Bông 200g",90000,90000,0,0
TIKI,bach-hoa-online,248162910,"Hạt dinh dưỡng mix 7 loại TANU NUTS , hạt ngũ cốc bà bầu gồm macca, óc chó, hạnh nhân, điều, nho, xoài, việt quất",157000,179000,22000,12
TIKI,bach-hoa-online,8021518,"Sữa hạt siêu dưỡng Dr OatCare",730000,730000,0,0
TIKI,bach-hoa-online,70689218,"Combo 3 gói Xốt Gia Vị Hoàn Chỉnh - Thịt Kho Tàu 80g",38400,38400,0,0
TIKI,bach-hoa-online,175687484,"Combo 2 gói Cà Phê Rang Xay Culi Highlands Coffee (200g)",158000,190000,32000,17
TIKI,bach-hoa-online,161250554,"Máng ăn tự động cho chim , gà, bồ câu, vẹt, cu gáy, yến phụng",35000,35000,0,0
TIKI,thoi-trang-nam,105678723,"Quần jean nam quần bò màu trắng trơn và trắng rách gối cá tính dễ phối đồ chất jean bò co dãn thoải mái vận động",199000,199000,0,0
TIKI,bach-hoa-online,141734889,"Trà hoa ngũ cốc thảo mộc Brown Rice thanh nhiệt detox ngủ ngon giảm stress 500gr",100000,100000,0,0
TIKI,bach-hoa-online,162730590,"Thức Ăn Cho Chó Poodle Taste Of The Wild Bao 500g - Appalachian Valley Thịt Nai & Đậu Garbanzo",129000,129000,0,0
TIKI,bach-hoa-online,194023184,"Măng ớt Hải Yêu 1kg, măng ớt mác mật Lạng Sơn, siêu thơm, siêu ngon, không phụ gia, chất bảo quản",37000,50000,13000,26
TIKI,bach-hoa-online,13715503,"Bột chiên gà giòn KFC Karaage túi 500G - Hàng nhập khẩu chính hãng Malaysia",80000,80000,0,0
TIKI,thoi-trang-nam,76301321,"Quần Lót Nam tam giác vải cotton 2 chiều lưng CITYMEN, đồ lót - LMTK-CTM2C",25000,25000,0,0
TIKI,bach-hoa-online,216401083,"Trà Dưỡng Nhan 7 Vị Hộp 30 Túi Lọc x 10Gr Của Siêu Thị Thiên Nhiên Giúp Giảm Cân, Giữ Dáng, Đẹp Da",4999,4999,0,0
TIKI,thoi-trang-nam,134647757,"Quần lót nam ARISTINO dáng Brief, quần sịp tam giác nam chất liệu cotton mềm mại, thoáng mát - ABF03707",79500,95000,15500,16
TIKI,thoi-trang-nam,190515998,"Quần lót nam boxer CITYMEN lưng Hàn Quốc cao cấp vải cotton co dãn 4 chiều mềm mại thoáng khí thấm hút tốt, quần xịp sịp đùi nam bao đổi trả 90 ngày",56000,56000,0,0
TIKI,bach-hoa-online,181377479,"Bột cần tây Dalahouse giúp giảm cân, thanh lọc cơ thể nguyên chất",119000,119000,0,0
TIKI,thoi-trang-nam,171049945,"Quần Bò Nam cao cấp thương hiệu Chandi, chất jean co dãn mẫu mới nhất MD22",194000,350000,156000,45
TIKI,thoi-trang-nam,20146794,"Quần Jean Nam Xanh Đậm Hàn Quốc XANHDAM52 - Xanh Đậm",134000,134000,0,0
TIKI,thoi-trang-nam,114536004,"Combo 3 quần lót nam thun brief Espresso iBasic PANM102",228000,297000,69000,23
TIKI,bach-hoa-online,75986346,"Sữa Tiệt Trùng Có Đường VPMilk Grow+ Vị Dâu Hộp 180ml (Thùng 48 Hộp)",423100,423100,0,0
TIKI,bach-hoa-online,173551153,"Trà râu ngô rau má Đại Uy - Thanh nhiệt giải độc",19000,19000,0,0
TIKI,bach-hoa-online,566902,"Hạt Nêm Aji-ngon Heo 900g",70700,75894,5194,7
TIKI,thoi-trang-nam,81938009,"Áo hoodie nam / áo hooodie nữ / áo hoodie form rộng / áo khoác nam có nón trùm đầu / áo hoodie cặp đôi / áo khoác cặp đôi in con hạc",59000,59000,0,0
TIKI,bach-hoa-online,49664783,"Trà tim sen - Cao cấp",90000,90000,0,0
TIKI,bach-hoa-online,149999288,"1kg hạt trộn dành riêng cho yến phụng, finch, 7 màu, manh manh và các loài chim cỡ nhỏ",46500,46500,0,0
TIKI,thoi-trang-nam,48275273,"COMBO 05 Quần đùi nam c mềm mát (mẫu caro < 80kg )",93000,93000,0,0
TIKI,thoi-trang-nam,160902809,"Quần Jogger Nam LAMPOS, Cotton Cao Cấp, Siêu Co Giản - Thoáng Mát - Siêu Bền (Màu đen)",195000,195000,0,0
TIKI,bach-hoa-online,85090399,"Đường ăn kiêng La Hán Quả Saraya Lakanto MonkFruit Trắng, 0 Calo, 0 tăng đường huyết, 0 biến đổi gen - 180g (3gx60que)",205000,205000,0,0
TIKI,bach-hoa-online,23084501,"COMBO TRÀ ATISÔ KHÔNG ĐƯỜNG VINAMILK VFRESH",140000,140000,0,0
TIKI,thoi-trang-nam,22620760,"Quần Jean Nam Cao Cấp Co Giản Mạnh m 5 6 7 8",105000,105000,0,0
TIKI,thoi-trang-nam,137611546,"Áo Thun Thể Thao Nam TSIMPLE cổ tròn tay ngắn tập gym vải thun lạnh thoáng mát co giãn chuẩn form MSSAHRBC",109000,149000,40000,27
TIKI,bach-hoa-online,73661212,"Cá Ngừ Cắt Khúc Ngâm Dầu Hạ Long - 115/175g",42570,47300,4730,10
TIKI,bach-hoa-online,40798356,"Đặc sản Tiền Giang - Gạo Ngon Đặc Sản ST24 (2kg) - OCOP 4 SAO",55000,63000,8000,13
TIKI,bach-hoa-online,57799580,"Combo 2 hũ Ớt Bột Hàn Quốc 45gr Dh Foods",40900,40900,0,0
TIKI,bach-hoa-online,52257723,"Combo Trà ổi giảm cân Orihiro và Trà diếp cá thải độc mát gan Dokudami Orihio Nhật Bản",215000,350000,135000,39
TIKI,bach-hoa-online,55567060,"500G BÁNH GẠO TOPOKKI HÀN QUỐC",42000,42000,0,0
TIKI,bach-hoa-online,10409795,"Lốc 6 Lon Cà Phê Sữa Highlands Coffee (235ml/Lon)",90000,90000,0,0
TIKI,bach-hoa-online,109245487,"[Lốc (06) lon 330ml] Bia Black Đại Việt, Bia đen sản xuất theo luật bia tinh dòng của Bia Đức, không hóa chất, Bia việt dành cho người có gu",165000,165000,0,0
TIKI,thoi-trang-nam,168994241,"Áo sơ mi nam Novelty ngắn tay trơn màu 171140N vạt ngang",169000,469000,300000,64
TIKI,bach-hoa-online,98796201,"LẠP XƯỞNG TÔM COMBO 1KG - MỖI BỊCH 500G",129000,240000,111000,46
TIKI,bach-hoa-online,123152630,"Fay Repell ngăn chó mèo phóng uế, cắn phá đồ đạc, khử mùi hôi",49000,49000,0,0
TIKI,the-thao-da-ngoai,71681892,"Băng Quấn Cổ Tay Đàn Hồi Hỗ Trợ Khớp Cổ Tay Khi Chơi Thể Thao Gym Tennis [Tặng Móc Dán Tường Treo Đồ",60000,60000,0,0
TIKI,the-thao-da-ngoai,77578726,"Găng Tay tập Gym Có dây Quấn Trợ Lực Cổ Tay VNS002 (WEIGHT LIFTING GLOVES), Găng Tay Tập Gym Cao Cấp Có Phủ Da Trên Mu bàn Tay, Chống Chai Sần Lòng Bàn Tay, Bảo Vệ Khớp Cổ Tay - M",350000,450000,100000,22
TIKI,the-thao-da-ngoai,84881067,"Quần bơi chống nắng nữ SPEEDO - SOJ20023",533000,1065000,532000,50
TIKI,the-thao-da-ngoai,67140999,"Con lăn massage cao cấp xốp đúc REXCHI Tập yoga, Xoa bóp, Phục hồi cơ bắp- Con lăn bọt xốp  tròn tập thể thao",179000,179000,0,0
TIKI,the-thao-da-ngoai,41225158,"Túi Đựng Thảm Tập Yoga Cao Cấp miDoctor",69000,69000,0,0
TIKI,the-thao-da-ngoai,14926065,"Băng Đô Trán Thể Thao Cao Cấp Bản To",40000,40000,0,0
TIKI,the-thao-da-ngoai,50771842,"Cặp Tạ Tay Cao Cấp Brosman",139000,139000,0,0
TIKI,the-thao-da-ngoai,130467474,"Giá treo huy chương điền kinh phối phong cảnh. Kt 58x18cm",429000,429000,0,0
TIKI,the-thao-da-ngoai,72029177,"Ghế Xếp Du Lịch, Dã Ngoại Cao Cấp ",555000,555000,0,0
TIKI,the-thao-da-ngoai,253100615,"Banh Bóng Rổ Graffiti - Bóng rổ người lớn, trẻ em - Size 5, size 7 - Tặng Balo Rút, Kim Bơm và Túi Lưới",164000,164000,0,0
TIKI,the-thao-da-ngoai,4693829,"Bộ 2 Tạ tay cao cấp Thái Lan 2Kg BG",259000,499000,240000,48
TIKI,the-thao-da-ngoai,125509330,"Bộ quần áo bóng đá đội tuyển Đức- Áo bóng đá mẫu mới - Bộ đồ bóng đá đẹp",94000,94000,0,0
TIKI,the-thao-da-ngoai,139934254,"Ghế Câu Cá Rằn Ri Không Tựa - Cần Câu Top1 VN",54000,54000,0,0
TIKI,the-thao-da-ngoai,2232473,"Dây Dù Tròn Nhỏ (21m)",42000,42000,0,0
TIKI,the-thao-da-ngoai,209906218,"Băng Nẹp Gối H5 Có Nẹp Nhôm Hỗ Trợ Sau Mổ Dây Chằng Chéo Knee Pad Chính Hãng Aolikes (1 Chiếc)",205000,205000,0,0
TIKI,the-thao-da-ngoai,170758139,"Tấm Trải Lều Cách Nhiệt Naturehike NH20FCD03",200000,200000,0,0
TIKI,the-thao-da-ngoai,50355808,"Lưới Đánh Bắt Cá - Lưới Bát Quái thiết kế tiện lợi, hiệu quả cao - lồng ô tiện dụng",25800,25800,0,0
TIKI,the-thao-da-ngoai,55052620,"Nón Bơi Vải PU Cleacco Cao Cấp, mềm mại, kiểu dáng năng động ,dành cho vận động viên chuyên nghiệp hoặc người có sở thích đi bơi mỗi ngày, màu sắc đa dạng - Hàng Chính Hãng BORO SPORT",99000,174000,75000,43
TIKI,the-thao-da-ngoai,138810456,"Cuốn cán vải cầu lông, tenis cuộn 5m",80000,80000,0,0
TIKI,the-thao-da-ngoai,156025480,"Mồi Mềm Chuyên Dùng Cho Câu Lure.mồi cá mềm dùng câu cá lóc",19900,19900,0,0
TIKI,the-thao-da-ngoai,48067779," THÙNG BÓNG TENNIS WILSON (Thùng 18 lon Hộp 4 trái)",3699000,4090000,391000,10
TIKI,the-thao-da-ngoai,87667718,"Lưới Bát Quái Bắt Cá, Tôm, Cua, Lươn, Trạch",26996,26996,0,0
TIKI,the-thao-da-ngoai,71887422,"Ván Trượt Đạt Chuẩn Thi Đấu Mặt Nhám Bánh Cao Su 80cm Chính Hãng Đại Nam Sport",269000,500000,231000,46
TIKI,the-thao-da-ngoai,41333562,"GEL LÀM NÓNG STARBALM WARM GEL",220000,220000,0,0
TIKI,the-thao-da-ngoai,170097847,"Parallettes - Dụng cụ hỗ trợ chống đẩy, hít đất, chồng chuối, planche, calisthenics, street workout (màu gỗ tự nhiên)",105000,105000,0,0
TIKI,the-thao-da-ngoai,708419,"Bao Tay Tập Yoga Chống Trượt Sportslink",34000,113000,79000,70
TIKI,the-thao-da-ngoai,46254823,"Kìm Bóp Tay Chữ A Cao Cấp Tập Cơ Tay Săn Chắc Khỏe Khoắn",24000,35000,11000,31
TIKI,the-thao-da-ngoai,186638779,"Túi Đeo Bụng Chạy Bộ Chống Nước Teement TM01, Đai Đeo Điện Thoại Chạy Bộ, Túi Đeo Hông Chạy Bộ Phản Quang -hàng Chính Hãng",75000,75000,0,0
TIKI,the-thao-da-ngoai,137764738,"(cần câu tay) cần câu HANDING ĐIẾU VƯƠNG 6h carbon siêu khỏe",160000,160000,0,0
TIKI,the-thao-da-ngoai,2232471,"Võng Dù Túi Lính Mỹ (1m4 x 2m2)",90000,90000,0,0
TIKI,the-thao-da-ngoai,114011137,"Dây Kháng Lực Tập Mông MiniBand Chính Hãng Aolikes chất liệu Vải Polyeste Cotton",58410,64000,5590,9
TIKI,the-thao-da-ngoai,85095747,"Giày Bata Học Sinh Học Thể Dục Chạy Bộ Cao Cấp",250000,250000,0,0
TIKI,the-thao-da-ngoai,52250162,"Áo tập Yoga Gym Croptop cho nữ Hibi Sports Mã CR805 có mút nâng ngực bên trong",306000,340000,34000,10
TIKI,the-thao-da-ngoai,189590439,"Combo 3 Đôi Tất Xỏ Ngón  Chạy Bộ Marathon Đạp Xe Leo Núi Aonijie E4801",480000,480000,0,0
TIKI,the-thao-da-ngoai,154934304,"Cần câu tay trúc xanh 3h chất liệu chuẩn carbon",17700,17700,0,0
TIKI,the-thao-da-ngoai,17455523,"Đai Nẹp Nắn Ngón Chân Cái Correcting Belt Of Thumb AOLIKES YE-1051",117000,124000,7000,6
TIKI,the-thao-da-ngoai,8128168,"Túi đeo tay đựng điện thoại chạy thể dục đa năng",35000,35000,0,0
TIKI,the-thao-da-ngoai,90834404,"Xà đơn gắn cửa mẫu mới 2022 có khóa chống xoay cải tiến + Livo cân bằng xà",278000,278000,0,0
TIKI,the-thao-da-ngoai,68247320,"Bộ Tạ Tập Tay Đa Năng Điều Chỉnh 2 in 1 Kết Hợp Tạ Đẩy (40kg)",789000,1000000,211000,21
TIKI,the-thao-da-ngoai,89475796,"Xà đơn treo tường, gắn cửa 2021 điều chỉnh 72cm-110cm và 93cm-140cm nặng 2kg, 2.8kg -Mẫu TG02",253000,400000,147000,37
TIKI,may-anh,15669129,"Micro Thu Âm Gắn Máy Rode Videomic Pro+ - Hàng Chính Hãng",7860000,7860000,0,0
TIKI,may-anh,7145663,"Túi đựng máy ảnh vải Caravan da chống thấm nước DG068",799000,799000,0,0
TIKI,may-anh,195867388,"Camera hành trình xe tải Wintosee H5- Không GPS - dây cam sau 15m",1389000,1389000,0,0
TIKI,may-anh,252272278,"Camera IP wifi không dây IMOU F42P, F42FP, F42FEP siêu nét đàm thoại 2 chiều - Hàng chính hãng",779000,1300000,521000,40
TIKI,may-anh,22561927,"Camera IP Wifi Ngoài Trời NetCAM NTL 2.0 Full HD 1080P - Hàng Chính Hãng",569000,569000,0,0
TIKI,may-anh,177463953,"Flycam DJI Mavic Air 2S Combo - Hàng chính hãng",31690000,31690000,0,0
TIKI,may-anh,20244830,"Máy Ảnh Mini Cho Bé Kèm Thẻ Nhớ 32G - Máy Chụp Hình Mini (Giao Mẫu Ngẫu Nhiên)",499000,499000,0,0
TIKI,may-anh,168042646,"Flycam ZLRC SG108 Pro, Động cơ không chổi than, Gimbal chống rung 2 trục - Hàng nhập khẩu",2349000,2349000,0,0
TIKI,may-anh,28079324,"Camera Hành Trình Hai Camera Kép Xoay 180 Độ Góc Siêu Rộng X8000 Kèm Định vị GPS",890000,890000,0,0
TIKI,may-anh,72040737,"Camera Hành Trình Dành Cho Xe Máy Kèm 2 Camera Sau Chống Nước Cao Cấp MT208",741000,780000,39000,5
TIKI,may-anh,127120714,"máy chụp hình của bé màu xanh ngọc - tặng thẻ nhớ 32G",290000,290000,0,0
TIKI,may-anh,7886763,"Ống nhòm một mắt Konus Small 2 7-17x30 - Hàng chính hãng",1500000,1500000,0,0
TIKI,may-anh,195867355,"Tặng thẻ xịn 32CAMERA HÀNH TRÌNH 4K WINTOSEE V8 HÌNH ẢNH SIÊU NÉT, CẢNH BÁO THÔNG MINH ADAS CÓ GPS",1489000,1489000,0,0
TIKI,may-anh,168501634,"12 inch Màn hình cảm ứng IPS chiếu hậu ô tô máy ảnh ghi hình với thẻ nhớ MICRO SD 64G (4K) WIFI 2160P + 1080P",2992000,2992000,0,0
TIKI,may-anh,43107996,"Ống Nhòm Một Mắt Tầm Nhìn 8000m - Hàng Nhập Khẩu",88000,88000,0,0
TIKI,may-anh,55617977,"Pin Máy Ảnh Sony Np Fz100 Ravpower - Chính hãng",599999,599999,0,0
TIKI,may-anh,5899493,"Tủ Chống Ẩm Andbon AD-30C(30 lít) - Hàng Nhập Khẩu",1349999,1349999,0,0
TIKI,may-anh,189698204,"Gimbal Zhiyun Smooth Q4 Combo - Tay cầm chống rung 3 trục dành cho điện thoại tích hợp đèn Led xoay 180 độ ấn tượng- Hàng nhập khẩu",2549000,3000000,451000,15
TIKI,may-anh,31246395,"Camera Hành Trình Wifi 1080p Full HD Dành Cho Ô Tô FC106T  Cao Cấp AZONE",536750,565000,28250,5
TIKI,may-anh,19890061,"Dây đeo ngực cho camera hành trình, camera hành động",69000,69000,0,0
TIKI,may-anh,25625706,"Camera Hành Trình Dành Cho Xe Máy Kèm 2 Camera Sau Chống Nước Cao Cấp MT208 AZONE",741000,780000,39000,5
TIKI,may-anh,109885923,"Túi máy ảnh Safrotto SF003, Hàng chính hãng",1099999,1099999,0,0
TIKI,may-anh,40024125,"THẺ NHỚ SONY 64GB SDXC UHS-II 277MB/S (SF-M64/T2) | Hàng Chính Hãng",1600000,1600000,0,0
TIKI,may-anh,109545963,"Chân máy ảnh Monopod Coman DK327AQ5S, Hàng chính hãng",2649999,2649999,0,0
TIKI,may-anh,205476178,"Camera Wifi Ezviz C1C CS-C1C-E0-1E2WF 1080P - Hàng Chính Hãng",550000,590000,40000,7
TIKI,may-anh,124276374,"Camera Hành Trình Xe Máy Chống Nước FULL HD 1080P A9",188000,188000,0,0
TIKI,may-anh,97379586,"Gimbal chống rung Zhiyun Smooth Q3 - Hàng Nhập Khẩu",1799000,1799000,0,0
TIKI,may-anh,70824025,"Kính viễn vọng  Carson RP-200SP zoom 25-56x80mm đi kèm với một bộ điều hợp điện thoại thông minh - Hàng chính hãng",11800000,11800000,0,0
TIKI,may-anh,57315763,"Ống nhòm một mắt chống nước Carson WM-025 BLACKWAVE - Hàng chính hãng",1630000,1630000,0,0
TIKI,may-anh,4688661,"Chân Máy Tripod Benro Ismart IS05 - Hàng Nhập Khẩu",1264000,1264000,0,0
TIKI,may-anh,212236083,"Camera Wifi Ezviz C3X 2MP 1080P Ngoài Trời Bản Mắt Kép, Có Màu Ban Đêm, AI Thông Minh - Hàng Chính Hãng",1799000,2900000,1101000,38
TIKI,may-anh,160357978,"Camera S12 Dùng Sim 4G Quay 4K FullHD 1080P Siêu Nét - PIN 2-3 Ngày Quan Sát Báo Động Chống Trộm Chế Độ PIR Hồng Ngoại Đen",1250000,1250000,0,0
TIKI,may-anh,175814384,"Camera IP wifi trong nhà Imou Ranger 2C - IPC-TA22CP-D - Hàng chính hãng",464000,464000,0,0
TIKI,may-anh,81206309,"Camera Eufy Security Indoor Cam 2K Công nghệ AI Âm thanh 2 chiều - Hàng Chính Hãng",780000,930000,150000,16
TIKI,may-anh,48428913,"TRIPOD MÁY ẢNH, MÁY QUAY CHUYÊN NGHIỆP CAO 1.65M YUNTENG VCT-690 hàng chính hãng",499999,499999,0,0
TIKI,may-anh,24200491," Ống nhòm đêm cao cấp có quay phim, chụp ảnh kỹ thuật số Carson NV-250 Aura Plus - Hàng chính hãng",13400000,13400000,0,0
TIKI,may-anh,23478407,"Camera hành trình SJCAM A10 - Hàng Nhập Khẩu",2386000,2479000,93000,4
TIKI,may-anh,201891429,"Tay cầm gimbal DJI Osmo Mobile SE - Gimbal chống rung điện thoại ổn định mượt mà với 3 trục, tính năng active track phiên bản nâng cấp - Hàng chính hãng",2288000,2500000,212000,8
TIKI,may-anh,178077780,"Camera Wi-Fi EZVIZ BC2 Không Dây, FHD 1080P, Pin Sạc 2000 mAh, Đàm Thoại 2 Chiều - Hàng Chính Hãng",1599000,2200000,601000,27
TIKI,may-anh,194133335,"Camera Wifi Trong Nhà Ngoài Trời PTZ EZVIZ C8W 4MP 2K+ Quay Quét 355 độ Tích Hợp Ai - Đàm Thoại 2 Chiều - Có Màu Ban Đêm - Hàng Chính Hãng",1350000,1350000,0,0
TIKI,dien-tu-dien-lanh,195715444,"Tủ Lạnh Mini 20L Mặt Gương, Có hệ thống đèn led 3 chức năng, Tủ lạnh 20L mặt gương có đèn led 2 chiều nóng lạnh dùng cho gia đình, xe hơi - Giao hàng toàn quốc",1658000,1899000,241000,13
TIKI,dien-tu-dien-lanh,87941161,"Smart Tivi Crystal Samsung 4K 50 inch UA50AU8000",9900000,9900000,0,0
TIKI,dien-tu-dien-lanh,195979566,"Tủ lạnh LG Inverter 635 lít GR-D257WB - Hàng chính hãng [Giao hàng toàn quốc]",27080000,35990000,8910000,25
TIKI,dien-tu-dien-lanh,98888600,"anten MOBITV ,KÈM DÂY CẤP NGUỒN 5V ,DÂY ANTEN 15M HÀNG CHÍNH HÃNG DÙNG CHO TIVI TÍCH HỢP DVB T2 và ĐẦU THU TRUYỀN HÌNH SỐ DVB T2",99000,99000,0,0
TIKI,dien-tu-dien-lanh,191093025,"Tủ Lạnh 2 Cánh Panasonic 268L NR-TV301BPKV - Diệt vi khuẩn 99.99% - Hàng Chính Hãng - Giao Toàn Quốc",10390000,11990000,1600000,13
TIKI,dien-tu-dien-lanh,20997533,"Khung treo tivi nghiêng mâm áp tường 19 - 42 inch M43N - Hàng chính hãng",210000,210000,0,0
TIKI,dien-tu-dien-lanh,109776740,"Máy giặt mini tại xô HW-150W giặt đồ cho bé giặt quần áo trắng đồ lót và cho sinh viên ở trọ",799000,799000,0,0
TIKI,dien-tu-dien-lanh,24429103,"Android Tivi Box MXQ Pro 4K Ram 1GB - Rom 8GB (xem phim, truyền hình, game online thỏa thích)",560000,560000,0,0
TIKI,dien-tu-dien-lanh,53135753,"Tủ đông Hòa Phát HCF-106S1N1 - Hàng chính hãng",4900000,4900000,0,0
TIKI,dien-tu-dien-lanh,104744225,"CHÂN CAO SU CHỐNG RUNG CHỐNG LẮC DÙNG CHO MÁY GIẶT ,TỦ LẠNH...BỘ 4 CÁI ,BẢO VỆ THIẾT BỊ GIA ĐINH.",22999,22999,0,0
TIKI,dien-tu-dien-lanh,122420956,"Dàn Anten thông minh cho tivi và thu sóng đầu KTS DVB - T2 ( 15m dây và 1 đầu cắm)",99000,99000,0,0
TIKI,dien-tu-dien-lanh,93088617,"Smart Tivi Samsung 4K 50 inch UA50AU7700",9790000,9790000,0,0
TIKI,dien-tu-dien-lanh,24413651,"Android tivi box TX3 mini bản Ram 2G - Rom 16G (xem phim, truyền hình, game online thỏa thích) - Hàng nhập khẩu",599000,599000,0,0
TIKI,dien-tu-dien-lanh,65410485,"Máy giặt LG Inverter 9 kg FV1409S4W - Chỉ giao Hà Nội",8699000,8699000,0,0
TIKI,dien-tu-dien-lanh,52780662,"Tủ lạnh Samsung Inverter 236 lít RT22M4032BU/SV - Hàng Chính Hãng",6623000,6623000,0,0
TIKI,dien-tu-dien-lanh,100168123,"Tủ lạnh Samsung Inverter 488L 4 cửa RF48A4000B4/SV- Hàng chính hãng- Chỉ giao tại Hà Nội",15197000,17200000,2003000,12
TIKI,dien-tu-dien-lanh,139048975,"Máy giặt sấy Samsung 9.5kg WD95T4046CE/SV - Chỉ giao tại Hà Nội",9800000,10300000,500000,5
TIKI,dien-tu-dien-lanh,131125585,"Máy giặt Aqua Inverter 9.0 KG AQD-A900F W - Hàng chính hãng - Giao hàng toàn quốc",7250000,7250000,0,0
TIKI,dien-tu-dien-lanh,162172161,"Máy sấy thông hơi Casper 7,2kg TD-72VWD-Hàng chính hãng ( Chỉ giao hàng tại Hà Nội)",5049000,5049000,0,0
TIKI,dien-tu-dien-lanh,113712375,"Giá treo ti vi xoay 90 độ cho ti vi 32 đến 55 inch KL Q4",550000,550000,0,0
TIKI,dien-tu-dien-lanh,173661265,"Đầu thu kỹ thuật số DVB T2 VNPT Igate T201HD hãng chính hãng",279000,279000,0,0
TIKI,dien-tu-dien-lanh,24229382,"Tấm chắn đổi hướng gió điều hòa , máy lạnh DM-224",95000,95000,0,0
TIKI,dien-tu-dien-lanh,24420855,"Android TV Box X96 mini Ram 2GB - ROM 16GB (xem phim, truyền hình, game online thỏa thích)",508000,508000,0,0
TIKI,dien-tu-dien-lanh,123179966,"Máy Rửa Bát Texgio 13 Bộ TG21H775B - Có Thể Lắp Âm - Diệt Khuẩn UV - Hàng Chính Hãng",13499000,13499000,0,0
TIKI,dien-tu-dien-lanh,162815443,"Giá treo tivi di động NB TW100 (60-110 inch) tích hợp hệ thống nâng hạ tự động Hàng Nhập Khẩu ",7500000,7500000,0,0
TIKI,dien-tu-dien-lanh,121268130,"Máy giặt Aqua Inverter 8 KG AQD-A800F W - Hàng chính hãng(Giao Toàn Quốc)",5890000,5890000,0,0
TIKI,dien-tu-dien-lanh,52695502,"Máy Giặt Cửa Trước Inverter Electrolux EWF8025CQWA (8kg) - Hàng Chính Hãng",7790000,7790000,0,0
TIKI,dien-tu-dien-lanh,114613084,"Tủ lạnh 2 cánh Panasonic 366 lít NR-TL381GPKV - Lấy nước ngoài - Làm đá siêu tốc - Hàng chính hãng",17390000,17390000,0,0
TIKI,dien-tu-dien-lanh,176463750,"Máy lạnh Panasonic 2HP Inverter CU/CS-XPU18XKH-8-HÀNG CHÍNH HÃNG-GIAO HÀNG TOÀN QUỐC",18550000,18550000,0,0
TIKI,dien-tu-dien-lanh,75626797,"ANTEN KHUẾCH ĐẠI HOÀNH KIẾN ĐẠT MODEL HKD-H8,CÓ DÂY CẤP NGUỒN 5V ,HÀNG CHÍNH HÃNG.",129000,129000,0,0
TIKI,dien-tu-dien-lanh,38101620,"Máy lão hóa rượu Gipwin Luxury máy khử độc rượu, khử Andehit loại bỏ tạp chất, giúp rượu êm, ngon, không gây đâu đầu, cơ thể nhanh phục hồi - Gipwin 1.8L",18500000,18500000,0,0
TIKI,dien-tu-dien-lanh,184466390,"TX3 mini + mới có điều khiển giọng nói tiếng việt 2G Ram 16G Rom S905w2 bluetooth wifi kép 2 băng tần Android 11 cài sẵn chương trình truyền hình cáp và xem phim HD miễn phí vĩnh viễn Hàng nhập khẩu ",874950,921000,46050,5
TIKI,dien-tu-dien-lanh,133736092,"MAGIC REMOTE LG ANMR21, MR21GA (2021) – HÀNG CHÍNH HÃNG",595000,595000,0,0
TIKI,dien-tu-dien-lanh,83419101,"Tủ lạnh Panasonic Inverter 377 lít NR-BX421GPKV - Chỉ giao Hà Nội",17350000,17350000,0,0
TIKI,dien-tu-dien-lanh,23556596,"Máy Nước Nóng Trực Tiếp Không Bơm Electrolux EWE451GX-DWB (4500W) - Hàng Chính Hãng",1920000,2700000,780000,29
TIKI,dien-tu-dien-lanh,128934736,"anten dvb t2 khuếch đại DUNALS dùng cho tivi tích hợp DVB T2 và đầu thu kỹ thuật số DVB T2. Hàng Chính Hãng",45000,45000,0,0
TIKI,dien-tu-dien-lanh,126702285,"Remote Điều khiển từ xa tivi dành cho Samsung giọng nói BN59-01298G dùng được cho năm 2015,2016,2017,2018",150000,150000,0,0
TIKI,dien-tu-dien-lanh,161256222,"Tủ lạnh mini Kemin 22L",2512000,2750000,238000,9
TIKI,dien-tu-dien-lanh,16463384,"Tủ Đông Dàn Đồng Sanaky VH-2299A1 1 Ngăn 2 Cánh - Hàng Chính Hãng",5990000,5990000,0,0
TIKI,dien-tu-dien-lanh,197175873,"Remote Điều Khiển Tivi Dành Cho SAMSUNG Nhận Giọng Nói Smart TV QLED 8K 4K BN59-01363J",160000,160000,0,0
TIKI,giay-dep-nu,174384911,"Sandal đế bệt nữ Aldo MARASSI",1650000,1650000,0,0
TIKI,giay-dep-nu,89883667,"Sandal đế xuồng 10.5cm X445 da lộn, đế cao su công nghệ mới siêu nhẹ",495000,495000,0,0
TIKI,giay-dep-nu,71048291,"Giầy búp bê siêu mềm chịu nước đế bệt siêu mềm họa tiết vintage dễ thương GN20",89000,89000,0,0
TIKI,giay-dep-nu,68634189,"Juno - Giày sandal gót vuông quai mặt bất đối xứng SD05044",407000,407000,0,0
TIKI,giay-dep-nu,91255482,"Giày Sandal Đế Xuồng Nữ Da Bò BIGGBEN Cao Cấp SDX29",339000,400000,61000,15
TIKI,giay-dep-nu,76405600,"Giày Sandal Nữ Đế Xuồng BIGGBEN Da Bò Thật SDX25",299000,450000,151000,34
TIKI,giay-dep-nu,73992156,"Giày thể thao sneaker nữ màu hồng đế êm nhẹ thoáng khí thương hiệu ZAVAS - S394 - Hàng chính hãng",349000,360000,11000,3
TIKI,giay-dep-nu,67600517,"Giày Sandal Đế Xuồng Quai Dán 3cm Pixie 4162",450000,450000,0,0
TIKI,giay-dep-nu,68402723,"Giầy nhựa búp bê dạo phố, đi mưa, đi biển dễ thương GN17 đan nam đính nơ",59000,59000,0,0
TIKI,giay-dep-nu,100465418,"Dép Guốc Cao Gót Nữ 5cm Quai Trong Thời Trang Nữ Tính GN15",129000,195000,66000,34
TIKI,giay-dep-nu,26045876,"Giầy nhựa chống trượt đi mưa đi biển thời trang mùa hè nhiều mầu họa tiết hoa GN03",59000,59000,0,0
TIKI,giay-dep-nu,82228784,"HÌNH THẬT - Dép lông bông plush , dép đi trong nhà lông mềm mại có đế cao su chống trơn trượt , dép lông mang trong nhà",45700,45700,0,0
TIKI,giay-dep-nu,79555723,"Giày nhựa cao su cho nữ giày nhựa đi mưa Alina cao 3p giá rẻ kiểu dáng thời trang V274",59000,59000,0,0
TIKI,giay-dep-nu,192844314,"Giày Nữ Pierre Cardin - PCWFWSG 171",390000,1490000,1100000,74
TIKI,giay-dep-nu,19728953,"Giày slip on da trơn đế nâu S207",182000,194000,12000,6
TIKI,giay-dep-nu,197418062,"Giày Sandal Nữ BIGGBEN Da Bò Thật SDN08",339000,450000,111000,25
TIKI,giay-dep-nu,59169064,"Dép Cao Gót Nữ Da Bò BIGGBEN Cao Cấp DCG34",249000,400000,151000,38
TIKI,giay-dep-nu,74555399,"Giày slip on nữ da trơn đế thấp - Giày lười nữ S150",121000,129000,8000,6
TIKI,giay-dep-nu,72538775,"Bình Xịt Bọt Tuyết Vệ Sinh Giày Sneaker | Chai Tẩy Trắng , Tẩy Ố Vàng Sneaker 9306",59000,59000,0,0
TIKI,giay-dep-nu,169914748,"Giày cao gót hở mũi da mềm màu đen Trường Hải gót trụ 5cm",219000,299000,80000,27
TIKI,giay-dep-nu,105274225,"Giày Búp Bê Mũi Nhọn Khoá Tròn Pixie X688",504000,504000,0,0
TIKI,giay-dep-nu,101264973,"Lót Đế Giày Biti's Hunter X AIUH00100DEN (Đen)",220000,244000,24000,10
TIKI,giay-dep-nu,14046442,"Dép tông Dép đi biển Dép lê nữ kiểu dáng thời trang đế dày full size chuẩn 36 đến 40 nhiều màu phù hợp cho mùa hè V149",55000,55000,0,0
TIKI,giay-dep-nu,22986513,"Dép Xỏ Ngón Nữ BIGGBEN Da Bò Thật DXN20",279000,350000,71000,20
TIKI,giay-dep-nu,121982801,"SANDAL NHỰA ĐI MƯA BOOKLYM LOW CAO 5CM ĐẾ XUỒNG MÀU BE",450000,450000,0,0
TIKI,giay-dep-nu,145756821,"GIÀY SANDAL QUAI NGANG NỮ ALDO ADRERAN",1550000,1550000,0,0
TIKI,giay-dep-nu,131143005,"Giày sandal nữ hàng hiệu rosata cao gót đế cao 5 phân màu đen za05",399000,399000,0,0
TIKI,giay-dep-nu,109332974,"Giày sandal đế trấu quai chéo nam nữ Detaunisex màu ĐEN - SATA23D",219000,219000,0,0
TIKI,giay-dep-nu,91205516,"Giày Sandal Cao Gót Da Bò BIGGBEN Cao 7 Phân SDCG63",319000,350000,31000,9
TIKI,giay-dep-nu,106868938,"Giày Búp Bê Nữ Đế Xuồng Da Bò BIGGBEN Cao Cấp BB105",309000,400000,91000,23
TIKI,giay-dep-nu,197044015,"Giày Sandals Bít mũi Vento OPTIMUS du lịch/trekking SD08003",395000,395000,0,0
TIKI,giay-dep-nu,143835373,"Giày Bệt Quai Sau (DA THẬT) Mềm Như Bún Slingback Mũi Nhọn FFAN STORE",470000,470000,0,0
TIKI,giay-dep-nu,193878090,"Giày lười vải nữ đế cao su mềm êm chân cao 2cm",119000,149000,30000,20
TIKI,giay-dep-nu,55995324,"Dép sục nữ phối màu",99000,99000,0,0
TIKI,giay-dep-nu,159437867,"XẢ KHO DÉP đúc nguyên khối mang trong nhà chống trơn trượt cao cấp mới nhất",48000,48000,0,0
TIKI,giay-dep-nu,46818961,"Giày búp bê da lộn nữ phong cách công sở kiểu dáng cơ bản V211",89000,89000,0,0
TIKI,giay-dep-nu,195277320,"Giày Thể Thao Nữ Biti's Êmbrace DSW066400HOG (Hồng)",463000,579000,116000,20
TIKI,giay-dep-nu,20954982,"Giày lười nữ - giày thời trang nữ",209000,209000,0,0
TIKI,giay-dep-nu,75657761,"Giày boots combat nữ, giày bốt nữ cột dây 1 dây kéo cổ lửng S011",202000,215000,13000,6
TIKI,giay-dep-nu,175470069,"Giày chạy bộ nữ Under Armour Flow Velociti Wind Prizm - 3024895-101",2857000,4395000,1538000,35
TIKI,giay-dep-nu,15240349,"Sneaker nữ siêu nhẹ Flex X_- 4SMG003",699000,699000,0,0
TIKI,giay-dep-nu,142002374,"Dép nữ thời trang chống nước DXG02",35000,35000,0,0
TIKI,giay-dep-nu,176544380,"giày cao gót hoa đi tiệc tiểu thư xinh 12cm",245000,245000,0,0
TIKI,giay-dep-nu,176542963,"Dép sandal đế bằng quai ngang xinh xắn",135000,135000,0,0
TIKI,giay-dep-nu,119668935,"giày Dép bông bộ Đồ thú khủng long xanh liền thân lông mịn Pijama Động Vật Hoạt Hình Cosplay",119000,119000,0,0
TIKI,giay-dep-nu,44224471,"Độn giày silicon đệm khí êm chân, lót giày 2 lớp tăng chiều cao 5cm- giao màu ngẫu nhiên ",44299,44299,0,0
TIKI,giay-dep-nu,242489571,"Giày lười Loafer No.5 trắng đé gỗ",999000,999000,0,0
TIKI,giay-dep-nu,129233346,"HJ7038-7920 - Giày boot nữ Huy hoàng da bò màu nâu, đen",1399000,1399000,0,0
TIKI,giay-dep-nu,87134083,"Giày Búp Bê Nữ Da Microfiber Đính Nơ Siêu Nhẹ Tomoyo TMW32202",800000,800000,0,0
TIKI,giay-dep-nu,193602832,"HAVAIANAS - Sandals nữ Luna Premium II 4147009",1049000,1049000,0,0
TIKI,giay-dep-nu,183116036,"_HÌNH THẬT_ Giày bệt búp bê hàng VNXK, da lì cao cấp siêu bền size từ 36 đến 42",89000,89000,0,0
TIKI,giay-dep-nu,104792780,"Dép nhựa Quai ngang Thái Lan Siêu Nhẹ, êm Monobo - Moniga 4.4",90000,90000,0,0
TIKI,giay-dep-nu,109546785,"Giày Nữ Búp Bê Đế Xuồng HÀ NAM Da Bò Thật Cao Cấp 4cm GBBN2036",350000,350000,0,0
TIKI,giay-dep-nu,186143660,"Giày bệt nữ, giày búp bê, có dây buộc nơ giúp ôm chân, loại đẹp, phong cách tiểu thư Hàn Quốc",137500,137500,0,0
TIKI,giay-dep-nu,125098565,"Giày nữ Anh Khoa C963-7",220000,220000,0,0
TIKI,giay-dep-nu,59058783,"Dép  nữ Mang Trong Nhà Chống Trơn Trượt Siêu Êm Ái Họa Tiết Hoa Hướng Dương Tặng Dây Buộc Tóc",115000,115000,0,0
TIKI,giay-dep-nu,191592488,"Giày da công sở Chelsea Boots Zip Classic 22 (CB.ZC22) da bò nhập khẩu, Lucas Shoes bảo hành 1 năm",645000,645000,0,0
TIKI,giay-dep-nu,36800101,"Giày Búp Bê Nữ Đế Bệt Nhựa Dẻo Êm Ái G01",59000,59000,0,0
TIKI,giay-dep-nu,87940576,"Giày sandal nữ da bò thật HÀ NAM đế xuồng gót cao 5cm DNU2021",346000,346000,0,0
TIKI,giay-dep-nu,125098628,"Giày lười nữ Anh Khoa A688",250000,250000,0,0
TIKI,giay-dep-nu,170110746,"2 chiếc giày Bata tàu phủi chính hãng Wika Ultra 1",219000,219000,0,0
TIKI,giay-dep-nu,205943587,"Giày cao gót nữ 8p RO466 ROSATA tại BCASHOP bít mũi, hở gót, gót trụ cùng màu thân - màu đen",489000,489000,0,0
TIKI,giay-dep-nu,51718162,"Dép Đi Trong Nhà Massage Chân - S26",85000,85000,0,0
TIKI,giay-dep-nu,184316951,"DÉP MASSAGE CHÂN - BẤM NGUYỆT ",124000,124000,0,0
TIKI,giay-dep-nu,14527186,"Bộ 02 cặp gồm 04 miếng lót gót giày silicon chống trầy bảo vệ gót chân",13999,13999,0,0
TIKI,giay-dep-nu,125099265,"Giày Lười Nữ Anh Khoa A913-9",199000,199000,0,0
TIKI,giay-dep-nu,108035446,"Miếng Lót Mũi Chân Nữ Cao Cấp Silicon Bảo Vệ Chân Khi Di Giày Siêu Mềm Thoáng Khí",15000,15000,0,0
TIKI,giay-dep-nu,114739749,"GIÀY CƯỚI - GIÀY CÔ DÂU BEJO W06 2HOA BABY - WEDDING SHOES",840000,840000,0,0
TIKI,giay-dep-nu,184069072,"HAVAIANAS - Dép nữ Slim Glitter II 4146975",949000,949000,0,0
TIKI,giay-dep-nu,183787500,"Giày Thể Thao Nữ Tăng Chiều Cao Hồng GN Dáng Đẹp-S104 Có 2 Màu",109000,150000,41000,27
TIKI,giay-dep-nu,76065255,"Giày cao gót nữ kiểu Pháp gót 7cm nhọn Y17",269000,269000,0,0
TIKI,giay-dep-nu,68659155,"Dép quai hậu nữ đep sandals nữ hoa cúc kiểu dáng trẻ trung mới 2020 FS2",149000,149000,0,0
TIKI,giay-dep-nu,160818672,"Dây giày boot tròn to 4.5mm Sans946 cotton dù đen nâu trắng be xám cột buộc giầy thể thao cao cổ bốt nam nữ shoe laces",22000,22000,0,0
TIKI,giay-dep-nu,172972756,"Dép Đế Xuồng Nữ Da Bò Thật BIGGBEN Cao 5cm DX38",309000,400000,91000,23
TIKI,giay-dep-nu,125779665,"Giày đi mưa siêu nhẹ",65000,65000,0,0
TIKI,giay-dep-nu,129942527,"Giày sneaker Vans UA Old Skool Mix & Match - VN0A4U3B2PD",1750000,1750000,0,0
TIKI,giay-dep-nu,50743767,"[HÌNH ẢNH THẬT] Giày đế xuồng nữ Trường Hải 3cm trơn đen da bò cao cấp mềm mại không bong tróc đế cao chống mòn không trơn DX0845",215000,299000,84000,28
TIKI,giay-dep-nu,192803896,"OLV - Dép Cream Casual Slipper",350000,350000,0,0
TIKI,giay-dep-nu,42643992,"Máy sấy giày khử mùi Lớn Chuyên dụng UV",1590000,1590000,0,0
TIKI,giay-dep-nu,2024015,"Giày Nữ Búp Bê Da Bò Huy Hoàng HT7911 - Tím",489000,489000,0,0
TIKI,giay-dep-nam,161404101,"Dép kẹp nam và nữ đế trắng quai trắng phối màu",82999,82999,0,0
TIKI,giay-dep-nam,82858419,"Giày Tây Nam Công Sở Happyshoes Da Bò Thật Vân Cá Sấu HS19",650000,650000,0,0
TIKI,giay-dep-nam,141767983,"Dép quai ngang nam Đông Hải chất da bò cao cấp với thiết kế đơn giản, tiện dụng - D1103",650000,650000,0,0
TIKI,giay-dep-nam,207510922,"Giày hở gót nam cao cấp giá đẹp thị trường S001",159000,159000,0,0
TIKI,giay-dep-nam,57890643,"Giày mọi nam Trường Hải màu đen bò da bò thật cao cấp không bong tróc đế cao su chống mòn không trơn GMTH096",507000,599000,92000,15
TIKI,giay-dep-nam,168955221,"Dép Da Nam Thời Trang Đế Cao Su Đúc Nguyên Khối Cao Cấp-DDTT",109000,109000,0,0
TIKI,giay-dep-nam,135852529,"Giày lười nam da bóng chuông màu đen tăng chiều cao 3cm gea giày tây nam trẻ trung cao cấp da thật - Mã GEADLM01",199000,199000,0,0
TIKI,giay-dep-nam,41335268,"Giày Da Nam Cao Cấp Germano Bellesi Italia_GB 1317",8880000,8880000,0,0
TIKI,giay-dep-nam,149410045,"Giày lười công sở da cao cấp ChristinA-Q GNA368",1199000,1199000,0,0
TIKI,giay-dep-nam,33053104,"Giày lười nam",1700000,1700000,0,0
TIKI,giay-dep-nam,176896414,"Giày tây nam công sở cao cấp GT111 Manzo store",180000,180000,0,0
TIKI,giay-dep-nam,261960384,"Giày Sneaker Converse Chuck Taylor All Star Seasonal Color - 1J793C",1550000,1550000,0,0
TIKI,giay-dep-nam,176896373,"Giày Oxford nam cao cấp - Giày công sở da bò sang trọng - MANZO LUX 104 - Manzo Store",180000,180000,0,0
TIKI,giay-dep-nam,207508680,"Giày hở gót nam da Pu phong cách trẻ trung lịch lãm mã S002",159000,159000,0,0
TIKI,giay-dep-nam,88818771,"Giày lười giày mọi nam da bóng kiểu dáng hàn quốc đai én",210000,210000,0,0
TIKI,giay-dep-nam,119287919,"Dép Nam Quai Ngang TiTi ĐÔ Da Bò Thật Cao Cấp DNA2118a",380000,380000,0,0
TIKI,giay-dep-nam,198353931,"Giày lười (sục) nam da mềm đế cao su được khâu chắc chắn, dễ phối đồ (màu đen)",240000,240000,0,0
TIKI,giay-dep-nam,19750669,"Giày Lười Vải Nam Happyshoes HPS001",150000,150000,0,0
TIKI,giay-dep-nam,129942758,"Giày nam nữ Converse cổ cao màu trắng cổ điển Chuck Taylor All Star Classic - 121184C / M7650C",1550000,1550000,0,0
TIKI,giay-dep-nam,115576332,"Giày Da Nam Buộc Dây, Da Bò Bảo Hành 12 Tháng Mã MBH02",500000,1000000,500000,50
TIKI,giay-dep-nam,49614118,"Giày Da Nam Công Sở Da Bò Thật Vân Cá Sấu - HS52",648000,648000,0,0
TIKI,giay-dep-nam,59395267,"Giày 101 thể thao nam phong cách mạnh mẽ trẻ trung năng động",199000,369000,170000,46
TIKI,giay-dep-nam,125271467,"Giày Da nam cực chất xả kho giá gốc - giày lười nam x076",210000,210000,0,0
TIKI,giay-dep-nam,20507532,"Bộ 3 dụng cụ xỏ giày cao cấp - Hàng nội địa Nhật",127000,127000,0,0
TIKI,giay-dep-nam,100869043,"Giày Da Nam Buộc Dây Da Bò Đế Khâu Mã BH-730",650000,1300000,650000,50
TIKI,giay-dep-nam,113779677,"Dép Bít Mũi Nam HÀ NAM Da Bò Thật Cao Cấp GSB2089",460000,460000,0,0
TIKI,giay-dep-nam,55457002,"Giày tây nam Trường Hải không dây da bò  thật màu đen mềm mại đế cao su không trơn may chắc chắn GT810",436000,515000,79000,15
TIKI,giay-dep-nam,129352209,"Dép Vento Quai Ngang Thời Trang AD22",205000,205000,0,0
TIKI,giay-dep-nam,164042031,"giày da nam cổ cao... đế cao su chất liệu da bò nguyên tấm Giày, bốt nam cổ cao Da Bò",610000,610000,0,0
TIKI,giay-dep-nam,115680579,"Giày Lười Nam Da Bò Đế Khâu, Kiểu Giày Mọi Mã MGL66-L",450000,900000,450000,50
TIKI,giay-dep-nam,167931335,"Giày Lười Nam Công Sở Da Bóng Cao Cấp Quai Vàng dập vân, Giày Nam giá Rẻ,đê khâu - Giảm 5",160000,160000,0,0
TIKI,giay-dep-nam,127580930,"Giày Doc.588 lửng da bò nguyên tấm",669000,669000,0,0
TIKI,giay-dep-nam,249719045,"Giày Tây Nam Cao Cấp Kiểu Dáng Oxford Brogues Đế Phíp, Da Bò Thật, Thiết Kế Họa Tiết Sang Trọng SCC-03",892000,892000,0,0
TIKI,giay-dep-nam,175886036,"Dép Quai Ngang Nam Mẫu Mới KEEDO-KD2809 - Đen",480000,480000,0,0
TIKI,giay-dep-nam,10047160,"Dép Xỏ Ngón Nam BIGGBEN Da Bò Thật DK30",400000,400000,0,0
TIKI,giay-dep-nam,109787786,"Giày tây nam da bóng Đồ Da Thành Long 20393",469000,469000,0,0
TIKI,giay-dep-nam,124244266,"Dép Massage khảm đá Bấm huyệt bàn chân trên gỗ tự nhiên, Bấm Huyệt chân Giảm căng thẳng mệt mỏi cao câpz",175000,175000,0,0
TIKI,giay-dep-nam,66628606,"Giày lười da bò thật nam cao cấp trang trọng, lịch lãm mã 8836",599000,799000,200000,25
TIKI,giay-dep-nam,271520629," Giày Mọi Màu Trắng Da Thật MR08 Giày Lười Trắng Mềm Êm Chân Giày SAGO’S Bảo hành 12 tháng",691000,691000,0,0
TIKI,giay-dep-nam,24240414,"Giày sandal nam Việt Thủy quai ngang VT02 - đen",199000,199000,0,0
TIKI,phu-kien-thoi-trang,96189571,"Gọng kính chính hãng Carrera CARRERA5023V OGC",1600000,3200000,1600000,50
TIKI,phu-kien-thoi-trang,132829040,"Thắt lưng nam, dây nịt nam da bò thật nguyên tấm Bụi Leather L110 - Khóa tự động, nhiều mặt khóa tùy chọn - Bảo hành 12 tháng",225000,398000,173000,43
TIKI,phu-kien-thoi-trang,206482134,"Gọng kính chính hãng Puma PE0039OA-002",783000,1500000,717000,48
TIKI,phu-kien-thoi-trang,27662813,"Gọng kính nữ Miss Sixty MX169 R96",680000,1700000,1020000,60
TIKI,phu-kien-thoi-trang,91291870,"Kính mát, mắt kính chính hãng SARIFA Z3246 (50-20-140) nhiều màu",600000,600000,0,0
TIKI,phu-kien-thoi-trang,174378832,"Thắt lưng dây nịt nam da bò khóa tự động phiên bản hàn đơn giản sành điệu trẻ trung  DT107",126000,140000,14000,10
TIKI,giay-dep-nu,154439372,"[ĐẸP CHẤT] Giày boot nữ cột dây 2 dây kéo sau gót cá tính năng động street style S028",243000,259000,16000,6
TIKI,phu-kien-thoi-trang,19720244,"Dây Thun Cột Tóc",7000,11850,4850,41
TIKI,giay-dep-nu,7983107,"Dép Nữ BIGGBEN Da Bò Thật DNQN04",269000,350000,81000,23
TIKI,phu-kien-thoi-trang,89478859,"THUN CỘT TÓC l",6000,15000,9000,60
TIKI,phu-kien-thoi-trang,79245107,"SET 5 MÓN KẸP TÓC - CÀNG CUA HÀN QUỐC CHO NỮ",34900,34900,0,0
TIKI,giay-dep-nu,126098122,"Dép Đế Trấu 2 Quai Ngang Nam Nữ Detaunisex Màu Đen - DETA24D",300000,300000,0,0
TIKI,phu-kien-thoi-trang,52758100,"Combo 5 Đôi Tất Nam Vớ Nam Cổ Dài Sợi Cotton Cùng Màu",95000,175000,80000,46
TIKI,giay-dep-nu,105273848,"Giày Cao Gót 3cm Hở Gót Đế Vuông Pixie X724",540000,540000,0,0
TIKI,phu-kien-thoi-trang,124860727,"(túi 6 chiếc) KHẨU TRANG VẢI XUẤT DƯ MAY 10 - LAINIÈRE PHÁP",6000,6000,0,0
TIKI,phu-kien-thoi-trang,203949886,"Thắt lưng nam da thật cao cấp nhãn hiệu Macsim MS036",560000,560000,0,0
TIKI,dien-tu-dien-lanh,56099364,"Chuyển hướng gió dàn lạnh Airwing Slim",990000,990000,0,0
TIKI,giay-dep-nu,68635403,"Juno - Giày cao gót mũi tròn phối nơ CG05059",343800,382000,38200,10
TIKI,dien-tu-dien-lanh,48747804,"Remote Điều Khiển Cho Smart TV, Internet TV SAMSUNG AA59-00638A (Kèm Pin AAA Maxell)",29900,29900,0,0
TIKI,phu-kien-thoi-trang,4213901,"Bờm cài tóc nam - nữ màu đen lượn sóng bằng sắt siêu bền BN39",9000,15000,6000,40
TIKI,dien-tu-dien-lanh,169926909,"Linh Kiện Triac BTA12-600B TO-220 600V 12A",5880,5880,0,0
TIKI,dien-tu-dien-lanh,83432654,"Tủ Lạnh Electrolux Inverter 312L ETB3440K-A - Chỉ Giao Hà Nội",8090000,8090000,0,0
TIKI,dien-tu-dien-lanh,162771934,"X96 tivi box có điều khiển giọng nói cử chỉ tay người dùng hỗ trợ tìm kiếm bằng tiếng việt Android 10 cài sẵn chương trình tivi truyền hình cáp miễn phí vĩnh viễn Hàng nhập khẩu",845405,889900,44495,5
TIKI,phu-kien-thoi-trang,222639340,"Thắt lưng nam -Dây nịt nam da thật cao cấp nhãn hiệu Macsim MS06",800000,800000,0,0
TIKI,giay-dep-nu,193272636,"Giày búp bê nữ da mềm. Đế cao 2cm",149000,149000,0,0
TIKI,giay-dep-nu,193772189,"Giày nữ da mềm giày đế xuồng cao 3cm",149000,149000,0,0
TIKI,phu-kien-thoi-trang,160370208,"Đinh Đục Lỗ Thắt Lưng Da 4.0mm 4U Cao Cấp DTL4",5000,7000,2000,29
TIKI,giay-dep-nu,193334606,"Giày lười nữ vải ren, đế cao su mềm cao 3p",149000,149000,0,0
TIKI,phu-kien-thoi-trang,103759208,"Mắt kính thời trang nam nữ form nhỏ gọng chữ V nhiều màu cực đẹp MK106",25000,100000,75000,75
TIKI,giay-dep-nu,88085717,"Giày cao gót nữ đẹp rẻ, giày gót vuông",254800,254800,0,0
TIKI,giay-dep-nu,101855040,"DÉP VIP (đi trong nhà/nhà tắm)",33000,33000,0,0
TIKI,phu-kien-thoi-trang,193702569,"Băng đô cài tóc vương miện nhiều màu",39000,39000,0,0
TIKI,dien-tu-dien-lanh,195226339,"Nấm cao su xả máy giặt Sanyo Toshiba",15000,15000,0,0
TIKI,dien-tu-dien-lanh,170730899,"Bình nóng lạnh Panasonic 15 lít DH15HBM - Hàng chính hãng",3000000,3000000,0,0
TIKI,phu-kien-thoi-trang,28326979,"Găng Tay Bao Tay Ống Chống Nắng Cao Cấp Unisex",10000,10000,0,0
TIKI,phu-kien-thoi-trang,165917606,"Tất Trơn Cổ Ngắn Nam Nữ GOMTAT, Vớ Cổ Ngắn Unisex Trơn Màu Vải Cotton Chuẩn Xuất Nhật - TRONNGAN-VNXK",6900,12000,5100,43
TIKI,phu-kien-thoi-trang,188858809,"Găng Tay Cụt Ngón, Bao Tay Tập Gym Thể Thao Đa Năng Dành Cho Phượt Thủ Phong Cách",53000,138000,85000,62
TIKI,giay-dep-nu,55055051,"Dép Cao Gót Nữ Da Bò BIGGBEN Cao Cấp DCG33",329000,400000,71000,18
TIKI,giay-dep-nu,67726443,"HAVAIANAS - Dép nữ Slim 4000030-5178-256",429000,429000,0,0
TIKI,phu-kien-thoi-trang,174380872,"Thắt Lưng Dây Nịt Nam Công Sở Da Bò 2 Lớp Khóa Tự Động Nam Tính Nhiều Mẫu  DT111",127500,150000,22500,15
TIKI,dien-tu-dien-lanh,54620524,"Điều khiển điều hoà Panasonic Model CS-N9SKH-8- Hàng chính hãng",469000,469000,0,0
TIKI,phu-kien-thoi-trang,188848409,"Găng Tay Cảm Ứng, Bao Tay Phượt Du Lịch Dã Ngoại Cao Cấp Dành Cho Cả Nam Và Nữ",73000,178000,105000,59
TIKI,dien-tu-dien-lanh,165964640,"Ron tủ lạnh cho tủ lạnh Panasonic NR-BL347",238000,238000,0,0
TIKI,giay-dep-nu,36926828,"Giày Sandal Nữ BIGGBEN Da Bò Thật SDN35 - 40",329000,350000,21000,6
TIKI,giay-dep-nu,143174524,"Giày thể thao nữ GT01 siêu nhẹ, thoáng khí, đế casu, phong cách trẻ",50000,50000,0,0
TIKI,phu-kien-thoi-trang,113490079,"Kính Mát ,Mắt Kính Unisex ASARIFA RP18013 c2",800000,800000,0,0
TIKI,giay-dep-nu,87005653,"Dép Sục Nữ Da Bò BIGGBEN Cao Cấp SBN35",339000,480000,141000,29
TIKI,phu-kien-thoi-trang,631716,"Gọng Kính Nữ Just Cavalli JC0369 002 (52/17/140) - Đen Đồi Mồi",3900000,3900000,0,0
TIKI,giay-dep-nu,20415496,"Giày lười nữ TOMOYO TMW20502",800000,800000,0,0
TIKI,phu-kien-thoi-trang,273867988,"Dây Đai Nịt Thắt Lưng Giữ Áo Sơ Mi Thẳng Khi Đóng Thùng Loại Quấn Bụng LeGaXi",28000,28000,0,0
TIKI,giay-dep-nu,101787249,"Giày Sandal Nữ 5cm Thời Trang JUNO Quai Ngang Khóa Trang Trí SD05064",446000,446000,0,0
TIKI,phu-kien-thoi-trang,91291870,"Kính mát, mắt kính chính hãng SARIFA Z3246 (50-20-140) nhiều màu",600000,600000,0,0
TIKI,phu-kien-thoi-trang,70656443,"Kính mát, mắt kính 2508 nhiều màu",47500,50000,2500,5
TIKI,giay-dep-nu,36978574,"Giày Sandal Nữ BIGGBEN Da Bò Thật SDN42 - 37",339000,400000,61000,15
TIKI,phu-kien-thoi-trang,177945773,"Găng tay chống nắng xỏ ngón 2 màu ombre thời trang - Bao tay chống nắng Ombre Sun Protection Sleeves",43000,43000,0,0
TIKI,dien-tu-dien-lanh,20634496,"	 Điều Khiển Dành cho Tivi LG ",65000,65000,0,0
TIKI,phu-kien-thoi-trang,4260047,"Băng đô turban giữ tóc bản to chất liệu cao cấp cho bạn gái TB07",19000,19000,0,0
TIKI,dien-tu-dien-lanh,195913115,"Máy sấy quần áo Electrolux 8.5 kg EDS854N3SB - Hàng chính hãng [Giao hàng HCM/HN]",11450000,13490000,2040000,15
TIKI,phu-kien-thoi-trang,186359438,"Dây nịt thắt lưng nam da bò 2 lớp không có khóa đi kèm bền đẹp 3.5cm  DDT100",25000,50000,25000,50
TIKI,phu-kien-thoi-trang,100973511,"Găng tay xỏ ngón chống nắng Rhino S101, tất tay nam nữ, chống tia UV, chống bụi, Hàng chính hãng",8000,11000,3000,27
TIKI,giay-dep-nu,197637839,"Giày Đế Xuồng Nữ BIGGBEN Da Bò Thật Đế Cao 5cm SDX42",339000,400000,61000,15
TIKI,giay-dep-nu,51519539,"GIÀY THỂ THAO NỮ SPORT CỰC THỜI TRANG",99000,99000,0,0
TIKI,phu-kien-thoi-trang,132829040,"Thắt lưng nam da bò nguyên tấm L110 cao cấp màu đen, dây lưng nam da bò thật mặt khóa tăng tự động thép không gỉ, nhiều mặt khóa lựa chọn, hộp sang trọng làm quà tặng,thương hiệu Bụi leather chuyên đồ da thật,bảo hành 24 tháng",225000,398000,173000,43
TIKI,giay-dep-nu,188657473,"Giày Đế Xuồng Nữ Da Bò Thật BIGGBEN Cao 9cm SDX39",369000,450000,81000,18
TIKI,phu-kien-thoi-trang,48891010,"KÍNH MÁT NAM EXFASH EF88972",516000,920000,404000,44
TIKI,giay-dep-nu,141729617,"Giày cao gót nữ đẹp đế vuông 7 phân hàng hiệu rosata hai màu đen đỏ ro352",430000,430000,0,0
TIKI,giay-dep-nu,174580656,"Giày sục nữ mũi nhọn thời trang cao gót ORSIL mã TA7-01 3 màu đen trắng kem",249000,289000,40000,14
TIKI,dien-tu-dien-lanh,103209086,"Tủ lạnh Samsung Inverter 488 lít RF48A4000B4/SV - Hàng chính hãng - Giao tại Hà Nội và 1 số tỉnh toàn quốc",19035000,19035000,0,0
TIKI,phu-kien-thoi-trang,225175029,"Thắt lưng nam da thật cao cấp nhãn hiệu Macsim MS01",800000,800000,0,0
TIKI,phu-kien-thoi-trang,133765419,"Găng tay chống nắng Let's Slim Xỏ Ngón - Bảo vệ tay khỏi tia UV - Dành cho cả nam và nữ - Hàng Chính Hãng",23000,23000,0,0
TIKI,dien-tu-dien-lanh,100042624,"khóa lồng quạt",10000,10000,0,0
TIKI,giay-dep-nu,193274680,"Giày nữ giày lười vải đế bệt cao 2p",119000,149000,30000,20
TIKI,dien-tu-dien-lanh,109064305,"Android Tivi FFALCON 4K 50 inch 50UF2",8950000,8950000,0,0
TIKI,phu-kien-thoi-trang,183498218,"Nón Kết Nam Lính Mỹ U558 Thêu AIR FORCE Chóp Tròn , Nón Lưỡi Trai Nam Vải Kaki Cao Cấp Thời Trang US ARMY Phong Cách Lính Mỹ - HÀNG CHÍNH HÃNG",81000,178000,97000,54
TIKI,dien-tu-dien-lanh,36723110,"TỦ ĐÔNG MINI SANAKY 100 LÍT VH-1599HYK ĐỒNG (R600A) (KÍNH CƯỜNG LỰC) - HÀNG CHÍNH HÃNG",5650000,5650000,0,0
TIKI,dien-tu-dien-lanh,88789945,"Remote Điều Khiển Dành Cho Máy Lạnh, Điều Hòa Không Khí DAIKIN ARC480A33 - Hàng chính hãng",88000,88000,0,0
TIKI,dien-tu-dien-lanh,95897564,"Máy Giặt Samsung AI AddWash Inverter 12kg WW12TP94DSB/SV - Chỉ giao Hà Nội",14700000,14700000,0,0
TIKI,dien-tu-dien-lanh,119822976,"Điều khiển điều hòa dành cho Panasonic CU/CS- 9000BTU 12000BTU 18000BTU 1 chiều 2 chiều Inverter",57900,57900,0,0
TIKI,dien-tu-dien-lanh,141111316,"Máy giặt Electrolux Inverter 9 kg EWF9042Q7WB - chỉ giao Hà Nội",11190000,11190000,0,0
TIKI,phu-kien-thoi-trang,67139433,"Kẹp tóc cầu vòng loại dài",38000,38000,0,0
TIKI,dien-tu-dien-lanh,55096354,"Điều hòa Inverter Electrolux ESV09CRR-C6 (9000BTU) - Hàng chính hãng - Chỉ giao tại Hà Nội",6090000,6090000,0,0
TIKI,phu-kien-thoi-trang,103857606,"Kẹp tóc vuông màu nhám trơn - set 2 màu bất kì",24000,24000,0,0
TIKI,phu-kien-thoi-trang,48891082,"KÍNH MÁT NAM EXFASH EF56792",267000,500000,233000,47
TIKI,giay-dep-nu,129354416,"Giày Sandal Vento Nam Nữ Quai Ngang dạo phố/đi chơi/đi học NV1001 Nhiều Màu",325000,325000,0,0
TIKI,giay-dep-nu,12530748,"Giày Sandal Nữ BIGGBEN Da Bò Thật SDN20",339000,400000,61000,15
TIKI,dien-tu-dien-lanh,34869816,"Remote Điều Khiển Dành Cho  Máy lạnh, Máy Điều Hòa Toshiba WC-H01EE - Hàng Nhập Khẩu",55000,55000,0,0
TIKI,dien-tu-dien-lanh,51436052,"Giá treo tivi thả trần cho Tivi từ 32 đến 65 inch ",350000,350000,0,0
TIKI,dien-tu-dien-lanh,143701464,"Tủ lạnh Samsung Inverter 307 lít RB30N4190BU/SV- Hàng chính hãng",12829000,12829000,0,0
TIKI,phu-kien-thoi-trang,73568379,"Kính mát, mắt kính 2508 nhiều màu lựa chọn",13000,85000,72000,85
TIKI,phu-kien-thoi-trang,142538263,"Găng Tay Đi Phượt Hở Ngón 5.11 U890, Găng Tay Phượt, Tập Gym, Thể Thao Đa Năng  - HÀNG CHÍNH HÃNG",45000,98000,53000,54
TIKI,giay-dep-nu,20416810,"Giày lười nữ TOMOYO TMW20509",699000,699000,0,0
TIKI,phu-kien-thoi-trang,51057943,"Bộ 36 Chiếc Ghim Kẹp Tóc BOB PIN Nhỏ Gọn Tiện Lợi Kẹp Tóc Mái , Tóc Giả MP122-36",18000,40000,22000,55
TIKI,dien-tu-dien-lanh,165964412,"Ron tủ lạnh  dành cho tủ lạnh  sharp model SJ- 185P-SL",200000,200000,0,0
TIKI,giay-dep-nu,193152237,"Giày sneaker nữ màu trắng siêu nhẹ phong cách Hàn Quốc",129000,129000,0,0
TIKI,giay-dep-nu,176843009,"Giày boot nữ cổ thấp 5 phân hàng hiệu rosata hai màu đen đỏ ro178",460000,460000,0,0
TIKI,dien-tu-dien-lanh,101142784,"Quạt lồng sóc 4 tấc",600000,600000,0,0
TIKI,giay-dep-nu,74370871,"Giày sandal nữ kẹp da bò thật cao cấp BIGGBEN SDN65",339000,450000,111000,25
TIKI,dien-tu-dien-lanh,4172279,"Máy Nước Nóng Ferroli Divo SSP 4.5S (4500W)",2485000,2485000,0,0
TIKI,phu-kien-thoi-trang,184591051,"Hộp 5 đôi tất nam đi giày tây màu tối cao cấp MIX04, vớ nam công sở chất liệu cotton hút ẩm thoáng khí - GOM-MIX04-CB5",129000,250000,121000,48
TIKI,giay-dep-nu,192886603,"Giày Sandal Nữ Pierre Cardin - PCWFWSG 176",490000,1490000,1000000,67
TIKI,phu-kien-thoi-trang,73329646,"Kính mát, mắt kính SARIFA 3026 (62-14-140) nhiều màu",800000,800000,0,0
TIKI,giay-dep-nu,104793076,"Dép nhựa xỏ ngón Thái Lan  6.4",105000,105000,0,0
TIKI,dien-tu-dien-lanh,136825949,"Máy giặt LG Inverter 11 kg FV1411S4P - Chỉ giao tại HN",11390000,11390000,0,0
TIKI,dien-tu-dien-lanh,167804322,"Máy rửa bát Texgio TGD8615BE 15 bộ Tự động mở cửa Rửa nhanh Rửa sạch sâu Hẹn giờ khởi động model mới 2022 Hàng Chính Hãng",13399000,13399000,0,0
TIKI,giay-dep-nu,72101747,"Giày Sandal Cao Gót BIGGBEN Da Bò Thật SDCG56",349000,400000,51000,13
TIKI,giay-dep-nu,197670567,"Dung dịch khử mùi giày, dép chống hôi chân có hương thơm công nghệ NHẬT BẢN",45000,80000,35000,44
TIKI,phu-kien-thoi-trang,181773412,"Mũ Lưỡi Trai Nam Phong Cách Lính Mỹ, Nón Kết Nam Lính Mỹ Chiến Thuật Chuyên Đi Phượt Du Lịch Dã Ngoại Dùng Thường Ngày Vải Kaki",70000,178000,108000,61
TIKI,dien-tu-dien-lanh,57339887,"BÌNH NƯỚC NÓNG GIÁN TIẾP AQUA E  150 LÍT TREO NGANG(SEH)-HÀNG CHÍNH HÃNG",11250000,11250000,0,0
TIKI,phu-kien-thoi-trang,178952359,"Khăn Lau Kính Nano Hộp 100 Miếng Giấy Lau Kính Chống Bám Hơi Nước, Lau Sạch Vân Tay Bụi Bẩn",26461,26461,0,0
TIKI,giay-dep-nu,52042691,"GIÀY THỂ THAO NỮ PHẢN QUANG CỰC ĐẸP",99000,99000,0,0
TIKI,giay-dep-nu,76796961,"Giày Mọi Da Nữ Cao Cấp Full Box Chất Liệu Da Mềm",209000,209000,0,0
TIKI,phu-kien-thoi-trang,59303157,"[Một Cặp] Kính Áp Tròng Australia Cận Thị Không Màu Mediclear 3 Tháng + Khay Đựng",200000,200000,0,0
TIKI,phu-kien-thoi-trang,225188588,"Thắt lưng nam da thật cao cấp nhãn hiệu Macsim MS58",800000,800000,0,0
TIKI,dien-tu-dien-lanh,73174423,"Máy giặt LG Inverter 11 kg TH2111SSAB - Chỉ giao Hà Nội",10890000,10890000,0,0
TIKI,dien-tu-dien-lanh,132786015,"Tủ lạnh Toshiba Inverter 325 lít GR-RB410WE-PMV(37)-SG - Hàng chính hãng - Giao toàn quốc",12500000,12500000,0,0
TIKI,dien-tu-dien-lanh,14350519,"Máy lạnh Electrolux Inverter 2.0 HP ESV18CRO-C1 - Hàng chính hãng",12290000,12290000,0,0
TIKI,phu-kien-thoi-trang,145466494,"[VIDEO]- Khăn choàng cổ đa năng cao cấp 90x180cm, Khăn choàng lụa cao cấp đi biển, phụ kiện thời trang làm quà tặng ý nghĩa- CHỌN MẪU",148000,148000,0,0
TIKI,phu-kien-thoi-trang,225188553,"Thắt lưng nam da thật cao cấp nhãn hiệu Macsim MS29",800000,800000,0,0
TIKI,dien-tu-dien-lanh,132834067,"Smart Tivi Casper 32 inch 32HG5200 Android - Hàng Chính Hãng",4600000,4600000,0,0
TIKI,giay-dep-nu,192643040,"Giày Thể Thao Nữ Biti's Hunter X LITEPLEX DSWH09800",961000,961000,0,0
TIKI,dien-tu-dien-lanh,75363994,"ĐIỀU KHIỂN ĐẦU THU TRUYỀN HÌNH KỸ THUẬT SỐ MẶT ĐẤT PANTESAT ,HÀNG CHÍNH HÃNG.",39000,39000,0,0
TIKI,giay-dep-nu,186818165,"Giày nữ giày thể thao, giày nữ học sinh sinh viên giày thời trang nữ mã QR06",429000,799000,370000,46
TIKI,dien-tu-dien-lanh,17012138,"Máy lạnh Mitsubishi Heavy 1.0 HP SRK10CRS-S5 ( hàng chính hãng)",8490000,8490000,0,0
TIKI,dien-tu-dien-lanh,92499278,"REMOTE ĐIỀU KHIỂN DÀNH CHO MÁY LẠNH ĐIỀU HOÀ DAIKIN ARC480A1",69000,69000,0,0
TIKI,phu-kien-thoi-trang,164021688,"Nước rửa kính Lọ nước lau xịt kính chuyên dụng - Kính mát Aoron",30000,30000,0,0
TIKI,phu-kien-thoi-trang,195113801,"Kẹp tóc càng cua lông mịn phong cách Hàn Quốc",16000,16000,0,0
TIKI,phu-kien-thoi-trang,187581474,"Combo 5 Đôi Tất Vớ Nữ Cổ Ngắn Vintage Sử Dụng Cả Tuần",29000,50000,21000,42
TIKI,giay-dep-nu,104793129,"Dép nhựa quai ngang Thái Lan Siêu Nhẹ, êm 4.3",90000,90000,0,0
TIKI,phu-kien-thoi-trang,174379379,"Thắt lưng dây nịt nam da bò khóa tự động phong cách âu đơn giản  DT108",127500,150000,22500,15
TIKI,giay-dep-nu,166034273,"Dép nữ da bò thật BIGGBEN cao cấp DNQN42",299000,350000,51000,15
TIKI,dien-tu-dien-lanh,28297375,"GIÁ TREO TIVI SÁT TƯỜNG (19"- 32")",68000,68000,0,0
TIKI,dien-tu-dien-lanh,126702308,"Remote Điều khiển từ xa điều hòa dành cho Daikin 1 chiều",197000,197000,0,0
TIKI,phu-kien-thoi-trang,52758433,"Combo 5 Đôi Tất Nam Vớ Nam Cổ Dài Sợi Cotton Mix Màu",95000,175000,80000,46
TIKI,dien-tu-dien-lanh,92504473,"ULED TIVI AKINO 55 inch TL-HU9 - android - Hàng Chính Hãng (Giao Hàng Toàn Quốc)",6500000,6500000,0,0
TIKI,dien-tu-dien-lanh,102108744,"10 gioăng (ron) trong silicon chịu nhiệt phi 27 dùng cho máy nước nóng năng lượng mặt trời",133000,140000,7000,5
TIKI,may-anh,5849307,"Chân Máy Ảnh Monopod Weifeng WT-1003 - Hàng Nhập Khẩu",271999,271999,0,0
TIKI,may-anh,141606175,"Sạc pin Doublepow DP-UK83 tự ngắt, chuyên dụng sạc pin AA/AAA, 4 khe sạc được 4 viên pin AA hoặc AAA hàng chính hãng",1089000,1089000,0,0
TIKI,may-anh,23838438," Kính hiển vi bỏ túi Carson MicroMini MM-280B 20x (có đèn LED, đèn tia cực tím UV kiểm tra tiền) - Hàng chính hãng",714000,714000,0,0
TIKI,may-anh,24409730,"Ống kính Yongnuo 50mm F1.8 II for Canon kèm lens hood và gói hút ẩm- Hàng nhập khẩu",1990000,1990000,0,0
TIKI,may-anh,5849599,"Chân Máy Ảnh Tripod/ Monopod Q-999 - Hàng Nhập Khẩu",1049999,1049999,0,0
TIKI,may-anh,114964724,"Bộ dụng cụ khám phá kính hiển vi Barska AY12938 (dành cho trẻ em) - Hàng chính hãng",1887000,1887000,0,0
TIKI,may-anh,108844840,"Kit RF Thu Phát Wifi BLE ESP32 Camera ESP32-CAM",187000,187000,0,0
TIKI,may-anh,189694785,"Gimbal Zhiyun Smooth Q4 - Tay cầm chống rung 3 trục có thể gấp gọn dành cho điện thoại, tích hợp gậy selfie kéo dài 21cm - Hàng nhập khẩu",2149000,2814900,665900,24
TIKI,may-anh,135812254,"Thẻ nhớ 64gb MIXIE  MicroSD  Class10 U3. Hàng Chính Hãng",86000,86000,0,0
TIKI,may-anh,195948474,"Camera Hành Trình Ô Tô DDPAI Z40 Dash Cam Plus Camera Sau Độ Phân Giải 2K Ultra HD, Công Nghệ Thực Tế Ảo, Giám Sát 24 Giờ, Định Vị GPS, Hỗ Trợ Bộ Nhớ 128GB - Hàng Chính Hãng",2099000,4189000,2090000,50
TIKI,may-anh,109879080,"Túi máy ảnh Safrotto SF002, Hàng chính hãng",1049999,1049999,0,0
TIKI,may-anh,194083692,"CAMERA WIFI EZVIZ C6 4MP 2K - HỖ TRỢ 5G - XOAY 360 ĐỘ - ĐÀM THOẠI 2 CHIỀU - ĐIỀU KHIỂN VÀ NHẬN DẠNG HÀNH ĐỘNG VẪY TAY",1090000,1090000,0,0
TIKI,may-anh,32528851," Kính thiên văn cao cấp kiểu cổ điển Barska Anchormaster 6x30mm - Hàng chính hãng",4257000,4257000,0,0
TIKI,may-anh,14272904,"Ngàm Chuyển Auto Focus Viltrox EF-EOS M Cho Canon EOS M - Hàng Chính Hãng",819000,819000,0,0
TIKI,may-anh,4740349,"Balo Đựng Máy Ảnh Benro Ranger Pro 500N (Đen) - Hàng Công Ty",3349999,3349999,0,0
TIKI,may-anh,20425156,"Balo Máy Ảnh  NG 5070 ",849999,849999,0,0
TIKI,may-anh,133436638,"Ống kính Sigma 18-50mm F/2.8 DC DN (C) Sony E- mount Hàng chính hãng	",11990000,11990000,0,0
TIKI,may-anh,26661669,"Pin Sạc Aa Fujitsu 2450mAh Vỉ 4 Viên (Bản Nội Địa Nhật Bản) - Hàng Nhập Khẩu",1430000,1430000,0,0
TIKI,may-anh,273984419,"Dây đeo máy ảnh kiểu peak design bản nhỏ dành cho máy ảnh mirrorless",100000,100000,0,0
TIKI,may-anh,921244,"Đèn Flash Godox TT600 Cho Canon, Nikon, Sony, Pentax (Tặng Kèm Tản Sáng Bounce) - Hàng nhập khẩu",1520000,1520000,0,0
TIKI,may-anh,2547015,"Hộp Chống Ẩm Wonderful 12 Lít",699000,699000,0,0
TIKI,may-anh,193778046,"Camera 360° Xiaomi - Hàng chính hãng - Camera quan sát Mi 360° 1080P Mi Home Security có đèn hồng ngoại, kết nối wifi",689000,689000,0,0
TIKI,may-anh,154234487,"Flycam SJRC F11S 4K Pro 2021 phiên bản 3km - Phương tiện bay khả năng quay hình 4K, gimbal chống rung 2 trục - Hàng nhập khẩu",3899000,3899000,0,0
TIKI,may-anh,7521387,"Ống Nhòm Barska Escape 7x50 - Hàng chính hãng",2020000,2020000,0,0
TIKI,may-anh,186094681,"Đầu ghi hình Camera IMOU IP Wifi 4 kênh/8 kênh IMOU - Hàng Chính Hãng",1350000,1350000,0,0
TIKI,may-anh,274179339,"Pin sạc Panasonic Eneloop AA 2550mah BK-3HCCE4BT3 (Vỉ 4 viên) (Đen) - Hàng chính hãng",499000,499000,0,0
TIKI,may-anh,171222217,"Balo máy ảnh Peak Design Everyday Backpack 20L Ver 2 - Hàng Chính Hãng",6499999,6499999,0,0
TIKI,may-anh,141606020,"bộ sạc pin aa panasonic CC55C sạc nhanh hàng chính hãng",1750000,1750000,0,0
TIKI,may-anh,72799732,"Ngàm chuyển  ống kính lấy nét tự động Viltrox NF-M1 cho Nikon F-Mount đến máy ảnh M 4/3 Hàng Nhập Khẩu",2899000,2899000,0,0
TIKI,may-anh,114929017,"Kính thiên văn khúc xạ ngắm sao Barska Starwatcher 600 - Hàng chính hãng",6770000,6770000,0,0
TIKI,may-anh,31867852,"Ống Kính Lấy Nét Tự Động Viltrox C-AF 2XII AF Hàng Nhập khẩu",2099000,2099000,0,0
TIKI,may-anh,97631649,"Chân đế cao cấp cho máy ảnh, ống nhòm Carson Rock TR-100 - Hàng chính hãng",1320000,1320000,0,0
TIKI,may-anh,242618146,"Camera IMOU wifi A22EP 1080P 2M xoay 360 độ đàm thoại 2 chiều - Hàng chính hãng",599000,900000,301000,33
TIKI,may-anh,169128158,"[ Giám sát 24H ] Mini Camera Hành Trình  4 Inch Ô Tô Màn Hình Gương Tràn Viền (Wifi+GPS) - Thẻ 64GB",2409472,2409472,0,0
TIKI,may-anh,165046251,"Phim Instax Mini Dành Cho Máy Ảnh Mini 8, 9, 11, 40, 70, 90, Mini Link, Mini Liplay (Trắng) - Hàng Chính Hãng",430000,430000,0,0
TIKI,may-anh,20028905,"Camera Hikvision DS-2CD2121G1-IDW1 Hàng Chính Hãng",1490000,1490000,0,0
TIKI,may-anh,502097,"Thẻ Nhớ SD Ultra Sandisk 64GB Class 10 - 48MB/s - Hàng Chính Hãng",229000,249000,20000,8
TIKI,may-anh,74500335,"Camera IP Wifi TP-Link Tapo C200 Full HD 1080P Giám sát An Ninh - Hàng Chính Hãng",439000,878000,439000,50
TIKI,may-anh,32923633,"Vỉ 5 Viên Pin CR2032 Panasonic ( CR-2032/5BE x 1 Vỉ ) Lithium 3 V",100000,100000,0,0
TIKI,may-anh,50873236,"Ống nhòm du lịch một mắt Konusmall - 3 8-24x40,Thiết kế nhỏ gọn,tính năng ưu việt phù hợp dã ngoại ngắm cảnh - Hàng nhập khẩu Italia",2430000,2430000,0,0
TIKI,may-anh,170340161,"Camera IP wifi không dây IMOU F42P, F42FP, F42FEP siêu nét đàm thoại 2 chiều - Hàng chính hãng",758000,758000,0,0
TIKI,may-anh,251943522,"Kính hiển vi cao cấp soi kim cương Terino DIA-1000XHD (50X-1000X) - Hàng chính hãng",8360000,8360000,0,0
TIKI,may-anh,193922240,"Kính hiển vi kỹ thuật số soi nổi TERINO 1000X-WFHD (Phóng đại 1000X, WiFi) - Hàng Chính Hãng",2915000,2915000,0,0
TIKI,giay-dep-nu,200519451,"Giày búp bê  da bò mũi tròn màu xám đính nơ Trường Hải da mềm mại BB130",253000,299000,46000,15
TIKI,giay-dep-nu,205299054,"Chai xịt tạo bọt vệ sinh giày cao cấp, chất tẩy rửa giày, làm sạch, trắng sáng và khử mốc giày hiệu quả - Hàng chính hãng",47000,55000,8000,15
TIKI,may-anh,225272503,"Máy dò camera loại cao cấp chính xác 100%. Bảo hành 12 tháng",150000,150000,0,0
TIKI,may-anh,381162,"Film Instax Mini - Giấy in ảnh Fujifilm cho máy chụp ảnh lấy liền Instax Mini - Hộp 20 tấm - Hàng Chính Hãng",390000,480000,90000,19
TIKI,giay-dep-nu,252597179,"Giày búp bê đế bằng da bò trơn Trường Hải da mềm GBB120 có 2 màu đen, trắng",241000,285000,44000,15
TIKI,may-anh,194140440,"Thẻ nhớ SDXC SanDisk Extreme Pro SDSDXXD-128G U3 V30 128GB 200MB/s New 2022 - Hàng Nhập Khẩu",505000,505000,0,0
TIKI,giay-dep-nu,110140477,"Giày đi mưa giày đi biển chống trơn trượt đế bằng phù hợp cho mùa hè V283",59000,59000,0,0
TIKI,may-anh,242644479,"Camera WIFI ngoài trời IMOU S21FP, S41FP có màu ban đêm, xoay 360 độ - Hàng chính hãng",1050000,1600000,550000,34
TIKI,may-anh,135839773,"Thẻ nhớ 32/64/128/256gb MIXIE  MicroSD  Class10 U3. Hàng Chính Hãng",63000,63000,0,0
TIKI,may-anh,165189326,"Kính hiển vi 7 chức năng cho trẻ em khám phá Carson CP-11 X-Scope - Hàng chính hãng",759000,759000,0,0
TIKI,giay-dep-nu,252596105,"Giày búp bê trơn da bò mũi vuông Trường Hải có 2 màu xanh ,đen GBB115",241000,285000,44000,15
TIKI,may-anh,7389203,"Ống Nhòm Barska Lucid 8x21mm - Hàng chính hãng",858000,858000,0,0
TIKI,may-anh,150633868,"Giá đỡ điện thoại/ máy ảnh MAWA MT04 dạng tripod 3 chân bạch tuộc uốn dẻo tiện lợi - Hàng chính hãng",220000,220000,0,0
TIKI,may-anh,112287864,"Chân đế treo tường, hộp kỹ thuật Cho Camera Dome, Camera Ezviz C6N, Camera C6CN, Camera C4W, Nhựa Tốt",7300,7300,0,0
TIKI,giay-dep-nu,43118520,"Bộ 2 cặp lót giày 4D bảo vệ gót chân và chống tuột gót giày (loại vuông) - buybox - BBPK53",30000,60000,30000,50
TIKI,may-anh,187637105,"Combo Camera WiFi Ngoài Trời TP-Link Tapo C310 3MP và Thẻ Nhớ MicroSD Kioxia/ Dahua/ Lexar 32Gb/64Gb/128Gb/256Gb - Hàng Chính Hãng",899000,1679000,780000,46
TIKI,may-anh,58405493,"Kính hiển vi sinh học soi tinh trùng, ấu trùng, tế bào Barska AY13286 (40x-640x) - Hàng chính hãng",3619000,3619000,0,0
TIKI,may-anh,70774508,"Kính hiển vi bỏ túi Carson PocketMicro MM-450 (20x-60x) - Hàng chính hãng",970000,970000,0,0
TIKI,giay-dep-nu,73988252,"Giày thể thao sneaker nữ màu đen đế êm nhẹ thoáng khí thương hiệu ZAVAS - S392 - Hàng chính hãng",349000,360000,11000,3
TIKI,may-anh,46462092,"Camera IP Wifi Trong Nhà EZVIZ C6N 1080p (CS-C6N) - Hàng Chính Hãng",427000,891000,464000,52
TIKI,may-anh,193710119,"Kính hiển vi tích hợp màn hình LCD BARSKA  AY12226 4MP (40x, 100x, 400x) - Hàng Chính Hãng",8360000,8360000,0,0
TIKI,giay-dep-nu,68857080,"Dép đi nhà tắm, trong nhà chống trơn kiểu mới Hàn Quốc ghép hình",27500,55000,27500,50
TIKI,giay-dep-nu,120970633,"Dép Nữ Gấu Trúc Cực Cute, Dép Nữ Thời Trang Chống Trơn Mã DP06",89000,89000,0,0
TIKI,may-anh,5899427,"Tủ Chống Ẩm Andbon AB-30C (30 lít) - Hàng Nhập Khẩu",1074999,1074999,0,0
TIKI,may-anh,111466126,"Thẻ nhớ 64gb camera Hikvision-Hàng Chính Hãng",99000,99000,0,0
TIKI,giay-dep-nu,252563249,"Giày Nữ Đế Xuồng 5cm Da Bò Màu Đen Trường Hải DX115Đ",285000,285000,0,0
TIKI,giay-dep-nu,92161380,"Chai xịt giày diệt khuẩn khử mùi hôi giày hôi chân nano bạc Nano Xclean For Shoes",39000,60500,21500,36
TIKI,may-anh,116903572,"Camera Wifi Yoosee 4.0 Mpx Full HD, Dòng Ngoài Trời Xoay 360° 4 râu C12 Xem Đêm Có Màu-Đàm Thoại 2 Chiều-Phát Hiện Chuyển Động Chống Trộm-Hàng Nhập Khẩu",411000,629000,218000,35
TIKI,giay-dep-nu,32859444,"Lót giày cao gót chống rộng, chống trầy gót cực êm chân cao cấp- buybox - BBPK09",25000,40000,15000,38
TIKI,giay-dep-nu,71027758,"Giày sneaker thể thao nữ hàn quốc buộc dây siêu nhẹ V254",55000,55000,0,0
TIKI,giay-dep-nu,28590683,"Miếng lót giảm size cho giày bị rộng Cao Cấp - buybox - BBPK11",35000,70000,35000,50
TIKI,may-anh,72556060,"Camera IP Wifi Ngoài Trời Imou F22P Bullet 2C Full HD 1080P Tặng Phíc Cắm Âm - Hàng Chính Hãng",628900,628900,0,0
TIKI,giay-dep-nu,162027539,"Dép Đi Trong Nhà, Văn Phòng, Nhà Tắm Chống Trơn Đúc Liền DP03",85000,85000,0,0
TIKI,may-anh,103995541,"Combo Camera IP Wifi EZVIZ C6N 2MP (1080P) và Thẻ Nhớ 32GB - Hàng Chính Hãng",434900,434900,0,0
TIKI,may-anh,67179275,"Camera Mini IP Vstarcam CB72 1080P 2.0 Sim 4G LTE Giám Sát Hành Trình Ô Tô, Xem Trực Tiếp Từ Xa Bằng Điện Thoại, PC - Hàng Chính Hãng",1980000,1980000,0,0
TIKI,may-anh,142796515,"Camera IP wifi trong nhà IMOU Ranger 2 2MP/4MP - Hàng Chính Hãng",510000,690000,180000,26
TIKI,giay-dep-nu,105159478,"Chai Xịt Khử Mùi Giày Nano Xclean Nano Bạc 100ml AHT Corp Hương Bạc Hà - Khử Mùi, Diệt Khuẩn, Làm Sạch Giày Dép Hiệu Quả An Toàn",42000,99000,57000,58
TIKI,giay-dep-nu,252563621,"Giày Đế Xuồng nữ 5cm Da Bò khóa vuông Màu Đen Trường Hải DX116Đ",241000,285000,44000,15
TIKI,giay-dep-nu,254903581,"Giày Sục nữ da bò đế xuồng 5cm mũi nhọn màu xanh đen Trường Hải S129 CÓ SIZE LỚN",261000,299000,38000,13
TIKI,may-anh,242618146,"Camera IMOU wifi A22EP 1080P 2M xoay 360 độ đàm thoại 2 chiều - Hàng chính hãng",489000,489000,0,0
TIKI,giay-dep-nu,177164437,"Giày Lười Nữ NATIVE AD Jericho",1400000,1400000,0,0
TIKI,may-anh,155288624,"Tripod/ Chân đế dùng cho điện thoại và máy ảnh TTX-6218 - Có Remote chụp ảnh và túi đựng tiện lợi - Hàng chính hãng",299000,349000,50000,14
TIKI,giay-dep-nu,63145867,"Giày Thể Thao Nữ Màu Trắng Bằng Da Không Bong Tróc Đế Cao 4cm, Đế Êm Nhẹ, phù hợp đi chơi đi làm đi học , vận động bảo vệ đôi chân tránh tổn thương S352",299000,350000,51000,15
TIKI,giay-dep-nu,184955659,"Lót giày Mizuno chính hãng",80000,80000,0,0
TIKI,may-anh,174896487,"Camera WiFi Ngoài Trời TP-Link Tapo C320WS Độ Phân Giải 2K QHD - Hàng Chính Hãng",969000,1899000,930000,49
TIKI,may-anh,155199274,"Pin sạc AA Camelion 2700mAh",110000,110000,0,0
TIKI,may-anh,47030777,"[Chân chụp ảnh] Chân đế Tripod Bluetooth cho điện thoại và máy ảnh TTX - 6218 (Kèm túi đựng và remote bluetooth) - Hàng nhập khẩu",279000,299000,20000,7
TIKI,giay-dep-nu,128086059,"NÚT BẢO VỆ GÓT GIÀY CAO GÓT DẠNG BÚT TRÒN NHIỀU SIZE KHÁC NHAU",19000,19000,0,0
TIKI,giay-dep-nu,92161380,"Chai xịt giày diệt khuẩn khử mùi hôi giày hôi chân nano bạc Nano Xclean For Shoes",39000,60500,21500,36
TIKI,may-anh,75664666,"Camera Xiaomi 360 Imilab Home Security Chất Lượng Cao 1296x2304, Đàm Thoại 2 Chiều, Chế Độ Hồng Ngoài Ban Đêm, Chế Độ Chống Trộm - Hàng chính hãng",649000,899000,250000,28
TIKI,may-anh,32923633,"Vỉ 5 Viên Pin CR2032 Panasonic ( CR-2032/5BE x 1 Vỉ ) Lithium 3 V",100000,100000,0,0
TIKI,giay-dep-nu,20117907,"Bộ 02 cặp gồm 04 miếng lót gót giày silicon chống trầy bảo vệ gót chân, giảm size giày",16999,16999,0,0
TIKI,may-anh,7546725,"Dây cáp kết nối máy ảnh Canon với máy tính",49000,49000,0,0
TIKI,giay-dep-nu,70175132,"Dép Đi Trong Nhà Chống Trơn Trượt Phong Cách Hiện Đại, Sang Trọng YORN - Hàng Nhập Khẩu",39000,39000,0,0
TIKI,may-anh,127834480,"Camera Wifi trong nhà EZVIZ C6N 4MP, Hàng Chính Hãng",649000,649000,0,0
TIKI,giay-dep-nu,184910652,"Dép bánh mì Cross nữ đế 6cm siêu nhẹ kèm Sticker dễ thương - dép nữ hot trend 2022",104500,110000,5500,5
TIKI,giay-dep-nu,73989137,"Giày thể thao sneaker nữ màu trắng đế êm nhẹ thoáng khí thương hiệu ZAVAS - S393 - Hàng chính hãng",349000,360000,11000,3
TIKI,giay-dep-nu,43126126,"Bộ 2 cặp lót giày 4D bảo vệ gót chân và chống tuột gót giày (loại bầu) - buybox - BBPK54",30000,60000,30000,50
TIKI,may-anh,84866683,"Camera IP Wifi Trong Nhà Ezviz Mini CS-C1C-B 1080p - Hàng Chính Hãng",451000,990000,539000,54
TIKI,giay-dep-nu,28731166,"2 cặp lót giày chống tuột gót, chống trầy gót cực êm chân - buybox - BBPK09",45000,60000,15000,25
TIKI,may-anh,74610299,"Chân Đế Camera Xoay 360 độ, chuyên dùng cho Camera Ezviz C6N Camera Imou A22Ep Camera Kbone H21PW",6600,6600,0,0
TIKI,may-anh,41319582,"Camera IP Wifi Trong Nhà EZVIZ C6N 1080p - Hàng Chính Hãng",550000,630000,80000,13
TIKI,may-anh,106641569,"Camera Wifi Trong Nhà Yoosee 3.0 Full HD, 3 Râu, Xoay 360 độ , Đàm Thoại 2 Chiều, Cảm Biến Báo Động – Hàng nhập khẩu",212000,240000,28000,12
TIKI,giay-dep-nu,206123708,"Giày thể thao nam nữ phong cách mới – G1009NY",874000,1960000,1086000,55
TIKI,giay-dep-nu,103940142,"5 Cặp miếng lót bảo vệ chân khi đi giày cao gót",47000,59000,12000,20
TIKI,giay-dep-nu,108747100,"Chai xịt giày khử mùi hôi giày hôi chân Nano Xclean For Shoes 100ml - Hương Trà Xanh - Nano Bạc AHT Corp (AHTC)",59000,99000,40000,40
TIKI,may-anh,102125538,"Camera IP Wifi Tenda CP3 1080P 360°-Có Báo Động - Hàng Chính Hãng",370000,370000,0,0
TIKI,may-anh,193717163,"Thẻ nhớ SDXC SanDisk Extreme Pro SDSDXXU-064G U3 V30 64GB 200MB/s New 2022 - Hàng Nhập Khẩu",299000,299000,0,0
TIKI,may-anh,183689560,"Camera IP Wifi Deli 360 Độ Full HD 1080P Đàm Thoại 2 Chiều Hồng Ngoại Đêm - An Ninh Gia Đình, Văn Phòng - Hàng Chính Hãng",429000,898200,469200,52
TIKI,giay-dep-nu,158631445,"Dép Đi Trong Nhà Cói Mây Đế Cao Su Chống Trơn, Thoáng Mát Mã DP07",49000,49000,0,0
TIKI,giay-dep-nu,21040605,"Combo 2 Bộ Miếng Dán Đế Giày Chống Trơn Trợt (4 Miếng Dán)",30000,30000,0,0
TIKI,giay-dep-nu,107801529,"Cặp Lót Gót Giày XIMO XC03 Chống Rộng, Chống Nhấc Gót và Bảo Vệ Gót Tránh Trầy Xước",12000,21600,9600,44
TIKI,giay-dep-nu,213724172,"Giày búp bê da bò mũi tròn Trường Hải đính nơ xinh da mềm mại GBB110",259000,299000,40000,13
TIKI,may-anh,7388523,"Ống Nhòm Barska Lucid 10x42mm - Hàng chính hãng",1770000,1770000,0,0
TIKI,may-anh,26434415,"Camera IP WIFI IMOU RANGER 2 IPC - A22EP Full HD 1080P - Hàng Chính Hãng",520000,665000,145000,22
TIKI,may-anh,162227436,"Camera IP Wifi Deli Full HD 1080P 360 Độ Đàm Thoại 2 Chiều - An Ninh Gia Đình, Văn Phòng - Hàng Chính Hãng - ES102",429000,898200,469200,52
TIKI,may-anh,153998709,"Thẻ nhớ IMOU chuyên dụng cho Camera 95 MB/s Class 10 32GB/64GB - Hàng Chính Hãng",125000,125000,0,0
TIKI,may-anh,5452277,"Bộ giá đỡ điện thoại, máy ảnh 3 chân tripod",46998,46998,0,0
TIKI,giay-dep-nu,73120993,"IÀY BÚP BÊ TRƯỜNG HẢI DA BÒ MỀM MÀU VÀNG BÒ SANG TRỌNG MŨI GIÀY TRÒN, ĐẾ MỀM DẺO BÊN CHẮC VÀ THỜI TRANGBB025",217000,289000,72000,25
TIKI,may-anh,85764360,"Camera Wifi TP-Link Tapo C310 3MP An Ninh Ngoài Trời - Hàng Chính Hãng",799000,1499000,700000,47
TIKI,giay-dep-nu,161943939,"Dép Quai Ngang Nam Nữ Siêu Nhẹ Tăng Chiều Cao Chống Trơn DP02",75000,75000,0,0
TIKI,giay-dep-nu,180999168,"Dép Bánh Mì Nữ Nam EVA Cao Cấp Đế Cao Mát xa Siêu Nhẹ Siêu Bền",48000,48000,0,0
TIKI,giay-dep-nu,108747100,"Chai xịt giày khử mùi hôi giày hôi chân Nano Xclean For Shoes 100ml - Hương Trà Xanh - Nano Bạc AHT Corp (AHTC)",59000,99000,40000,40
TIKI,giay-dep-nu,32726343,"2 cặp miếng lót giày cao gót mũi tròn cho giày bị rộng, giúp giảm size cao cấp - buybox - BBPK11",70000,140000,70000,50
TIKI,may-anh,28324579,"Pin Sạc AA Eneloop Pro 2550 mah Made In Japan - Hàng Chính Hãng ( Panasonic Việt Nam nhập khẩu và Phân Phối)",425000,425000,0,0
TIKI,may-anh,107356974,"Camera Wifi TP-Link Tapo C210 Độ Phân Giải 3MP Lưu trữ 256GB Giám Sát An Ninh - Hàng Chính Hãng",559000,1118000,559000,50
TIKI,may-anh,251931548,"Kính hiển vi phân tích, kiểm tra bề mặt da độ nét cao Terino M66F (50X-500X) - Hàng chính hãng",5830000,5830000,0,0
TIKI,giay-dep-nu,31593583,"Lót mũi giày cao gót cao su non đệm êm ngón chân - buybox - BBPK50",25000,50000,25000,50
TIKI,giay-dep-nu,105159478,"Chai Xịt Khử Mùi Giày Nano Xclean Nano Bạc 100ml AHT Corp Hương Bạc Hà - Khử Mùi, Diệt Khuẩn, Làm Sạch Giày Dép Hiệu Quả An Toàn",42000,99000,57000,58
TIKI,giay-dep-nu,197419814,"Giày Sandal Nữ Đế Xuồng BIGGBEN Da Bò Cao Cấp SDX11",329000,450000,121000,27
TIKI,may-anh,56021195,"Pin CR2 Panasonic Lithium Photo Power 3V chính hãng vỉ 1 viên",109000,109000,0,0
TIKI,giay-dep-nu,252596684,"Giày búp bê mũi tròn trơn da bò mềm mại Trường Hải GBB118 có 2 màu đen, đỏ",241000,285000,44000,15
TIKI,giay-dep-nu,86860057,"Giày Sandal Cao Gót Da Bò BIGGBEN Cao 5 Phân SDCG60",299000,550000,251000,46
TIKI,may-anh,24766023,"Bộ Sạc Pin AA AAA + 4 Pin AA 1200mAh Doublepow (Hàng nhập khẩu)",79800,79800,0,0
TIKI,giay-dep-nu,88979578,"[Ảnh Thật] Dép Quai Ngang, Dép Đi Trong Nhà, Ngoài Trời Họa Tiết Cá Sấu Siêu Dễ Thương, Logo Nổi. Form Nhỏ Các Bạn Đặt Tăng 1 Size Nha Mã DP19",89000,89000,0,0
TIKI,giay-dep-nu,133617832,"Dép Đi Trong Nhà, Căn Hộ Chung Cư, Văn Phòng, Nhà Tắm Siêu Êm Chống Trơn Trượt Mẫu Mới",95000,140000,45000,32
TIKI,giay-dep-nu,209305648,"Dép Lông Bông Plush Đi Trong Nhà, Phòng Ngủ - Hàng Chính Hãng",87400,95000,7600,8
TIKI,giay-dep-nu,54354661,"Combo 4 miếng lót đế giày tăng chiều cao Air có đệm khí siêu êm ái, giày đế cao, giày độn gót GD233-LGIAYTCC",61000,61000,0,0
TIKI,giay-dep-nu,197643943,"Giày công sở nữ, giày cao gót HT.NEO gót vuông 5p chất liệu da cao cấp, đi cực êm chân, thoải mái, giày được thiết kế trẻ trung với khuy CD CS256",435000,900000,465000,52
TIKI,may-anh,270772763,"Máy bay Flycam mini 4k giá rẻ Drone E88 Pro 2 camera kép kết nối WIFI 2.4GHZ, ĐỘ PHÂN GIẢI 4K, Bay cao 100m, nhào lộn 360 độ thích làm đồ chơi cho bé Tặng túi đựng chống sốc - Hàng chính hãng",399000,750000,351000,47
TIKI,giay-dep-nu,90519531,"Giày thể thao nữ ZAVAS đế cao 3cm màu trắng bằng da không bong tróc mang êm chân S411 - Giày Sneaker Nữ Chính Hãng",349000,420000,71000,17
TIKI,may-anh,263488986,"Camera WIFI Ngoài Trời IMOU S21FP, S41FP Có Màu Ban Đêm, Xoay 360 Độ - Hàng chính hãng",799000,1200000,401000,33
TIKI,may-anh,195863820,"Thẻ nhớ SDXC SanDisk Extreme U3 V30 64GB 170MB/s SDSDXV2-064G (New 2022) - Hàng Nhập Khẩu",255000,255000,0,0
TIKI,giay-dep-nu,140573000,"Dép Bông Đi Trong Nhà Đế Cao Su Đúc Cao Cấp LACEVA DP95",99000,99000,0,0
TIKI,may-anh,263987622,"Camera Wifi TP-Link Tapo C200 / C210 Smart IR Full HD 1080P - Hàng Chính Hãng",445000,445000,0,0
TIKI,giay-dep-nu,103879065,"Dép quai ngang nam nữ, dép đi trong nhà, dép văn phòng siêu êm đúc nguyên khối, dép bánh mì, dép lê siêu nhẹ - Hàng nhập khẩu",43000,43000,0,0
TIKI,giay-dep-nu,71680262,"Giày nhựa đi mưa chịu nước chống trơn trượt dáng búp bê công sở V258",55000,55000,0,0
TIKI,dien-tu-dien-lanh,106594158,"MÁY GIẶT CỬA TRƯỚC 8.5KG CASPER MG WF85I140BGB-  HÀNG CHÍNH HÃNG ( CHỈ GIAO HÀ NỘI )",6800000,6800000,0,0
TIKI,dien-tu-dien-lanh,271448660,"Remote Điều Khiển TV Dành Cho TCL Smart Tivi Nhận Giọng Nói NETFLIX YouTube",98000,98000,0,0
TIKI,dien-tu-dien-lanh,93066052,"Smart Tivi Samsung 4K 65 inch UA65AU7700",11400000,12950000,1550000,12
TIKI,dien-tu-dien-lanh,103071703,"Remote máy lạnh Daikin Inverter - Hàng chính hãng",220000,220000,0,0
TIKI,dien-tu-dien-lanh,270057368,"Remote Điều Khiển Tivi Dành Cho SHARP Smart TV GB234WJSA RM-L1346",30000,30000,0,0
TIKI,phu-kien-thoi-trang,96189571,"Gọng kính chính hãng Carrera CARRERA5023V OGC",1600000,3200000,1600000,50
TIKI,dien-tu-dien-lanh,142212821,"Giá treo màn hình xoay 360 độ - Chân đứng - Tay dài 23 cm, kẹp bàn model XL03",269900,269900,0,0
TIKI,phu-kien-thoi-trang,27662813,"Gọng kính nữ Miss Sixty MX169 R96",680000,1700000,1020000,60
TIKI,dien-tu-dien-lanh,140836636,"Máy lão hóa và khử độc tố GIPWIN 20L - HÀNG CHÍNH HÃNG",55000000,55000000,0,0
TIKI,dien-tu-dien-lanh,1010522,"Tủ Lạnh Inverter Aqua AQR-IG525AM-GB (456L) – Đen - Hàng chính hãng ",17644000,17644000,0,0
TIKI,phu-kien-thoi-trang,206482134,"Gọng kính chính hãng Puma PE0039OA-002",783000,1500000,717000,48
TIKI,dien-tu-dien-lanh,192193315,"Box Mytv Net 2H - Android TV 10 - RAM 2GB + 16GB - Hàng Chính Hãng",759000,759000,0,0
TIKI,may-anh,536260,"Tủ Lạnh Inverter Sharp SJ-FX680V-ST (605L)-Hàng Chính Hãng",16950000,16950000,0,0
TIKI,may-anh,176289256,"Máy Sấy Thông Hơi Electrolux 8.5 kg EDV854J3WB - Hàng Chính Hãng - Chỉ Giao HCM",11490000,11490000,0,0
TIKI,may-anh,165964546,"Ron tủ lạnh dành cho tủ lạnh  Sharp model SJ-165S-GR",153000,153000,0,0
TIKI,phu-kien-thoi-trang,222627373,"Thắt lưng nam da thật cao cấp nhãn hiệu Macsim MS45",800000,800000,0,0
TIKI,dien-tu-dien-lanh,53798008,"Remote Điều Khiển Cho Máy Lạnh, Điều Hòa MITSUBISHI E07140426, SLZ-A09RA, SLZ-A12RA (Kèm Pin AAA Maxell)",44500,44500,0,0
TIKI,phu-kien-thoi-trang,48867441,"Dung Dịch Ngâm Kính Áp Tròng Vision Plus + ( Nước Ngâm Lens )",70000,70000,0,0
TIKI,may-anh,34744943,"Tủ Lạnh AQUA Inverter 456 Lít AQR-IGW525EM GB - HÀNG CHÍNH HÃNG",19249000,19249000,0,0
TIKI,phu-kien-thoi-trang,58332431,"Mắt kính mát nam nữ đổi màu dùng cả ngày và đêm, tròng Polaroid phân cực. Mã DKY8503DM",269000,269000,0,0
TIKI,phu-kien-thoi-trang,57999755,"Mắt kính mát nữ thời trang form mắt mèo màu đen, chống tia UV. Mã DKY337D.",159000,159000,0,0
TIKI,may-anh,76053885,"Máy Giặt Sóng Siêu Âm Đảo Chiều Tự Động Có Thể Xếp Gọn",341000,341000,0,0
TIKI,dien-tu-dien-lanh,196897091,"GIÁ TREO TIVI DI ĐỘNG 32-75 INCH,HÀNG CHÍNH HÃNG",780000,780000,0,0
TIKI,may-anh,198573060,"TẤM CHẮN GIÓ KHE LẠNH ĐIỀU HÒA Kt 60X15cm",350000,350000,0,0
TIKI,phu-kien-thoi-trang,113480536,"Kính Mát ,Mắt Kính Unisex ASARIFA RP18009 C1",800000,800000,0,0
TIKI,may-anh,176289443,"[HCM] Máy Sấy Thông Hơi Electrolux 8.5 kg EDS854J3WB (MODEL 2022) - 12 Chương Trình Sấy - Hàng Chính Hãng",12990000,12990000,0,0
TIKI,phu-kien-thoi-trang,87093158,"Dây thắt lưng nam D&D Fashion ( dây riêng lẻ không mặt ) dây da thật sử dụng cho khóa tự động",28000,50000,22000,44
TIKI,may-anh,126702091,"Điều khiển tivi dành cho Toshiba CT-8068",47500,50000,2500,5
TIKI,may-anh,187271835,"Android tivi box MAGICSEE N5 MAX X4 Ram 4G Android 11 điều khiển giọng nói kiêm bàn phím chuột bay có đèn nền dual wifi 2 băng tần bluetooth S905X4 cài sẵn phim, truyền hình cáp miễn phí vĩnh viễn cáp miễn phí vĩnh viễn - Hàng nhập khẩu ",1555000,1555000,0,0
TIKI,may-anh,167549374,"Smart Tivi Crystal Samsung 4K 65 inch UA65BU8000 - Model 2022",14200000,14200000,0,0
TIKI,phu-kien-thoi-trang,113007808,"Kính Mát,Mắt Kính Unisex ASARIFA RP3025 Nhiều Màu",800000,800000,0,0
TIKI,may-anh,189204315,"Máy rửa bát 15 bộ cao cấp Nagakawa NAG3601M15 - Made in Malaysia - Hàng chính hãng",11499000,16099000,4600000,29
TIKI,may-anh,196002803,"Tủ lạnh LG Inverter 335 lít GN-M332PS - Hàng chính hãng [Giao hàng toàn quốc]",12990000,12990000,0,0
TIKI,dien-tu-dien-lanh,176443152,"Máy giặt LG lồng đứng 10.5kg T2350VS2W Smart Inverter - Hàng chính hãng (chỉ giao HN và một số khu vực)",6090000,6090000,0,0
TIKI,phu-kien-thoi-trang,140843587,"Mũ Lưỡi Trai Lính Mỹ US ARMY U890, Nón Lưỡi Trai Rằn Ri Đi Phượt Phong Cách Lính - HÀNG CHÍNH HÃNG",76000,178000,102000,57
TIKI,phu-kien-thoi-trang,143022333,"Găng tay giữ ấm mùa đông chống gió, kháng nước mưa Rhino G101 Bao tay thể thao cảm ứng điện thoại đi xe máy, xe đạp lót nỉ cho nam nữ,  bảo hộ đi phượt",155000,200000,45000,23
TIKI,may-anh,126702225,"Remote Điều khiển từ xa Tivi giọng nói dành cho LG AN-MR650A LG 2017",259000,259000,0,0
TIKI,phu-kien-thoi-trang,172904600,"Găng tay chống nắng thể thao cho nam nữ | Sport Sun Protection Sleeves - Thiết kế cá tính, mạnh mẽ",45000,45000,0,0
TIKI,may-anh,53308440,"Tủ mát - Minibar thương hiệu Homesun, Model: BCH-40B, Thể tích 40L, Công suất 65W, Điện áp 220VAC, Không tiếng ồn, Tiết kiệm điện năng, Màu đen sang trọng, Hàng chính hãng",3960000,3960000,0,0
TIKI,dien-tu-dien-lanh,24944567,"Máy Nước Nóng Gián Tiếp Casper EH-20TH11 (2500W) - Hàng Chính Hãng",2250000,2250000,0,0
TIKI,dien-tu-dien-lanh,459570,"Máy Nước Nóng FERROLI QQ EVO 30L ME (2500W)",2389000,2389000,0,0
TIKI,phu-kien-thoi-trang,174376514,"Thắt Lưng Dây Nịt  Nam Khóa Tự Động Giản Dị Mặt Đen  DT101",64000,80000,16000,20
TIKI,may-anh,114830872,"[Lắp đặt trong vòng 24h] Máy Giặt Cửa Trước Panasonic 9.5 Kg NA-FD95V1BRV - Công Suất Xoáy Giặt Nhanh - Hàng chính hãng",10190000,12190000,2000000,16
TIKI,phu-kien-thoi-trang,163572707,"Thắt lưng da nam cao cấp- dây nịt da bò 2 lớp EMRENEW -Full hộp đựng cao cấp",290000,580000,290000,50
TIKI,dien-tu-dien-lanh,195956112,"Tủ lạnh Toshiba Inverter 509 lít GR-RF605WI-PMV(06)-MG - Hàng chính hãng [Giao hàng toàn quốc]",21140000,29990000,8850000,30
TIKI,dien-tu-dien-lanh,114447965,"Giá treo màn hình máy tính NB F100A 22 - 35 inch - Hàng Chính Hãng ",474000,474000,0,0
TIKI,may-anh,109693112,"Máy Nước Nóng Gián Tiếp Ariston Vitaly 30 2.5 FE (2500W) - Hàng chính hãng",2149000,2149000,0,0
TIKI,phu-kien-thoi-trang,67921211,"Kính mát, mắt kính SARIFA 1052",450000,450000,0,0
TIKI,phu-kien-thoi-trang,183685137,"Thắt Lưng Dây Nịt Nam Vải Dù US ARMY, Phong Cách Sang Trọng Cổ Điển Mặt Khóa Hợp Kim Thép Chống Ghỉ Cao Cấp -HÀNG CHÍNH HÃNG",72000,158000,86000,54
TIKI,may-anh,16872971,"Điều khiển dùng cho điều hòa LG 2 chiều ngắn",50000,50000,0,0
TIKI,phu-kien-thoi-trang,58163346,"Kính mát nữ ulzzang 2020 hot nhất",13000,60000,47000,78
TIKI,may-anh,195219893,"Máy rửa chén Junger 2100W DWJ-450 - Hàng chính hãng",19950000,19950000,0,0
TIKI,dien-tu-dien-lanh,100042541,"Moter Quạt 100% đồng (cuộn điện 5 sao) B4 220V - Moter 220v",155000,155000,0,0
TIKI,may-anh,112716880,"Máy giặt 9.5kg Casper WF-95I140BGB Inverter Mới 2021 Xuất xứ Thái Lan -Hàng chính hãng (Chỉ giao Hà Nội)",5990000,5990000,0,0
TIKI,dien-tu-dien-lanh,182821962,"Điều hòa Panasonic 1 chiều Inverter R32 Tiêu chuẩn CS/CU-XPU12XKH-8 -[Chính hãng - giao hàng Hà Nội]",11450000,11450000,0,0
TIKI,dien-tu-dien-lanh,85186784,"Nước rửa dàn lạnh máy lạnh AC-007.1",45000,45000,0,0
TIKI,giay-dep-nu,91011976,"Giày búp bê nữ BIGGBEN da bò cao cấp BB89",309000,400000,91000,23
TIKI,may-anh,86139384,"MÁY RỬA CHÉN BOSCH HMH.SMS63L08EA - HÀNG CHÍNH HÃNG - chỉ giao tại hcm",13389000,13389000,0,0
TIKI,may-anh,90148835,"Máy giặt Samsung Inverter 11kg WA11T5260BV/SV - Chỉ giao Hà Nội",8550000,8550000,0,0
TIKI,phu-kien-thoi-trang,83423370,"Bộ dụng cụ tua vít đa năng sửa kính, mắt kính",3000,8900,5900,66
TIKI,dien-tu-dien-lanh,178058673,"Google Tivi Sony 4K 55 inch KD-55X81DK - Model 2022",13800000,13800000,0,0
TIKI,phu-kien-thoi-trang,189215794,"(Combo) Đệm Mũi Chống Trượt, không làm hằn mũi, chơi thể thao cho mắt kính (vỉ 4 Cặp)",14000,20000,6000,30
TIKI,phu-kien-thoi-trang,34261311,"Tất Vớ trơn Nam Nữ cổ ngắn chuẩn xuất Nhật, Set 12 đôi sử dụng cả tuần",37000,88900,51900,58
TIKI,may-anh,186117126,"Tủ lạnh Aqua 130 lít AQR-T150FA (BS) - Hàng Chính Hãng [Giao hàng toàn quốc]",4680000,4890000,210000,4
TIKI,phu-kien-thoi-trang,100347074,"Combo 5 chiếc KHẨU TRANG VẢI 3 LỚP KHÁNG KHUẨN MAY 10 (GIAO MÀU NGẪU NHIÊN)",20000,20000,0,0
TIKI,may-anh,196953412,"MÁY RỬA BÁT TEXGIO TG–DT2022B – Hàng chính hãng",6200000,6200000,0,0
TIKI,phu-kien-thoi-trang,631716,"Gọng Kính Nữ Just Cavalli JC0369 002 (52/17/140) - Đen Đồi Mồi",3900000,3900000,0,0
TIKI,phu-kien-thoi-trang,92911325,"Mắt kính mát nữ ốc 7K6833 màu nâu, xám khói râm mát, dịu mắt. Tròng kính chống nắng, chống tia UV. Form kính ôm mặt",99000,99000,0,0
TIKI,giay-dep-nu,46490330,"Giày Thể Thao Độn Đế 10cm PS252",550000,550000,0,0
TIKI,phu-kien-thoi-trang,19716248,"Bộ 2 Kẹp Tóc Càng Cua",3000,25000,22000,88
TIKI,phu-kien-thoi-trang,163572294,"Thắt lưng da nam cao cấp- dây nịt da bò 2 lớp EMRENEW -Full hộp đựng cao cấp",290000,290000,0,0
TIKI,dien-tu-dien-lanh,104799579,"ĐIỀU KHIỂN TIVI CASPER  GIỌNG NÓI (SP 1828) HÀNG NHẬP KHẨU",210000,210000,0,0
TIKI,dien-tu-dien-lanh,131007332,"Máy lạnh Casper Inverter 1 HP GC-09IS32 - Hàng chính hãng - Giao hàng toàn quốc",6500000,6500000,0,0
TIKI,may-anh,128628167," Tivi Box  Kiwi S3 Pro - Phiên Bản 2021 - Ram2G/16G - Android 10 -Cầu Hình Siêu Khủng - Hàng Chính Hãng",780000,780000,0,0
TIKI,phu-kien-thoi-trang,164021724,"Kính Mát Nam Nữ, Mắt Kính Phân Cực Thời Trang, Gọng Kính Vuông Magie AK010 - AORON",220000,320000,100000,31
TIKI,phu-kien-thoi-trang,74743103," Kẹp Tóc Càng Cua Hàn Quốc Dễ Thương Với Thiết Kế Tinh Tế KT18",22000,48000,26000,54
TIKI,dien-tu-dien-lanh,75379889,"KHUNG TREO TIVI NGHIÊNG 42-64 INCH",145000,145000,0,0
TIKI,phu-kien-thoi-trang,3712423,"1 Đôi Găng Tay Chiến Thuật Hở Ngón (2 Chiếc) (Size",25000,25000,0,0
TIKI,phu-kien-thoi-trang,137960010,"(Hàng Xịn) Thắt lưng Nam vải dù_Siêu bền_Mặt khóa gài tự động thép không gỉ chắc chắn, tiện lợi_Dây lưng vải dù cao cấp, Thắt lưng lính",139000,139000,0,0
TIKI,giay-dep-nu,101775139,"Giày múa Ba lê cao cổ, giày khiêu vũ múa bale",120000,120000,0,0
TIKI,giay-dep-nu,180105162,"[CHẤT LƯỢNG] Giày sandal chiến binh da cắt lazer đinh đế thấp cao cấp S370D",272000,289000,17000,6
TIKI,phu-kien-thoi-trang,73329267,"Kính mát, mắt kính SARIFA 3025 (58-14-135) nhiều màu",800000,800000,0,0
TIKI,phu-kien-thoi-trang,107783759,"Khẩu trang vải Azumikichi màu đen, khẩu trang thời trang cao cấp sang trọng",20900,25000,4100,16
TIKI,giay-dep-nu,133236075,"Giày nhựa đúc 2 lớp Thái Lan đi mưa MONOBO - TAMMY",180000,180000,0,0
TIKI,dien-tu-dien-lanh,823162,"Tủ Lạnh Inverter Sharp SJ-X316E-DS (287L) - Hàngchính hãng",7090000,7090000,0,0
TIKI,may-anh,142781325,"VinaBox X9 (Phiên Bản Thế Hệ Mới 2022) - Ram 2G/16G - Truyền Hình OTT Miễn Phí - Siêu Phẩm Trở Lại - Chất Lượng Bền Lâu - Hàng Chính Hãng",667000,667000,0,0
TIKI,may-anh,12771188,"Bình nước nóng Ariston Slim2 SL2 20 R - 20 lít - Hàng Chính Hãng",2899000,2899000,0,0
TIKI,phu-kien-thoi-trang,83357670,"Nước lau kính, lau tròng kính cận",20000,20000,0,0
TIKI,may-anh,23419942,"Máy giặt mini tại xô DEKE GT-16AC tiết kiệm điện cho sinh viên và em bé có hẹn giờ và đảo chiều",1099000,1099000,0,0
TIKI,phu-kien-thoi-trang,83359866,"Combo 5 khăn lau kính đa năng, khăn lau kính cận, khăn lau kính mát (giao màu ngẫu nhiên)",10000,10000,0,0
TIKI,phu-kien-thoi-trang,49246349,"DÂY ĐEO KÍNH THỜI TRANG ACCEDE - DÂY NHUNG (Giao mẫu ngẫu nhiên)",80000,80000,0,0
TIKI,phu-kien-thoi-trang,169641329,"Dây đeo mắt kính giữ gọng kính, chơi thể thao chống rơi kính",45000,50000,5000,10
TIKI,giay-dep-nu,176030540,"Giày công sở nữ đế xuồng HT.NEO cao 7p chất liệu da bò cao cấp, đi cực  êm chân CS79",390000,900000,510000,57
TIKI,giay-dep-nu,192196517,"Giày sandal nữ da bò thật BIGGBEN cao cấp SDN81",339000,400000,61000,15
TIKI,dien-tu-dien-lanh,126701936,"Remote Điều khiển tivi dành cho Sony giọng nói RMF-TX310P",185000,185000,0,0
TIKI,dien-tu-dien-lanh,55964022,"Tủ Lạnh 2 Cánh Panasonic 188 Lít NR-BA229PAVN - Kháng khuẩn tinh thể bạc Ag+ - Hàng chính hãng",7490000,8490000,1000000,12
TIKI,phu-kien-thoi-trang,191693411,"KHẨU TRANG MẶT NẠ CHE GÒ MÁ, CHỐNG TIA CỰC TÍM UPF50+ MÃU MỚI",29000,29000,0,0
TIKI,giay-dep-nu,169586601,"[CHUẨN CHẤT LƯỢNG] Giày boot đế thô 5 phân cột dây 1 dây kéo cá tính street style đường phố ulzzang boots S002",289000,289000,0,0
TIKI,giay-dep-nu,163035058,"Dép Đi Trong Nhà, Văn Phòng, Xốp Lỗ Siêu Nhẹ Siêu Rẻ, Chống Trơn Trượt - Hàng Loại 1 - Giao Màu Ngẫu Nhiên",28000,45000,17000,38
TIKI,dien-tu-dien-lanh,138909307,"Vệ Sinh Máy Lạnh Siêu Sạch Tại Nhà (sử dụng 10 lần)",159000,159000,0,0
TIKI,giay-dep-nu,128088524,"GIÀY KHIÊU VŨ NỮ MÀU ĐỒNG NHẸ",325000,325000,0,0
TIKI,phu-kien-thoi-trang,113484947,"Kính Mát ,Mắt Kính Unisex ASARIFA RP18012 C2",800000,800000,0,0
TIKI,dien-tu-dien-lanh,119976828,"Tủ lạnh Panasonic Inverter 268 lít NR-TV301VGMV - Diệt khuẩn 99.99% - Ướp lạnh nhanh - Hàng chính hãng",10990000,12690000,1700000,13
TIKI,phu-kien-thoi-trang,117492265,"Combo 5 đôi Tất nam cổ ngắn vintage, Vớ Cổ Ngắn Nam Cotton mềm mại, thoáng khí sử dụng cả tuần",39000,50000,11000,22
TIKI,may-anh,11998183,"Android tivi box VNPT MyTVNet Net 1 - Tặng kèm chuột không dây chính hãng  ",725000,725000,0,0
TIKI,phu-kien-thoi-trang,184880509,"Dây Đeo Kính Thể Thao Chuyên Dụng Giữ Kính Chống Rơi Khi Chơi Thể Thao, Vận Động APK057 - Aoron",90000,90000,0,0
TIKI,giay-dep-nu,67726699,"HAVAIANAS - Dép nữ Slim 4000030-0001-334",699000,699000,0,0
TIKI,phu-kien-thoi-trang,16519989,"Cài tóc tạo hình bính tóc",27000,35000,8000,23
TIKI,may-anh,120389915,"Remote Điều Khiển Dùng Cho SONY Smart TV, Internet Tivi RMT-TX100D",56000,56000,0,0
TIKI,phu-kien-thoi-trang,165602471,"Tất Nữ, Combo 5 Đôi Tất Nữ Cổ Ngắn, Mẫu Tất Nữ Hình Gấu Nhiều Màu Dễ Thương Thời Trang Baw TN06",99000,99000,0,0
TIKI,dien-tu-dien-lanh,11668829,"Android Tivi Box TX3 Mini Phiên Bản 2GB Ram Và 16GB Bộ Nhớ Trong, Hệ Điều Hành Android TV, Tìm Kiếm Giọng Nói - Hàng Nhập Khẩu",550000,550000,0,0
TIKI,giay-dep-nu,115264279,"Dép kẹp nữ xỏ ngón Thái Lan Nữ  Monobo Moniga 5.5",90000,90000,0,0
TIKI,dien-tu-dien-lanh,46179293,"Tấm chắn điều hướng gió  máy lạnh, điều hòa treo tường trong suốt cao cấp",225000,225000,0,0
TIKI,giay-dep-nu,62649454,"Dép nữ sandal Trường Hải đế xuồng da bò thật màu vàng Cao 5cm HÌNH ẢNH THẬT",250000,295000,45000,15
TIKI,giay-dep-nu,52274758,"Giày Sandal Nữ Cao Gót BIGGBEN Da Bò Thật SDCG41",339000,400000,61000,15
TIKI,may-anh,71567079,"Điều khiển thông minh dành cho tivi LG 2018",418000,418000,0,0
TIKI,dien-tu-dien-lanh,191689652,"Máy giặt lồng ngang LG Inverter 9Kg FM1209S6W - Hàng Chính Hãng (chỉ giao HN và một số khu vực)",6890000,6890000,0,0
TIKI,phu-kien-thoi-trang,164021689,"Mắt Kính Phân Cực Thể Thao Đổi Màu Chống Chói Đi Nắng Đi Đêm, Kính Mát Nam Nữ Thời Trang  AK041 AORON",270000,450000,180000,40
TIKI,dien-tu-dien-lanh,213705668,"Máy Rửa Chén Độc Lập Bosch HMH.SMS4HCI48E (Series 4) - 14 Bộ - 6 Chương Trình Rửa - Hàng Chính Hãng",32000000,32000000,0,0
TIKI,giay-dep-nu,175469588,"Giày chạy bộ nữ Under Armour HOVR Sonic 4 - 3023559",2207000,3395000,1188000,35
TIKI,giay-dep-nu,81507608,"Giày Búp Bê Bệt Da Bò Thật Hoạ Tiết Pixie X666",450000,450000,0,0
TIKI,giay-dep-nu,67725452,"HAVAIANAS - Dép nữ Slim 4000030-0090-378",699000,699000,0,0
TIKI,may-anh,77910697,"Điều Hòa Nagakawa 9000Btu NS-C09R1M05 - Chỉ Giao tại HN",4990000,4990000,0,0
TIKI,phu-kien-thoi-trang,109776986,"Thắt Lưng Vải Nam Phong Cách Lính U669 Mặt Khóa Hợp Kim Thép Không Ghỉ Sáng Bóng-Hàng chính hãng",76000,179000,103000,58
TIKI,giay-dep-nu,192201329,"Dép nữ Quai ngang đế cao Thái Lan nữ MOSSONO YW568",260000,260000,0,0
TIKI,may-anh,50278870,"Khung treo tivi sát tường 26 - 32 inch",48000,48000,0,0
TIKI,dien-tu-dien-lanh,174292585,"CHÂN ĐỠ TIVI DI ĐỘNG CÓ BÁNH XE DÙNG CHO MÀN HÌNH TỪ 32 INCH  - 120 INCH",1200000,1200000,0,0
TIKI,giay-dep-nu,40344004,"Giày nữ đế xuồng da bò cao cấp Trường Hải DX218",264000,309000,45000,15
TIKI,giay-dep-nu,164203822,"Dép Nữ Thái Lan có hạt Massage Monobo Moniga 25.5",110000,110000,0,0
TIKI,phu-kien-thoi-trang,48891024,"KÍNH MÁT NAM EXFASH EF79971",449000,840000,391000,47
TIKI,dien-tu-dien-lanh,176463760,"Máy lạnh Panasonic 1 HP Inverter CS-XPU9XKH-8-HÀNG CHÍNH HÃNG-GIAO HÀNG TOÀN QUỐC",9999000,9999000,0,0
TIKI,may-anh,95515402,"Android Tivi OLED Sony 4K 55 inch XR-55A80J",26204000,26204000,0,0
TIKI,giay-dep-nu,175540244,"Giày Nữ Búp Bê Đế Bệt TiTi ĐÔ Da Bò Thật Cao Cấp GBBN2038a",396000,396000,0,0
TIKI,dien-tu-dien-lanh,99477185,"{bảo hành 06 tháng}Remote điều khiển tivi  giọng nói dành cho Sony RMT-TX300A",300000,300000,0,0
TIKI,may-anh,53304261,"Tủ lạnh Funiki Hòa Phát FR 136ISU 130 lít - Hàng Chính Hãng",3890000,3890000,0,0
TIKI,phu-kien-thoi-trang,56262919,"Thắt Lưng Nữ Nhỏ Xinh TL005 MayHomes, Dây Lưng Nữ, Dây Nịt Nữ Chất Liệu Da PU Khóa Kim Loại Bền Đẹp",33600,35000,1400,4
TIKI,giay-dep-nu,74829838,"Dép Xỏ Ngón Unisex Crocs CROCBAND 11033",767000,1095000,328000,30
TIKI,giay-dep-nu,126085241,"Dép Đế Trấu Nam Nữ 2 Quai Ngang Khóa Đi Mưa Detaunisex Màu Đen - DETA21F",300000,300000,0,0
TIKI,giay-dep-nu,195357367,"Dép Nữ Da Bò Thật BIGGBEN Cao Cấp DNQN52",299000,350000,51000,15
TIKI,may-anh,146363487,"Hệ Thống Máy Lạnh Multi S Daikin Inverter Combo 2HP + 02 dàn lạnh 1.0HP + 1.5HP - MKC50RVMV/CTKC25RVMV+CTKC35RVMV - Hàng Chính Hãng - Chỉ giao tại TP.HCM",22042000,22042000,0,0
TIKI,giay-dep-nu,108651737,"Sục cao gót bít mũi, kiểu dáng tôn chân, sang chảnh ModelM5 ( TẶNG KÈM 02 ĐÔI TẤT MÀU NGẪU NHIÊN CỐ THẤP CHỐNG NẮNG HÌNH TRÁI TIMM )",214000,214000,0,0
TIKI,dien-tu-dien-lanh,65453428,"Máy giặt LG Inverter 8.5 kg FV1408S4W - Chỉ giao HCM",8322000,8322000,0,0
TIKI,phu-kien-thoi-trang,191489615,"Thắt Lưng Dây Nịt Nam Da Bò Khóa Tự Động Phiên Bản Hàn Đơn Giản Sành Điệu Trẻ Trung  DT113",126000,140000,14000,10
TIKI,giay-dep-nu,67727885,"HAVAIANAS - Dép nữ Slim 4000030-2719-378",699000,699000,0,0
TIKI,giay-dep-nu,141469159,"Giày cao gót nữ đẹp đế vuông 8 phân hàng hiệu rosata màu đen ro322",490000,490000,0,0
TIKI,may-anh,114856783,"[CHỈ GIAO TẠI HCM] - Máy giặt Panasonic 16kg NA-FD16V1BRV - Hàng Chính Hãng",23090000,23090000,0,0
TIKI,giay-dep-nu,169354968,"Giày nhựa đi mưa nữ Alina 3p dáng công sở V291",54000,54000,0,0
TIKI,may-anh,114772016,"Tủ lạnh 2 cánh Panasonic 234 lít NR-TV261BPKV - Diệt khuẩn 99.99% - Tiết kiệm điện - Hàng chính hãng",9140000,10390000,1250000,12
TIKI,giay-dep-nu,55663875,"Giày Sandal nữ cao gót Phong Cách Hàn Quốc SDAN115",199000,199000,0,0
TIKI,giay-dep-nu,51967828,"Giày lười nữ êm chân thoáng khí thời trang mới nhất V228",69000,69000,0,0
TIKI,giay-dep-nu,143796531,"Dép nữ xỏ ngón thời trang Màu Kem Trường Hải da mềm êm ái đế Pu nhẹ cao 2.5cm thời trang nữ cao cấp DN145K",207000,259000,52000,20
TIKI,may-anh,167441196,"LỒNG QUẠT MÁY - HÀNG CHÍNH HÃNG 3HT",40000,40000,0,0
TIKI,giay-dep-nu,73566157,"Sandal nữ 2 quai da siêu mềm, sandal quai hậu đế bệt PABNO PN15002",275000,275000,0,0
TIKI,phu-kien-thoi-trang,88792974,"Kính Mắt Chống Tia UV Từ Điện Thoại, Máy Tính, Chống Mỏi Mắt Gọng kính chính hãng SARIFA 9827 Nhiều Màu",148000,650000,502000,77
TIKI,giay-dep-nu,67598438,"Giày Mọi Moccasin Da Bò Thật Đế Cao Su Pixie X482",475000,475000,0,0
TIKI,dien-tu-dien-lanh,4678975,"Giá Treo Tivi Góc Xoay Nhập Khẩu North Bayou L600 (45-70 inch)",576980,576980,0,0
TIKI,phu-kien-thoi-trang,95673758,"Găng tay băng lụa xỏ ngón chống nắng Rhino S102, tất tay nam nữ, chống tia UV, chống bụi, UPF50+, Hàng chính hãng",65000,95000,30000,32
TIKI,giay-dep-nu,117684680,"RẺ VÔ ĐỊCH - Quai giày quai hậu nữ chống tuột gót chống rộng phụ kiện trang trí thay thế lót gót giày nhiều màu",35000,35000,0,0
TIKI,dien-tu-dien-lanh,9845949,"Đầu Thu Truyền Hình Kỹ Thuật Số DVB T2 - Kèm Anten Liền Dây 15M - Hàng Chính Hãng",419000,419000,0,0
TIKI,phu-kien-thoi-trang,41217788,"Combo nước rửa kính và khăn lau kính (Tặng kèm bộ ốc vít)",13000,60000,47000,78
TIKI,giay-dep-nu,74460391,"Giày Búp Bê Đế Xuồng Da Thật 3cm Mũi Nhọn Gắn Nơ Pixie X619",420000,420000,0,0
TIKI,giay-dep-nu,77093014,"Boot da nữ thời trang thiết kế đơn điệu, thanh lịch - NP109",450000,450000,0,0
TIKI,phu-kien-thoi-trang,573065,"Kính Mát Thể Thao Nam Exfash EF 5980 966",252000,460000,208000,45
TIKI,phu-kien-thoi-trang,162189772,"Tất vớ cổ cao nam nữ GOMTAT chất liệu cotton cao cấp, thiết kế hút ẩm thoáng khí, mềm mại êm chân - GOM-KLB-TRONCAO",18900,35900,17000,47
TIKI,may-anh,3810897,"Máy Nước Nóng Gián Tiếp FERROLI VERDI 20L TE (2500W) - Hàng Chính Hãng",2365000,2365000,0,0
TIKI,may-anh,23831436,"Máy sấy Electrolux 8 Kg EDV805JQSA - Hàng Chính Hãng",9890000,9890000,0,0
TIKI,giay-dep-nu,88085949,"Xăng đan xỏ ngón, dép kẹp nữ, sandal du lịch chất liệu da cao cấp",268000,268000,0,0
TIKI,dien-tu-dien-lanh,126702204,"Remote Điều khiển từ xa quạt ",76950,81000,4050,5
TIKI,phu-kien-thoi-trang,112357404,"Mũ Lưỡi Trai Kaki Nam Nữ US ARMY U833, Kiểu Dáng Nón Beret 2 Lớp Thời Trang Cao Cấp- HÀNG CHÍNH HÃNG",105000,258000,153000,59
TIKI,phu-kien-thoi-trang,113490079,"Kính Mát ,Mắt Kính Unisex ASARIFA RP18013 c2",800000,800000,0,0
TIKI,dien-tu-dien-lanh,186122456,"Android Tivi Box Best TV G9 Có Điều Khiển Giọng Nói ,hệ điều hành 7.1 xem chường trình truyền hình và giải trí Youtube thỏa thích",550000,550000,0,0
TIKI,giay-dep-nu,37953767,"Combo 10  jibbitz sticker dán dép sục ngẫu nhiên",21800,21800,0,0
TIKI,giay-dep-nu,56360027,"Giày sandal nữ Trường Hải da bò thật đế cao su không trơn dép cao 2.5cm dép thời trang cao cấp SDN074",244000,289000,45000,16
TIKI,phu-kien-thoi-trang,58362048,"Mắt kính mát nữ thời trang form chữ nhật màu nâu trà, chống tia UV. Gọng kim loại không gỉ. Mã DKY6035TRD",179000,179000,0,0
TIKI,giay-dep-nu,53037571,"Giày sandal nữ Trường Hải gót vuông 4cm màu đen đế cao su mềm dẻo chống trơn thời trang cao cấp XDN235",224000,265000,41000,15
TIKI,dien-tu-dien-lanh,176752041,"Máy giặt Toshiba 9kg AW-K1000FV(Cửa trên) - Chỉ giao Hà Nội",6400000,6400000,0,0
TIKI,dien-tu-dien-lanh,25240425,"Remote Điều Khiển Dùng Cho Máy Lạnh Fujitsu Inverter AR-RAE2U, Điều Hòa AR-RY10",63000,63000,0,0
TIKI,dien-tu-dien-lanh,104791222,"Máy giặt Casper 8.5 KG WT-85N68BGA - Hàng chính hãng (chỉ giao HCM)",4290000,4290000,0,0
TIKI,dien-tu-dien-lanh,87571543,"Máy Lạnh Panasonic Inverter 1.5 HP CU/CS-XPU12XKH-8 - Chỉ giao tại HCM",12495000,12495000,0,0
TIKI,dien-tu-dien-lanh,243045582,"Remote Điều Khiển Máy Lạnh, Máy Điều Hòa LG AKB73756203, LG S09EN2",50000,50000,0,0
TIKI,dien-tu-dien-lanh,119195115,"Remote Điều khiển dành cho tivi led Asanzo",37500,37500,0,0
TIKI,dien-tu-dien-lanh,195228162,"Công Tắc Cửa Dành Cho Máy Giặt TOSHIBA E89",285700,285700,0,0
TIKI,dien-tu-dien-lanh,165964670,"Ron tủ lạnh cho tủ lạnh SHARP model SJ-186SL",187000,187000,0,0
TIKI,dien-tu-dien-lanh,76357858,"khung treo tivi CỐ ĐỊNH 52-62INCH HOÀNG THỊNH ,HÀNG CHÍNH HÃNG.",88000,88000,0,0
TIKI,dien-tu-dien-lanh,7478727,"Thiết bị đo nhiệt độ từ xa sửa chữa đa năng",227050,239000,11950,5
TIKI,dien-tu-dien-lanh,48319742,"Điều Hòa Inverter Nagakawa NIS-C18R2T01 (18.000Btu) - Hàng Chính Hãng (Chỉ giao tại Hà Nội)",9390000,9390000,0,0
TIKI,dien-tu-dien-lanh,126701965,"Remote điều khiển thông minh,điều khiển bằng giọng nói tivi dành cho CASPER",220000,220000,0,0
TIKI,dien-tu-dien-lanh,103121262,"Tủ lạnh Toshiba Inverter 270 lít GR-RB350WE-PMV(30)-BS - Hàng chính hãng - Giao tại Hà Nội và 1 số tỉnh toàn quốc",8500000,8500000,0,0
TIKI,dien-tu-dien-lanh,89637543,"Anten thông minh DVB T2 tặng kèm bộ đinh vít",75000,75000,0,0
TIKI,dien-tu-dien-lanh,126702290,"Remote điều khiển dành cho đầu thu truyền hình kĩ thuật số An Viên TV-AVG.",74000,74000,0,0
TIKI,dien-tu-dien-lanh,189151843,"Moto, mô tơ đảo gió quạt điều hòa, quạt hơi nước",69000,69000,0,0
TIKI,dien-tu-dien-lanh,48575548,"Bộ Chia 3 Pacific Dùng Chia Truyền Hình Cáp, Anten KTS - Hàng Nhập Khẩu",44900,44900,0,0
TIKI,dien-tu-dien-lanh,103822668,"ĐIỀU KHIỂN TIVI ASANZO CÓ 4 NÚT MÀU PHÍA DƯỚI (SP 1291)HÀNG CHÍNH HÃNG.",74000,74000,0,0
TIKI,dien-tu-dien-lanh,77910707,"Điều Hòa Nagakawa Inverter 18000Btu NIS-C18R2H08 - Chỉ Giao tại HN",10290000,10290000,0,0
TIKI,dien-tu-dien-lanh,156311446,"Remote Tivi Điều Khiển Dành Cho SAMSUNG Smart TV QLED, 4K BN59-01259B",75000,75000,0,0
TIKI,dien-tu-dien-lanh,106066668,"Motor quạt hơi nước các loại",480000,480000,0,0
TIKI,dien-tu-dien-lanh,126701896,"Điều khiển điều hòa dành cho LG1&2 chiều Inverter dùng cho dòng V10 V13 V18 9000BTU 12000BTU 18000BTU",71000,71000,0,0
TIKI,dien-tu-dien-lanh,102824878,"Tủ lạnh Aqua Inverter 291 lít AQR-T329MA (GB) - Hàng chính hãng - Giao tại Hà Nội và 1 số tỉnh toàn quốc",9850000,9850000,0,0
TIKI,dien-tu-dien-lanh,87909068,"Smart Tivi Samsung 4K 75 inch UA75AU7000 Mới 2021",17644000,17644000,0,0
TIKI,dien-tu-dien-lanh,195219175,"Máy rửa chén Electrolux ESF6010BW 1480W - Hàng chính hãng",7810000,9990000,2180000,22
TIKI,dien-tu-dien-lanh,80916526,"Bộ 4 Chân Đế Máy Giặt, Tủ Lạnh Cao Su Chống Rung (Tròn)",24999,24999,0,0
TIKI,dien-tu-dien-lanh,72722986,"Tủ Đông Kangaroo KG168NC1 - Hàng chính hãng - Chỉ giao hàng tại Hà Nội",5350000,5350000,0,0
TIKI,dien-tu-dien-lanh,212425712,"Cầu chì lò vi sóng",4700,4700,0,0
TIKI,dien-tu-dien-lanh,141111320,"Máy giặt Electrolux Inverter 9 kg EWF9024P5SB - chỉ giao Hà Nội",10450000,10450000,0,0
TIKI,dien-tu-dien-lanh,121744043,"Máy giặt LG Inverter 8.5 kg T2185VS2M - Chỉ giao tại HN",6090000,6090000,0,0
TIKI,dien-tu-dien-lanh,113673050,"Càng dành cho máy giặt Elextrolux 10843, 80743, 85743, 12843, 10844 - elec10843",571000,571000,0,0
TIKI,dien-tu-dien-lanh,32130994,"Remote Điều Khiển Dùng Cho TV LCD, TV LED TCL TC-97E",24900,24900,0,0
TIKI,dien-tu-dien-lanh,135038787,"Sensor cho tủ lạnh  samsung cảm biến nhiệt tủ lạnh samsung",35000,35000,0,0
TIKI,dien-tu-dien-lanh,116075780,"Máy Rửa Bát Bosch SMS4HCI48E Serie 4 Độc Lập - Hàng Nhập Khẩu Đức",28650000,28650000,0,0
TIKI,dien-tu-dien-lanh,119822270,"Điều khiển tivi dành cho Samsung giọng nói (Có tìm kiếm TIẾNG VIỆT) 2019",170000,170000,0,0
TIKI,dien-tu-dien-lanh,50560445,"Tủ Lạnh Inverter Aqua AQR-T219FA-PB (186L) - Hàng Chính Hãng - Chỉ giao tại Hà Nội",6040000,6040000,0,0
TIKI,dien-tu-dien-lanh,113483268,"Cáp HDMI không dây Chromecast.",310000,310000,0,0
TIKI,dien-tu-dien-lanh,23476169,"Tủ lạnh Funiki FR-152CI 150L - Hàng chính hãng",4148000,4150000,2000,0
TIKI,dien-tu-dien-lanh,119822281,"Remote Điều khiển tivi dành cho LG giọng nói 2020 MR20GA các dòng tivi LG 2017,2018,2019,2020",480000,480000,0,0
TIKI,dien-tu-dien-lanh,114985013,"Tủ lạnh Sharp Inverter 525 lít SJ-FXP600VG-MR - Chỉ giao Hà Nội",24290000,24290000,0,0
TIKI,giay-dep-nu,48108837,"Dép đi trong nhà bằng chất liệu bông mềm mại bảo vệ đôi chân,  hình gấu dễ thương - màu giao ngẫu nhiên",110000,140000,30000,21
TIKI,giay-dep-nu,140951160,"Giày cao gót đi dự tiệc loại cao cấp, khóa sau gót, 11 phân, êm, chắc chân dễ đi. Dép nữ hot trend",279500,279500,0,0
TIKI,giay-dep-nu,54654068,"Giày Thể Thao Sneaker Nữ , Cao Cổ, Nhẹ Thoáng Khí, Thích Hợp Đi Chơi, Đi Hoc, Đi Làm, Đế Cao Su Đúc, Chống Trơn Trượt, Hạn Chế Mòn Đế, Miếng Lót Giày Cấu Trúc Tổ Ong Tạo Cảm Giác Êm S322",99000,99000,0,0
TIKI,giay-dep-nu,36706495,"Miếng đế lót giày silicone trong suốt 8 hạt nam châm bấm huyệt massage ở chân nhằm giúp lưu thông tuần hoàn máu tăng cường sức khoẻ cho cả nam lẫn nữ",49000,49000,0,0
TIKI,giay-dep-nu,125098668,"Giày Lười Nữ Anh Khoa C83-1",170000,170000,0,0
TIKI,giay-dep-nu,165588823,"Giày Sandal Cao Gót Da Bò Thật BIGGBEN SDCG71",319000,360000,41000,11
TIKI,giay-dep-nu,109340017,"Dép đế trấu nữ 2 khóa unisex màu TRẮNG - DETA21T",199000,199000,0,0
TIKI,giay-dep-nu,91831484,"[Combo 2] Chai xịt khử mùi giày Xclean Nano Bạc AHT Corp 50ml - Khử mùi hôi giày, diệt khuẩn, làm sạch bề mặt giày dép",72600,121000,48400,40
TIKI,giay-dep-nu,74013226,"Giày độn đế siêu nhẹ 8.5cm PS368",399000,399000,0,0
TIKI,giay-dep-nu,196382749,"HAVAIANAS - Dép nữ Slim Glitter Neon 4147111-5217",799000,799000,0,0
TIKI,giay-dep-nu,114292106,"DÉP NỮ PHONG CÁCH HÀN QUỐC",276250,276250,0,0
TIKI,giay-dep-nu,191973535,"Dép rọ cao gót nữ đế 5F",279000,279000,0,0
TIKI,giay-dep-nu,1998827,"Giày Sandal Nữ Cao Gót Huy Hoàng HT7064 - Xanh (Size",469000,469000,0,0
TIKI,giay-dep-nu,70934850,"Dép massage đi trong nhà tắm MT1-Màu",89000,89000,0,0
TIKI,giay-dep-nu,97103342,"Giày búp bê nữ Doris ️️ Giày búp bê da thật mũi tròn gắn nơ kim loại màu đen DR006",199000,199000,0,0
TIKI,giay-dep-nu,179912036,"Dép Quai Ngang Nữ Kẻ Caro Đế Bánh Mì Êm Chân Kiểu Hàn Quốc ,Dép Nữ Quai Ngang Thời Trang D04",35000,35000,0,0
TIKI,giay-dep-nu,176725915,"Dép quai kẹp Bitis nữ 5cm",180000,180000,0,0
TIKI,giay-dep-nu,79608204,"Giày Sneakers Nữ TOMOYO "SIÊU NHẸ" TMW20901",699000,699000,0,0
TIKI,giay-dep-nu,54076853,"Giày sandal xuồng quai ngang dây cổ chân S304",243000,259000,16000,6
TIKI,giay-dep-nu,19399799,"Lót Giày Quế Khử Mùi",27000,27000,0,0
TIKI,giay-dep-nu,153260344,"Lót Giày Hương Quế Nam Nữ 36-43 Hiệu Quả - Êm chân",8000,8000,0,0
TIKI,giay-dep-nu,242064466,"Dép xỏ ngón nữ Skechers Go Walk 6 Sandal - 140600-CRL",1290000,1290000,0,0
TIKI,giay-dep-nu,109853076,"GIÀY SKECHERS CHUYÊN THỜI TRANG CHO NỮ STAMINA V2-149510-WLM",1791000,1791000,0,0
TIKI,giay-dep-nu,40810250,"Dép quai ngang nữ đế cao 7cm thời trang cao cấp Trường Hải QN222",256000,299000,43000,14
TIKI,giay-dep-nu,153258048,"Giày vải đi bộ nữ - thêu hoa cúc thoáng khí",88000,88000,0,0
TIKI,giay-dep-nu,112960784,"Sandal Đế Bánh Mì Thời Trang Nữ Tính Kiểu Dáng Hàn Quốc Cao Cấp 21303",100000,100000,0,0
TIKI,giay-dep-nu,91251655,"Giày sandal nữ da bò BIGGBEN cao cấp SDN68",279000,370000,91000,25
TIKI,giay-dep-nu,184068915,"HAVAIANAS - Dép nữ Slim Glitter II 4146975",799000,799000,0,0
TIKI,giay-dep-nu,205820079,"Dép sandal nữ đế xuống Bitas SYN.238",295000,295000,0,0
TIKI,giay-dep-nu,48360291,"Dép cói quai chéo xinh xắn",99000,99000,0,0
TIKI,giay-dep-nu,53053891,"Giày thể thao sneakers nữ cổ lửng, chất liệu vải canvas bền đẹp, thời trang trẻ, phong cách Hàn Quốc",99000,99000,0,0
TIKI,giay-dep-nu,190741773,"Dép Nữ Da Bò Thật BIGGBEN Cao Cấp DNQN50",299000,370000,71000,19
TIKI,giay-dep-nu,159437972,"Dép Đúc Cao Su Dẻo Nguyên Khối Mang Trong Nhà Chống Trơn Trượt Mẫu Mới Nhất",49000,49000,0,0
TIKI,giay-dep-nu,193109841,"Giày cao gót nữ 5p bít mũi xoàn mảnh chéo chân",130000,130000,0,0
TIKI,giay-dep-nu,88011631,"Dép nữ đế xuồng quai ngang HÀ NAM da bò cao cấp 9cm DNU2024",410000,410000,0,0
TIKI,giay-dep-nu,35606240,"Sục nhựa nữ tím",28000,28000,0,0
TIKI,giay-dep-nu,169364047,"Dép đi trong nhà nữ quai ngang chống trơn trượt V295",35000,35000,0,0
TIKI,giay-dep-nu,141114694,"Giày búp bê nữ da bò thật BIGGBEN cao cấp BB113",299000,350000,51000,15
TIKI,giay-dep-nu,90324355,"Giầy búp bê hở gót thoáng mát chịu nước thời trang dạo phố đi biển họa tiết vân sóng dễ thương GN08",105000,105000,0,0
TIKI,giay-dep-nu,61278532,"Giày thể thao nữ hoa cúc đi bộ cực êm siêu xinh V253 - Đen - Size 38",55000,55000,0,0
TIKI,phu-kien-thoi-trang,33394879,"Set 100 dây cột tóc trơn kèm túi khóa đựng dễ thương",8000,8900,900,10
TIKI,phu-kien-thoi-trang,43105935,"Combo 10 đôi tất nữ cổ ngắn hình gấu chống hôi chân - tặng túi",25500,25500,0,0
TIKI,phu-kien-thoi-trang,165602534,"Tất Nữ, Combo 5 Đôi Tất Nữ Cổ Ngắn, Mẫu Tất Nữ Phối Lưới Hình Hoa Cúc Nhiều Màu Dễ Thương Thời Trang Baw TN07",79000,99000,20000,20
TIKI,phu-kien-thoi-trang,90870485,"KÍNH LÃO GỌNG NHỰA CHUẨN ĐỘ FROM ĐẸP",45000,45000,0,0
TIKI,phu-kien-thoi-trang,112440908,"Mũ Lưỡi Trai Thời Trang Hàn Quốc U459 US ARMY, Chất liệu Kaki Cao Cấp Kiểu Dáng Nón Kết Vành Cong, Phong Cách Trẻ Trung, Năng Động-HÀNG CHÍNH HÃNG",109000,258000,149000,58
TIKI,phu-kien-thoi-trang,120441681,"(Hàng Xịn) Dây nịt vải_Siêu bền_Mặt khóa gài tự động thép không gỉ chắc chắn, tiện lợi_Dây lưng vải dù cao cấp, Thắt lưng lính TẶNG MÓC CHÌA KHÓA",119000,119000,0,0
TIKI,phu-kien-thoi-trang,4562103,"Tất Vớ cổ ngắn trơn Cotton Air Seven S101. 4 màu: Trắng, Đen, Xanh, Xám. Dày dặn, mềm mại, kháng khuẩn khử mùi, không hôi chân",16000,34000,18000,53
TIKI,phu-kien-thoi-trang,181248509,"Quần Tất Nữ Che Khuyết Điểm Dày 100g Hàng Loại 1 Thật Chân Siêu Dai Siêu Bền Chống Rách Dọc",165000,250000,85000,34
TIKI,phu-kien-thoi-trang,96283828,"Dây nịt nam/ Thắt lưng nam công sở da bò nguyên chất  khóa tự động Mã Z-0331",189000,359000,170000,47
TIKI,phu-kien-thoi-trang,157125323,"Tất Lười Nam, Tất Nam mang Giày Lười vải cotton mềm mại thoáng mát, Có đệm cao su chống trượt gót chân",8000,16000,8000,50
TIKI,phu-kien-thoi-trang,67909702,"[Combo G] Dung Dịch Ngâm Kính Áp Tròng + Nước Nhỏ Mắt Áp Tròng",150000,150000,0,0
TIKI,phu-kien-thoi-trang,183678934,"Tất Trơn Cổ Ngắn Nam Nữ GOMTAT, Vớ Cổ Ngắn Unisex Trơn Màu Vải Cotton Chuẩn Xuất Nhật - VOTRON-VNXK",7900,15000,7100,47
TIKI,phu-kien-thoi-trang,170511645,"Khẩu Trang Vải Y Tế Kháng Khuẩn Cao Cấp BADBIRD 3 Lớp 4 Tính Năng, Antibacterial Mask, Thương hiệu Việt",28000,45000,17000,38
TIKI,phu-kien-thoi-trang,150604747,"Gọng kính 8085 nhựa cao cấp siêu bền thời trang nam nữ OURESS",270000,299000,29000,10
TIKI,phu-kien-thoi-trang,67538461,"Mắt kính nữ râm thời trang 9909DKYDO, tròng Polarized màu nâu đỏ phân cực không vỡ, chống nắng, chống tia UV",99000,99000,0,0
TIKI,phu-kien-thoi-trang,173096759,"Găng tay chống nắng lụa băng phối 2 màu thời trang | Dòng -5 độ cao cấp | Găng tay xỏ ngón che nắng - Loại dài 48CM",90000,90000,0,0
TIKI,phu-kien-thoi-trang,146952964,"Thắt lưng da nam cao cấp Classic khoá kim gài phong cách thời trang, cổ điển",60000,120000,60000,50
TIKI,phu-kien-thoi-trang,168957464,"Găng tay chống nắng hở 2 ngón | Bao tay chống nắng đi xe máy cho nam vải trơn mềm, bám tay, thoáng mát, thật tay lái",60000,70000,10000,14
TIKI,phu-kien-thoi-trang,114578930,"Hộp da đựng kính mắt, đựng kính cận, viễn, râm…  chống shock, chống va đập, trầy xước",18000,27000,9000,33
TIKI,phu-kien-thoi-trang,154781103,"Thắt lưng da nam cao cấp Basic khoá tự động phong cách thời trang Hàn",55000,110000,55000,50
TIKI,phu-kien-thoi-trang,273202672,"Mắt Kính, Cài Tóc Phong Cách Giáng Sinh Cho Người Lớn và Trẻ Em",35000,35000,0,0
TIKI,phu-kien-thoi-trang,148848703,"Băng Đô, Cài Tóc Giáng Sinh, Tuần Lộc Noel Hoạt Tiết Xinh Xắn",32000,32000,0,0
TIKI,phu-kien-thoi-trang,117677969,"Hộp da đựng mắt kính cao cấp",20000,21500,1500,7
TIKI,phu-kien-thoi-trang,109301225,"Dung Dịch Ngâm Kính Áp Tròng Vision Plus + loại",120000,120000,0,0
TIKI,phu-kien-thoi-trang,73330139,"Kẹp tóc sau - kẹp tóc ngọc trai",49000,54000,5000,9
TIKI,phu-kien-thoi-trang,144259235,"Kính lão gọng gập hộp vàng dành cho nam và nữ kiểu dáng from đẹp có độ từ 0.5-4.0",89000,89000,0,0
TIKI,phu-kien-thoi-trang,97332403," Dây đeo khẩu trang Maskstrap - Dây đeo kính sẵn theo yêu cầu",60000,60000,0,0
TIKI,phu-kien-thoi-trang,87958881,"[Tất Nữ,Vớ Nữ] Combo 10 Đôi Tất Nữ Hình Gấu Cổ Ngắn Dễ Thương - Kèm Túi Đựng - TiMa.LaLa",49000,59000,10000,17
TIKI,phu-kien-thoi-trang,115893286,"GĂNG TAY CHỐNG NẮNG XỎ NGÓN NAM LET'S SLIM ĐEN, CHỐNG TIA UV CHÍNH HÃNG, CHỐNG TIA UV, VẢI DÀY DẶN, CO DÃN THOÁNG MÁT",18000,18000,0,0
TIKI,phu-kien-thoi-trang,26612260,"Combo 30 tờ hình xăm dán tatoo thời trang nhiều mẫu",21000,21000,0,0
TIKI,phu-kien-thoi-trang,49214113,"Combo 3 Kẹp Tóc Càng Cua 5 Chấu Loại Xịn Chắc Chắn Cứng Cáp Giao Mầu Ngẫu Nhiên MP119.3",16000,40000,24000,60
TIKI,phu-kien-thoi-trang,90870296,"KÍNH LÃO GỌNG NHỰA CHUẨN ĐỘ",39000,39000,0,0
TIKI,phu-kien-thoi-trang,183378555,"Lẻ 2 chiếc Khẩu trang vải không dệt cho bé họa tiết hoạt hình chuột Mickey và Princess Nội địa Nhật Bản (giao màu ngẫu nhiên)",10000,10000,0,0
TIKI,phu-kien-thoi-trang,48757147,"Kẹp tóc 3 răng màu đen - Combo 2 sp",19000,30000,11000,37
TIKI,phu-kien-thoi-trang,42731328,"Set 8 kẹp tăm cầu vồng cực dễ thương, màu chọn ngẫu nhiên",22000,22000,0,0
TIKI,phu-kien-thoi-trang,176024147,"Tất Cổ Cao Trơn Nam Nữ GOMTAT, Vớ Cao Cổ Unisex Trơn Màu Vải Cotton Chuẩn Xuất Nhật - TRONCAO-VNXK",7900,15000,7100,47
TIKI,phu-kien-thoi-trang,92911270,"Mắt kính mát nam đổi màu đi ngày đêm 7K0540DM. Kính nam  tròng Polarized chống tia UV, chống nắng. Gọng kim loại, ôm mặt",279000,279000,0,0
TIKI,phu-kien-thoi-trang,170713053,"Khăn Mùi Xoa, Khăn Tay Nam (L1)",55000,55000,0,0
TIKI,phu-kien-thoi-trang,42802416,"sét 100 thun cột tóc kèm túi zip , màu sắc phù hợp với mọi lứa tuổi",6500,6500,0,0
TIKI,phu-kien-thoi-trang,180851207,"Găng tay cụt ngón da lộn Cao Cấp Hatsu Pearl Izumi | Găng tay đi phượt | Găng tay chạy xe máy, Xe Đạp Nửa Ngón Có Đệm Chống Sốc - Hàng chính hãng",83000,83000,0,0
TIKI,giay-dep-nam,180228967,"Máy sấy giày đa năng bằng tia cực tím cao cấp MSG01",389000,600000,211000,35
TIKI,giay-dep-nam,181454853,"Giày Mọi, giày lười, giày tây nam da mềm lịch lãm màu đen",199000,199000,0,0
TIKI,giay-dep-nam,39997426,"Dép bít mũi nam da bò cao cấp Trường Hải BM213",341000,399000,58000,15
TIKI,giay-dep-nam,20639773,"Chai vệ sinh giày dép, túi xách - 100ml",9599,9599,0,0
TIKI,giay-dep-nam,155008229,"Dép 2 Quai Ngang cao cấp KEEDO BH00505 da bò thật siêu bền",960000,960000,0,0
TIKI,giay-dep-nam,67367689,"Dép quai hậu nam công sở da bò thật giản dị đế mềm êm thoáng khí kiểu dáng Hàn Quốc mã 50335",359000,689000,330000,48
TIKI,giay-dep-nam,196849302,"Giày tây nam Pierre Cardin - PCMFWLG 758",1495000,2990000,1495000,50
TIKI,giay-dep-nam,4418135,"Giày Chelsea Boot Tathanium Nam Màu Đen Da Lộn TFBKS8812",750000,750000,0,0
TIKI,giay-dep-nam,122712021,"Giày Lười Da Bò Nam, Kiểu Dáng Bắt Mắt, Thiết Kế Giữ Phong Dáng, Đế Cao Su, Da Chuẩn GD19",229000,430000,201000,47
TIKI,giay-dep-nam,113574574,"(Có 3 Màu) Giầy xăng đan nam nữ 35-44 3 quai ngang Sport - Sandal nam mẫu mới hot 2020",159000,159000,0,0
TIKI,giay-dep-nam,162994213,"Dép quai ngang Lihsing nam",429000,429000,0,0
TIKI,giay-dep-nam,71693900,"Giày Tây Nam Cao Cấp Mã  BH73",550000,1100000,550000,50
TIKI,giay-dep-nam,20333597,"Dép cao su 5 quai ngang",300000,300000,0,0
TIKI,giay-dep-nam,196215025,"Giày/dép Sandal Vento DARIUS Nam màu Tro đi học/đi làm SD-NB10607",395000,395000,0,0
TIKI,giay-dep-nam,145455290,"Giày nam, giày sneaker nam cao cấp mới nhất CỰC HOT",229000,229000,0,0
TIKI,giay-dep-nam,164491354,"(Kèm Video )Giày Thể Thao Nam MS042 Tăng Chiều Cao Phong Cách  Thời Trang Trẻ Trung có 2 màu",99000,99000,0,0
TIKI,giay-dep-nam,115768012,"Giày Sục Nam Da Bóng Có Đai Vàng Kết Hợp Da Lộn Mã L194 Màu Đen",199000,199000,0,0
TIKI,giay-dep-nam,156216262,"GIÀY LƯỜI NAM KHÂU VIỀN DA BÒ THẬT 100",750000,750000,0,0
TIKI,giay-dep-nam,183110561,"Giày Thể Thao Nam Đế Em SK012 Thoáng Khí- Có 2 Màu",54000,54000,0,0
TIKI,giay-dep-nam,190537769,"Dép quai kẹp xốp Bitis nam",90000,90000,0,0
TIKI,giay-dep-nam,55107216,"Giày Tây Nam Da Bò BIGGBEN Cao Cấp GT172",599000,730000,131000,18
TIKI,giay-dep-nam,6396781,"Sandal Nam Bít Mũi BIGGBEN Da Bò Thật SD44",419000,470000,51000,11
TIKI,giay-dep-nam,96242641,"Sandal Bitis nam",325000,325000,0,0
TIKI,giay-dep-nam,179060663,"Dép sục cross nam nữ oflaod màu đen đi mưa, thoáng, bền, hàng xịn, full box",405000,405000,0,0
TIKI,giay-dep-nam,176896324,"Giày Chelsea Boots cổ cao cho nam - Da bò thật 100% bảo hành 12 tháng - MANZO CHEL 101 - Manzo Store",120000,120000,0,0
TIKI,giay-dep-nam,50390802,"Lót độn đế silicon nguyên khối trong suốt tăng 3cm chiều cao - buybox - BBPK47",72000,120000,48000,40
TIKI,giay-dep-nam,270460979,"Giày sandal unisex Crocs All Terrain - 207711-001",1395000,1395000,0,0
TIKI,giay-dep-nam,155221895,"Giày đốc nam da bò cao cấp Giày gồ cột dây đế nâu cá tính- G88 Giày SAGO’S",650000,650000,0,0
TIKI,giay-dep-nam,14380825,"Dép nam saldalda bò cao cấp Trường hải SD038",290000,339000,49000,14
TIKI,giay-dep-nam,117492220,"Chai xịt giày Aht Nano Bạc khữ mùi diệt khuẩn, chống thối chân hôi giày - XITGIAY-AHT",49000,69000,20000,29
TIKI,giay-dep-nam,59436595,"Sandal  nam cao cấp Pierre Cardin PCMFWL 127 - màu nâu",945000,1890000,945000,50
TIKI,giay-dep-nam,161496598,"Giày lười vải nam trung niên cao cấp form dáng đẹp - giày lười vải nam thoáng khí",155000,155000,0,0
TIKI,giay-dep-nam,9810961,"Giày Slip On Unisex Vans - VN000EYEBWW",1305000,1450000,145000,10
TIKI,giay-dep-nam,116819962,"Dép sandal nam và nữ đế đen quai bố đen",82500,82500,0,0
TIKI,giay-dep-nam,85386059,"GIày Sandal Nam Da Bò BIGGBEN Cao Cấp SD112",339000,450000,111000,25
TIKI,giay-dep-nam,109885929,"Dép quai ngang nam Đông Hải da bò cao cấp thiết kế quai bản to dễ phối đồ - D1811",590000,590000,0,0
TIKI,giay-dep-nam,184068704,"HAVAIANAS - Dép nam Brasil Logo 4110850",749000,749000,0,0
TIKI,giay-dep-nam,70373722,"Dép sức khỏe nam Spenco Kholo Black Carbon 450",1695000,1695000,0,0
TIKI,giay-dep-nam,55085257,"Giày sandal nam Trường Hải da bò thật mềm mại màu nâu đế PU nhẹ nhàng không trơn hình ảnh thật SD0474",285000,319000,34000,11
TIKI,giay-dep-nam,31208721,"Dép nam bít mũi da bò cao cấp TH_QN054",280000,339000,59000,17
TIKI,giay-dep-nu,252596684,"Giày búp bê mũi tròn trơn da bò mềm mại Trường Hải GBB118 có 2 màu đen, đỏ",241000,285000,44000,15
TIKI,giay-dep-nu,252596105,"Giày búp bê trơn da bò mũi vuông Trường Hải có 2 màu xanh ,đen GBB115",241000,285000,44000,15
TIKI,giay-dep-nu,252597179,"Giày búp bê đế bằng da bò trơn Trường Hải da mềm GBB120 có 2 màu đen, trắng",241000,285000,44000,15
TIKI,giay-dep-nu,213724172,"Giày búp bê da bò mũi tròn Trường Hải đính nơ xinh da mềm mại GBB110",259000,299000,40000,13
TIKI,giay-dep-nu,73120993,"IÀY BÚP BÊ TRƯỜNG HẢI DA BÒ MỀM MÀU VÀNG BÒ SANG TRỌNG MŨI GIÀY TRÒN, ĐẾ MỀM DẺO BÊN CHẮC VÀ THỜI TRANGBB025",217000,289000,72000,25
TIKI,giay-dep-nu,146989025,"Giày múa bale có gót 3cm bọc da lộn cực êm ái và bền",110000,110000,0,0
TIKI,dien-tu-dien-lanh,142781325,"VinaBox X9 (Phiên Bản Thế Hệ Mới 2022) - Ram 2G/16G - Truyền Hình OTT Miễn Phí - Siêu Phẩm Trở Lại - Chất Lượng Bền Lâu - Hàng Chính Hãng",667000,667000,0,0
TIKI,giay-dep-nu,55060972,"Combo 2 cặp Lót gót giày 4D hình cánh bướm có mặt gai silicone chống trầy rách da và chống tuột gót chân - buybox - BBPK70_2",45000,90000,45000,50
TIKI,dien-tu-dien-lanh,53308440,"Tủ mát - Minibar thương hiệu Homesun, Model: BCH-40B, Thể tích 40L, Công suất 65W, Điện áp 220VAC, Không tiếng ồn, Tiết kiệm điện năng, Màu đen sang trọng, Hàng chính hãng",3960000,3960000,0,0
TIKI,may-anh,23415553," Kính thiên văn cao cấp Carson SkySeeker JC-200 - Hàng chính hãng",4390000,4390000,0,0
TIKI,giay-dep-nu,101773571," Giày múa bale (Size 23 -> 33)",38000,38000,0,0
TIKI,dien-tu-dien-lanh,34744943,"Tủ Lạnh AQUA Inverter 456 Lít AQR-IGW525EM GB - HÀNG CHÍNH HÃNG",19249000,19249000,0,0
TIKI,dien-tu-dien-lanh,187271835,"Android tivi box MAGICSEE N5 MAX X4 Ram 4G Android 11 điều khiển giọng nói kiêm bàn phím chuột bay có đèn nền dual wifi 2 băng tần bluetooth S905X4 cài sẵn phim, truyền hình cáp miễn phí vĩnh viễn cáp miễn phí vĩnh viễn - Hàng nhập khẩu ",1555000,1555000,0,0
TIKI,may-anh,5866369,"Tủ Chống Ẩm Andbon AD-50S (50 Lít) - Hàng Nhập Khẩu",1974999,1974999,0,0
TIKI,giay-dep-nu,56377212,"Lót giày tăng chiều cao silicon đúc nguyên khối siêu êm ái, giày đế cao, giày độn gót",48000,48000,0,0
TIKI,giay-dep-nu,20235117,"Xi đánh giày Kangaroo Hàn Quốc - Nhập khẩu chính hãng",39000,39000,0,0
TIKI,dien-tu-dien-lanh,76053885,"Máy Giặt Sóng Siêu Âm Đảo Chiều Tự Động Có Thể Xếp Gọn",341000,341000,0,0
TIKI,may-anh,566581,"Dây Đeo Trước Ngực (GP26P) - Hàng Chính Hãng",119999,119999,0,0
TIKI,dien-tu-dien-lanh,189204315,"Máy rửa bát 15 bộ cao cấp Nagakawa NAG3601M15 - Made in Malaysia - Hàng chính hãng",11499000,16099000,4600000,29
TIKI,may-anh,97650599,"Chân đế cao cấp Carson The Rock Monopod TR-500 - Hàng chính hãng",2280000,2280000,0,0
TIKI,giay-dep-nu,200519451,"Giày búp bê  da bò mũi tròn màu xám đính nơ Trường Hải da mềm mại BB130",253000,299000,46000,15
TIKI,giay-dep-nu,254903581,"Giày Sục nữ da bò đế xuồng 5cm mũi nhọn màu xanh đen Trường Hải S129 CÓ SIZE LỚN",261000,299000,38000,13
TIKI,dien-tu-dien-lanh,176289256,"Máy Sấy Thông Hơi Electrolux 8.5 kg EDV854J3WB - Hàng Chính Hãng - Chỉ Giao HCM",11490000,11490000,0,0
TIKI,may-anh,134361229,"Phông nền chụp ảnh Studio Size lớn 2M . 3M chất liệu vải cotton",195000,195000,0,0
TIKI,dien-tu-dien-lanh,165964546,"Ron tủ lạnh dành cho tủ lạnh  Sharp model SJ-165S-GR",153000,153000,0,0
TIKI,may-anh,6479625,"Ống Nhòm Một Mắt Fomei 10x25 MONO BEATER - Hàng chính hãng",2899000,2899000,0,0
TIKI,giay-dep-nu,252563621,"Giày Đế Xuồng nữ 5cm Da Bò khóa vuông Màu Đen Trường Hải DX116Đ",241000,285000,44000,15
TIKI,may-anh,155760651,"Camera Hành Trình Trước Ô Tô Xiaomi 70mai A800S - Phiên Bản Quốc Tế - HÀNG NHẬP KHẨU",3887000,3887000,0,0
TIKI,giay-dep-nu,252563249,"Giày Nữ Đế Xuồng 5cm Da Bò Màu Đen Trường Hải DX115Đ",285000,285000,0,0
TIKI,giay-dep-nu,177164437,"Giày Lười Nữ NATIVE AD Jericho",1400000,1400000,0,0
TIKI,dien-tu-dien-lanh,120389915,"Remote Điều Khiển Dùng Cho SONY Smart TV, Internet Tivi RMT-TX100D",56000,56000,0,0
TIKI,giay-dep-nu,179235641,"Dép Bánh Mì Nam , Dép Bánh Mì Nữ , Dép Quai Ngang Nữ , Dép Nữ Thời Trang",65550,69000,3450,5
TIKI,may-anh,5899419,"Tủ Chống Ẩm Andbon AB-21C (20 Lít) - Hàng Nhập Khẩu",949999,949999,0,0
TIKI,dien-tu-dien-lanh,114772016,"Tủ lạnh 2 cánh Panasonic 234 lít NR-TV261BPKV - Diệt khuẩn 99.99% - Tiết kiệm điện - Hàng chính hãng",9140000,10390000,1250000,12
TIKI,dien-tu-dien-lanh,114830872,"[Lắp đặt trong vòng 24h] Máy Giặt Cửa Trước Panasonic 9.5 Kg NA-FD95V1BRV - Công Suất Xoáy Giặt Nhanh - Hàng chính hãng",10190000,12190000,2000000,16
TIKI,giay-dep-nu,72640100,"Dép bông đi trong nhà chống trơn trượt cao cấp - Hàng nhập khẩu",80000,80000,0,0
TIKI,may-anh,32526794," Ống nhòm quân sự vỏ kim loại Barska X-Trail 8x30mm - Hàng chính hãng",3432000,3432000,0,0
TIKI,giay-dep-nu,195536360,"Giày Sandal Nữ Da Bò Thật BIGGBEN Cao Cấp SDN84",319000,350000,31000,9
TIKI,may-anh,44213819,"Camera Hành Trình ô tô, xe máy chất lượng 1080 Sports chống nước tuyệt đối đầy đủ phụ kiện gắn mũ bảo hiểm hoặc tay xe",199000,199000,0,0
TIKI,dien-tu-dien-lanh,86139384,"MÁY RỬA CHÉN BOSCH HMH.SMS63L08EA - HÀNG CHÍNH HÃNG - chỉ giao tại hcm",13389000,13389000,0,0
TIKI,may-anh,195740667,"Máy Ảnh Sony Alpha 6400 - Cảm biến APS-C | Hàng Chính Hãng",21990000,21990000,0,0
TIKI,giay-dep-nu,144191547,"Giày Khiêu Vũ Dance Sport, Giày Nhảy Latin Người Lớn",200000,200000,0,0
TIKI,dien-tu-dien-lanh,167549374,"Smart Tivi Crystal Samsung 4K 65 inch UA65BU8000 - Model 2022",14200000,14200000,0,0
TIKI,giay-dep-nu,187188390,"Sơn Repaint giày - Phục hồi đế giày và che vết nứt  trên đế giày (30ml) - buybox - BBPK213",75000,100000,25000,25
TIKI,may-anh,32809813,"Hạt Hút Ẩm Xanh Cho Máy Ảnh Kèm Túi Đựng (Silica Gel)",29000,29000,0,0
TIKI,giay-dep-nu,205299054,"Chai xịt tạo bọt vệ sinh giày cao cấp, chất tẩy rửa giày, làm sạch, trắng sáng và khử mốc giày hiệu quả - Hàng chính hãng",47000,55000,8000,15
TIKI,dien-tu-dien-lanh,536260,"Tủ Lạnh Inverter Sharp SJ-FX680V-ST (605L)-Hàng Chính Hãng",16950000,16950000,0,0
TIKI,giay-dep-nu,92161380,"Chai xịt giày diệt khuẩn khử mùi hôi giày hôi chân nano bạc Nano Xclean For Shoes",39000,60500,21500,36
TIKI,may-anh,21442742,"Camera hành trình ô tô A19",549000,549000,0,0
TIKI,dien-tu-dien-lanh,109693112,"Máy Nước Nóng Gián Tiếp Ariston Vitaly 30 2.5 FE (2500W) - Hàng chính hãng",2149000,2149000,0,0
TIKI,giay-dep-nu,108747100,"Chai xịt giày khử mùi hôi giày hôi chân Nano Xclean For Shoes 100ml - Hương Trà Xanh - Nano Bạc AHT Corp (AHTC)",59000,99000,40000,40
TIKI,may-anh,197598293,"Bộ Pin NP-FW50 2000mAh + Sạc Beston Dùng Cho Máy Ảnh Sony a6100 a6300 a6500 a7m2 r2 s2 a5100 NEX-C3 NEX-C7 a33 a37 a55 - Hàng nhập khẩu",175000,175000,0,0
TIKI,may-anh,29254537,"Bảng clapper board quay phim - Loại nhỏ",115000,115000,0,0
TIKI,dien-tu-dien-lanh,114856783,"[CHỈ GIAO TẠI HCM] - Máy giặt Panasonic 16kg NA-FD16V1BRV - Hàng Chính Hãng",23090000,23090000,0,0
TIKI,dien-tu-dien-lanh,196002803,"Tủ lạnh LG Inverter 335 lít GN-M332PS - Hàng chính hãng [Giao hàng toàn quốc]",12990000,12990000,0,0
TIKI,giay-dep-nu,105159478,"Chai Xịt Khử Mùi Giày Nano Xclean Nano Bạc 100ml AHT Corp Hương Bạc Hà - Khử Mùi, Diệt Khuẩn, Làm Sạch Giày Dép Hiệu Quả An Toàn",42000,99000,57000,58
TIKI,dien-tu-dien-lanh,16872971,"Điều khiển dùng cho điều hòa LG 2 chiều ngắn",50000,50000,0,0
TIKI,may-anh,270917932,"Túi Da Bò Đừng Máy Ảnh Chuyên Dụng Marrant - BHL840",1250000,1250000,0,0
TIKI,giay-dep-nu,206123708,"Giày thể thao nam nữ phong cách mới – G1009NY",874000,1960000,1086000,55
TIKI,dien-tu-dien-lanh,71567079,"Điều khiển thông minh dành cho tivi LG 2018",418000,418000,0,0
TIKI,may-anh,109877195,"Túi máy ảnh Safrotto SF001, Hàng chính hãng",999999,999999,0,0
TIKI,giay-dep-nu,47293616,"Combo 01 cặp lót mũi giày cao su non và 01 cặp lót gót chân 2 trong 1 - buybox - BBPK09&50",45000,90000,45000,50
TIKI,may-anh,5850113,"Combo Đèn LED Yongnuo YN-300 II + Bộ 01 Viên Pin F970 & 01 Sạc V615 - Hàng Nhập Khẩu",1399999,1399999,0,0
TIKI,dien-tu-dien-lanh,128628167," Tivi Box  Kiwi S3 Pro - Phiên Bản 2021 - Ram2G/16G - Android 10 -Cầu Hình Siêu Khủng - Hàng Chính Hãng",780000,780000,0,0
TIKI,giay-dep-nu,180104810,"Dép quai ngang đế cao nữ và nam, dép đi trong nhà nữ quai ngang đế cao chất liệu eva chống ngấm nước",54150,57000,2850,5
TIKI,may-anh,174640490,"Camera IMOU Bullet 2S, Camera Ngoài Trời, Khẩu độ lớn F1.0, Chống nước IP67, Chuẩn nén H265, Theo dõi chuyển động, Quay Màu ban đêm - Hãng Chính Hãng",1100000,1750000,650000,37
TIKI,dien-tu-dien-lanh,195219893,"Máy rửa chén Junger 2100W DWJ-450 - Hàng chính hãng",19950000,19950000,0,0
TIKI,may-anh,177196776,"Gimbal chống rung cho điện thoại Vimble 3 - Hàng Chính Hãng",2090000,2090000,0,0
TIKI,giay-dep-nu,72851806,"Dép Bông Ulzang Caityn Hình Mèo Dễ Thương Cực Êm, Đế Nhựa Dẻo Được Khâu Rất Chắc Chắn. DP97",79000,79000,0,0
TIKI,giay-dep-nu,197663700,"Dép Lông Mang Trong Nhà Hình Trái Cây- Hàng Chính Hãng",146280,159000,12720,8
TIKI,may-anh,42299204," Bùi nhùi thép Steel Wool 1 mét",30000,30000,0,0
TIKI,dien-tu-dien-lanh,23831436,"Máy sấy Electrolux 8 Kg EDV805JQSA - Hàng Chính Hãng",9890000,9890000,0,0
TIKI,giay-dep-nu,107667053,"Lót giày nam nữ êm chân bằng EVA cấu trúc vòm nâng đỡ lòng bàn chân, chống thốn và bảo vệ gót chân - buybox - BBPK177",55000,65000,10000,15
TIKI,giay-dep-nu,189266374,"Miếng lót giày cao cấp ép vải, hạt lồi tặng độ bám giúp giảm size giày và chống đau gót sau - BuyBox - BBPK198",25000,35000,10000,29
TIKI,may-anh,80955507,"Các loại Tủ chống ẩm 30 Lít Andbon, Hàng chính hãng",1074999,1074999,0,0
TIKI,dien-tu-dien-lanh,77910697,"Điều Hòa Nagakawa 9000Btu NS-C09R1M05 - Chỉ Giao tại HN",4990000,4990000,0,0
TIKI,may-anh,55984779,"Filter màu lọc ánh sáng 80x100cm",140000,140000,0,0
TIKI,giay-dep-nu,11333235,"Giày cao gót bít chân thời thượng cho chân nang thêm dài-160",139300,199000,59700,30
TIKI,dien-tu-dien-lanh,126702225,"Remote Điều khiển từ xa Tivi giọng nói dành cho LG AN-MR650A LG 2017",259000,259000,0,0
TIKI,may-anh,10373372,"Chân Máy Ảnh Benro T880EX - Hàng Chính Hãng",614999,614999,0,0
TIKI,may-anh,9990028,"Túi đựng máy chụp hình microless BBK",220000,220000,0,0
TIKI,dien-tu-dien-lanh,112716880,"Máy giặt 9.5kg Casper WF-95I140BGB Inverter Mới 2021 Xuất xứ Thái Lan -Hàng chính hãng (Chỉ giao Hà Nội)",5990000,5990000,0,0
TIKI,giay-dep-nu,148932524,"giày nữ đẹp giá rẻ đế bằng,giày thể thao nữ đế cao su SUNO STORE GTTN04",152000,152000,0,0
TIKI,may-anh,58462929,"Ống nhòm ngày quan sát tầm xa chống nước Barska 20x80mm Cosmos (ngắm cảnh vật, thiên văn) - Hàng chính hãng",18920000,18920000,0,0
TIKI,dien-tu-dien-lanh,3810897,"Máy Nước Nóng Gián Tiếp FERROLI VERDI 20L TE (2500W) - Hàng Chính Hãng",2365000,2365000,0,0
TIKI,giay-dep-nu,74003235,"Giày thể thao sneaker nữ đế êm nhẹ thoáng khí thương hiệu ZAVAS - S396",180000,360000,180000,50
TIKI,may-anh,13892182,"Ống nhòm 1 mắt Halebor",89000,89000,0,0
TIKI,dien-tu-dien-lanh,126702091,"Điều khiển tivi dành cho Toshiba CT-8068",47500,50000,2500,5
TIKI,may-anh,144455283,"Ống nhòm cho trẻ con Binoculars mẫu mới 2020",44000,44000,0,0
TIKI,giay-dep-nu,199520284,"Dép nhà tắm Emhome, Dép đi trong nhà hình ô vuông chống trượt, hấp thụ sốc giúp êm mềm thoải mái bàn chân - Hàng chính hãng",72680,79000,6320,8
TIKI,dien-tu-dien-lanh,90148835,"Máy giặt Samsung Inverter 11kg WA11T5260BV/SV - Chỉ giao Hà Nội",8550000,8550000,0,0
TIKI,giay-dep-nu,149969265,"Dép nhựa siêu nhẹ Bitis nữ",104000,104000,0,0
TIKI,may-anh,174416971,"Máy ảnh Sony ILCE-7RM4A Body - Hàng Chính Hãng",74990000,74990000,0,0
TIKI,dien-tu-dien-lanh,146363487,"Hệ Thống Máy Lạnh Multi S Daikin Inverter Combo 2HP + 02 dàn lạnh 1.0HP + 1.5HP - MKC50RVMV/CTKC25RVMV+CTKC35RVMV - Hàng Chính Hãng - Chỉ giao tại TP.HCM",22042000,22042000,0,0
TIKI,may-anh,262762204,"Hohem Isteady X2 - Gimbal | Tay cầm chống rung có remote điều khiển từ xa dùng cho smartphone - Hàng Chính Hãng",1599000,1599000,0,0
TIKI,dien-tu-dien-lanh,50278870,"Khung treo tivi sát tường 26 - 32 inch",48000,48000,0,0
TIKI,giay-dep-nu,59465312,"Giày búp bê nhựa nữ đi mưa, đi biển, dạo phố siêu xinh GN09",59000,59000,0,0
TIKI,may-anh,13593871,"Ống nhòm Barska Lucid 12x25mm - Hàng chính hãng",1200000,1200000,0,0
TIKI,dien-tu-dien-lanh,167441196,"LỒNG QUẠT MÁY - HÀNG CHÍNH HÃNG 3HT",40000,40000,0,0
TIKI,may-anh,20425053,"Combo hộp chống ẩm, ẩm kế điện tử, 200gram hạt hút ẩm xanh, mút xốp, khăn lau lens cho máy ảnh, máy quay phim - dung tích 5 lít - Hàng chính hãng",179000,179000,0,0
TIKI,may-anh,144615912,"Chân Đế Camera IP Wifi Giá Rẻ -  Đa Năng Lắp Được Camera Xoay Ezviz, Imou, Kbone, Vitacam c1280 .....",9000,9000,0,0
TIKI,dien-tu-dien-lanh,198573060,"TẤM CHẮN GIÓ KHE LẠNH ĐIỀU HÒA Kt 60X15cm",350000,350000,0,0
TIKI,giay-dep-nu,141490261,"Giày sandal nữ da bò thật BIGGBEN cao cấp SDN70",339000,450000,111000,25
TIKI,giay-dep-nu,107675669,"Lót giày vòm cao ốp nhựa chuyên dùng cho bàn chân bẹt phẳng cải thiện dáng đi chân chữ X, giảm đau mỏi lòng bàn chân - buybox - V01BBPK179",63000,69000,6000,9
TIKI,giay-dep-nu,180323823,"Giày thể thao nữ độn đế, sneaker loại cao cấp, 9cm tôn chiều cao, bằng da PU, SIÊU ÊM - SIÊU ĐẸP - SIEU BỀN",239000,239000,0,0
TIKI,dien-tu-dien-lanh,186117126,"Tủ lạnh Aqua 130 lít AQR-T150FA (BS) - Hàng Chính Hãng [Giao hàng toàn quốc]",4680000,4890000,210000,4
TIKI,may-anh,17142465,"Phông nền chụp ảnh 3D 80cm x 125cm",79000,79000,0,0
TIKI,dien-tu-dien-lanh,196953412,"MÁY RỬA BÁT TEXGIO TG–DT2022B – Hàng chính hãng",6200000,6200000,0,0
TIKI,giay-dep-nu,41805495,"Giày thể thao nữ - giày sneaker nữ mầu trắng đế cao ST008W",168000,250000,82000,33
TIKI,giay-dep-nu,177482245,"Dép HT.NEO thiết kế mới lạ, độc đáo, trẻ trung, da cao cấp đi êm chân, thoải mái SDN100",140000,180000,40000,22
TIKI,may-anh,194139462,"Camera IP Wifi Ngoài Trời EZVIZ CB8 3MP 2K Tặng Kèm Tắm Pin Năng Lượng - Có Màu Ban Đêm - Đàm Thoại 2 Chiều - Hàng Chính Hãng",2365500,2490000,124500,5
TIKI,dien-tu-dien-lanh,11998183,"Android tivi box VNPT MyTVNet Net 1 - Tặng kèm chuột không dây chính hãng  ",725000,725000,0,0
TIKI,giay-dep-nu,54362596,"Dép Sandal nữ đi mưa cao 3.5p thời trang mới nhất V241",54000,54000,0,0
TIKI,dien-tu-dien-lanh,94584737,"Máy tính bảng 10.1 inch màn hình cong Moocis M5 Android 6.0 Ram3GB Rom32Gb - HanruiOffical",4264000,4264000,0,0
TIKI,may-anh,9797918,"Bộ 2 pin và sạc đôi RavPower LP-E17 cho Canon 77D, 750D, 760D, 800D, M6 - Hàng chính hãng",668999,668999,0,0
TIKI,dien-tu-dien-lanh,73174421,"Máy giặt LG Inverter 10.5 kg T2350VSAB - Chỉ giao Hà Nội",6290000,6290000,0,0
TIKI,giay-dep-nu,137966974,"Giày Cao Gót Nữ Pierre Cardin - PCWFWS159",490000,1690000,1200000,71
TIKI,dien-tu-dien-lanh,12771188,"Bình nước nóng Ariston Slim2 SL2 20 R - 20 lít - Hàng Chính Hãng",2899000,2899000,0,0
TIKI,may-anh,108342016,"Combo 1 pin 1 sạc đôi Kingma for Canon LP-E17 - Hàng chính hãng",429999,429999,0,0
TIKI,dien-tu-dien-lanh,176289443,"[HCM] Máy Sấy Thông Hơi Electrolux 8.5 kg EDS854J3WB (MODEL 2022) - 12 Chương Trình Sấy - Hàng Chính Hãng",12990000,12990000,0,0
TIKI,giay-dep-nu,195465100,"1 Đai nẹp hỗ trợ định hình ngón chân cái phiên bản CAO CẤP, điều chỉnh dễ dàng, tiện dụng #52",130000,130000,0,0
TIKI,dien-tu-dien-lanh,29246318,"Máy Sấy Cửa Trước Electrolux EDV805JQSA (8kg) - Hàng Chính Hãng",10590000,10590000,0,0
TIKI,dien-tu-dien-lanh,95515402,"Android Tivi OLED Sony 4K 55 inch XR-55A80J",26204000,26204000,0,0
TIKI,may-anh,100920384,"Camera Hành Trình Xe Hơi Hỗ Trợ Ghi Hình Ban Đêm 1080P_u2",299000,299000,0,0
TIKI,giay-dep-nu,196233252,"Dép quai ngang nữ hình gấu TEDDY MILK TEA thời trang hottrend năm 2022 Form nhỏ tăng 1-2 Size",53865,56700,2835,5
TIKI,dien-tu-dien-lanh,273533348,"Ron tủ lạnh có sẵn nam châm 1.6 mét màu trắng",25000,25000,0,0
TIKI,dien-tu-dien-lanh,23419942,"Máy giặt mini tại xô DEKE GT-16AC tiết kiệm điện cho sinh viên và em bé có hẹn giờ và đảo chiều",1099000,1099000,0,0
TIKI,may-anh,82529007,"Camera trong nhà Eufy Security Indoor Cam 2K, tích hợp còi báo động - Hàng chính hãng",888250,935000,46750,5
TIKI,giay-dep-nu,104438755,"Giày nhựa đi mưa, đi biển - Chất liệu siêu nhẹ - GN10",51000,51000,0,0
TIKI,dien-tu-dien-lanh,53304261,"Tủ lạnh Funiki Hòa Phát FR 136ISU 130 lít - Hàng Chính Hãng",3890000,3890000,0,0
TIKI,dien-tu-dien-lanh,154745459,"Bình nước nóng hồng ngoại xa Kangaroo KG588W - Hàng Chính Hãng",4200000,4200000,0,0
TIKI,may-anh,7586151,"Kính Thiên Văn Barska Starwatcher 300 Power - Hàng chính hãng",4114000,4114000,0,0
TIKI,dien-tu-dien-lanh,58537376,"Tủ Chăm Sóc Quần Áo Thông Minh Samsung DF60R8600CG/SV - Chỉ Giao Hà Nội",26804000,26804000,0,0
TIKI,giay-dep-nu,177772693,"Giày sandal nữ BIGGBEN cao 4,5cm SDN76",349000,500000,151000,30
TIKI,dien-tu-dien-lanh,125273731,"Tủ lạnh Casper Inverter 551 lít RS-575VBW - Chỉ giao Hà Nội",14390000,14390000,0,0
TIKI,giay-dep-nu,73980665,"Giày thể thao nữ giày sneaker nữ màu trắng đế 3cm bằng da màu trắng hiệu ZAVAS - S387",339000,360000,21000,6
TIKI,giay-dep-nu,50182055,"Giày búp bê nữ đế bằng nhựa đi mưa siêu bền đi thoáng và êm chân full size nhiều màu V217",55000,55000,0,0
TIKI,dien-tu-dien-lanh,13775999,"Bình nước nóng Ferroli Hotdog E (5L) - Hàng Chính Hãng",1747800,1747800,0,0
TIKI,giay-dep-nu,68385143,"Giày Mọi Moccasin Da Bò Thật Đế Cao Su Pixie X482",475000,475000,0,0
TIKI,dien-tu-dien-lanh,126702248,"Remote Điều khiển từ xa tivi dành cho LG giọng nói 2017 MR650A ",303000,303000,0,0
TIKI,dien-tu-dien-lanh,19389387,"Giá Treo Màn Hình Máy Tính North Bayou F120  (17-27 INCH) - Hàng Chính Hãng",378000,378000,0,0
TIKI,giay-dep-nu,106605092,"Giày búp bê nữ BIGGBEN da bò cao cấp BB99",289000,400000,111000,28
TIKI,giay-dep-nu,178470868,"Sét 2 miếng lót gót chân cao su mềm bảo vệ gót chân khi mang giày ,chống nứt gót ,bảo vệ mắt cá ,chống đau chân",49000,49000,0,0
TIKI,dien-tu-dien-lanh,117033515,"Remote BN59-01329H Điều Khiển Dành Cho Samsung Smart TV QLED 4K - Nhận Giọng Nói ",155000,155000,0,0
TIKI,giay-dep-nu,57382862,"Dép Đi Trong Văn Phòng - Trong Nhà Tắm Chống Trơn Trượt Lock&Lock ETM645",96000,170000,74000,44
TIKI,dien-tu-dien-lanh,170275021,"Bộ phụ kiện của Áo điều hòa Nhật Bản",546000,546000,0,0
TIKI,dien-tu-dien-lanh,74893159,"Magic Remote Điều Khiển Dành Cho Smart TV, Tivi Thông Minh LG AN-MR18BA Chuột Bay, Nhận Giọng Nói ",310000,310000,0,0
TIKI,dien-tu-dien-lanh,3813015,"Tủ Lạnh Inverter Hitachi R-FW690PGV7-GBW (540L) - Hàng chính hãng",27500000,27500000,0,0
TIKI,giay-dep-nu,128086563,"NÚT BỌC GÓT GIÀY CAO GÓT CÓ LINE CỐ ĐỊNH",35000,35000,0,0
TIKI,dien-tu-dien-lanh,126701916,"Điều khiển điều hòa dành cho Daikin hàng mới",58000,58000,0,0
TIKI,dien-tu-dien-lanh,140192388,"Giá treo tivi thẳng tường cố định hàng xuất khẩu dùng cho tivi siêu mỏng, Hàng Chính Hãng",166900,166900,0,0
TIKI,dien-tu-dien-lanh,52695663,"Máy giặt Electrolux Inverter 8 kg EWF8025CQSA",7390000,7390000,0,0
TIKI,dien-tu-dien-lanh,191089702,"Máy Giặt Sấy Cửa Trước Panasonic 9 Kg giặt 6kg sấy NA-S96FR1BVT - Diệt khuẩn đến 99.99% - Giặt sấy 2 trong 1 - Hàng Chính Hãng (Đen) - Giao Toàn Quốc",16490000,21390000,4900000,23
TIKI,dien-tu-dien-lanh,119193686,"Remote Điều khiển dành cho quạt Mitsubishi+ kèm pin 3V",56000,56000,0,0
TIKI,dien-tu-dien-lanh,113490579,"TV QLED 50'' 4K Android 11 Tivi TCL 50C725 - Gam Màu Rộng , HDR 10+, MEMC , Dolby Audio- HÀNG CHÍNH HÃNG",12950000,12950000,0,0
TIKI,dien-tu-dien-lanh,55584723,"Tủ mát - Minibar, Tủ bảo quản mỹ phẩm, Model: BCH-40B2, Thể tích 40L, Công suất 65W, Điện áp 220VAC, Cửa gương sang trọng, Không tiếng ồn, Tiết kiệm điện năng, Thương hiệu Homesun, Hàng chính hãng",4180000,4180000,0,0
TIKI,dien-tu-dien-lanh,176289386,"Máy Rửa Chén Độc Lập Electrolux ESF5206LOW - 13 Bộ Chén Đĩa - Hàng Chính Hãng",21990000,21990000,0,0
TIKI,dien-tu-dien-lanh,31587116,"MÁY RỬA BÁT FUJISHAN FJVN15- S03AF Hàng Chính Hãng",10990000,10990000,0,0
TIKI,dien-tu-dien-lanh,32920496,"Máy giặt Electrolux Inverter 9 kg EWF9024ADSA",9450000,9450000,0,0
TIKI,dien-tu-dien-lanh,1956689,"Bình nước nóng Ferroli Verdi DE20L, 3 công suất, hiển thị nhiệt độ, có chống giật, 2500W - Hàng Chính Hãng",2491733,2491733,0,0
TIKI,dien-tu-dien-lanh,126701984,"Remote Điều khiển từ xa dành cho TIVI SAMSUNG SMART BN59-01266A",165000,165000,0,0
TIKI,dien-tu-dien-lanh,89637495,"Remote điều khiển cho smart TV LG, Internet TV, tivi thông minh loại ngắn tặng kèm pin",53000,53000,0,0
TIKI,dien-tu-dien-lanh,171273605,"ÁO VỆ SINH MÁY LẠNH LOẠI TỐT CÓ ĐUÔI DÀI 2,5met - Xanh bích không dây siêu rẻ",55000,55000,0,0
TIKI,dien-tu-dien-lanh,20500053,"Tủ Lạnh Inverter LG GN-M255BL (255L) - Hàng chính hãng",6850000,6850000,0,0
TIKI,dien-tu-dien-lanh,55109192,"Remote Điều Khiển Hộp TV Thông Minh, ANDROID TV BOX (Kèm Pin AAA Maxell)",59000,59000,0,0
TIKI,dien-tu-dien-lanh,168042358,"Smart Tivi QLED Samsung 4K 65 inch QA65Q70BA - Model 2022",21200000,21200000,0,0
TIKI,dien-tu-dien-lanh,186693695,"Điều hòa Casper 1 chiều Inverter 12.000 BTU GC-12IS33 -Hàng chính hãng ( Chỉ giao hàng tại Hà Nội)",6690000,6690000,0,0
TIKI,dien-tu-dien-lanh,10191063,"Tủ Lạnh Inverter LG GN-D602BL (475L) - Hàng chính hãng",13800000,13800000,0,0
TIKI,dien-tu-dien-lanh,184698546,"Dây Cáp AV 1 Ra 3 Dành Cho TV",14000,14000,0,0
TIKI,dien-tu-dien-lanh,169748875,"Smart Tivi Neo QLED Samsung 8K 65 inch QA65QN700B - Model 2022",71000000,71000000,0,0
TIKI,dien-tu-dien-lanh,195480654,"Smart Tivi LG 4K 75 inch 75UQ8000PSC - Model 2022",19500000,19500000,0,0
TIKI,dien-tu-dien-lanh,4184251,"Máy Nước Nóng Ferroli VERDI 20L SE (2500W)",2589000,2589000,0,0
TIKI,dien-tu-dien-lanh,168780538,"Android Box Mytv net  Phiên bản Ram 2G/16G 4G/32G có điều khiển giọng nói - Xem 200 Kênh truyền hình miễn phí - Hàng Chính Hãng",1089000,1089000,0,0
TIKI,dien-tu-dien-lanh,135273331,"Máy giặt mini có giặt ngâm, giặt nhẹ kích thước nhỏ 2,5kg đồ giặt",799000,799000,0,0
TIKI,dien-tu-dien-lanh,50189662,"Máy giặt Toshiba 9.5 KG TW-BK105S3V SK",7479000,7479000,0,0
TIKI,phu-kien-thoi-trang,52580065,"Găng tay/ bao tay hở ngón chuyên phượt sport có gù - giao màu ngẫu nhiên ",42000,42000,0,0
TIKI,phu-kien-thoi-trang,16605414,"Hộp kim chỉ đa năng 55 món tiện dụng",35000,35000,0,0
TIKI,phu-kien-thoi-trang,181449243,"Khăn Lau Kính Nano Hộp 100 Miếng Khăn Giấy Chống Bám Hơi Nước, Giấy Lau Kính Chống Mờ Sương, Mồ Hôi, Chống Nhờn",27000,27000,0,0
TIKI,phu-kien-thoi-trang,150332055,"Gọng kính 8080 nhựa cao cấp siêu bền thời trang nam nữ OURESS",270000,299000,29000,10
TIKI,phu-kien-thoi-trang,170262631,"Khăn lau mắt kính nano chống hơi nước chuyên dụng Hộp 100pcs lau mũ bảo hiểm, màn hình điện thoại, laptop chống bám bụi",22000,27000,5000,19
TIKI,phu-kien-thoi-trang,191911527,"Mũ trùm đầu y tế, nón con sâu Khánh An bịch 100 cái dùng trong môi trường y tế, thí nghiệm, điện tử, thực phẩm, spa",96000,120000,24000,20
TIKI,phu-kien-thoi-trang,74495963,"Dây Thắt Lưng Da Bò KEIO NIPPON - Dây Nịt Nam Không Mặt Khóa",249000,249000,0,0
TIKI,phu-kien-thoi-trang,75583448,"Gel lau kính chống bám sương mù, hơi nước cho mắt kính",189000,189000,0,0
TIKI,phu-kien-thoi-trang,128327129,"bờm tóc sắt sóng màu đen (giá 1 cái )",12000,20000,8000,40
TIKI,phu-kien-thoi-trang,155789821,"Mũ chống nắng đa năng nữ, nón chống nắng, mũ chống nắng kèm khẩu trang khăn trùm vai gáy mũ vải cotton mã VAM0156",98500,98500,0,0
TIKI,phu-kien-thoi-trang,112937019,"Thắt Lưng Co Giãn U863 US ARMY, Mặt Khóa Truyền Thống Chất Liệu Thép Sáng Bóng Không Ghỉ Thiết Kế Thời Trang, Dùng Cho Cả Nam Và Nữ- HÀNG CHÍNH HÃNG",72000,170000,98000,58
TIKI,phu-kien-thoi-trang,73984173,"Bao tay găng tay Nữ chống nắng giữ ấm lái xe, sử dụng điện thoại Cao Cấp - MD001",70000,70000,0,0
TIKI,phu-kien-thoi-trang,14486912,"Cài tóc ngọc trai đính đá",23000,35000,12000,34
TIKI,phu-kien-thoi-trang,12727575,"Bộ Năm Cặp Kính Áp Tròng Trong Suốt Dùng 1 ngày Eye Secret- Năm.Năm độ",180000,199000,19000,10
TIKI,phu-kien-thoi-trang,195749420,"Mắt kính mát nam thời trang form dáng hiện tại , cảm giác dễ chịu 8521 [ BỘ ĐỰNG KÍNH 5 MÓN] DUMBUM BK001",129000,145000,16000,11
TIKI,phu-kien-thoi-trang,119217005,"Kẹp Tóc Càng Cua Nhỏ Gọn 3 Răng Làm Từ Nhựa Bền Bỉ Cho Nữ",9000,15000,6000,40
TIKI,phu-kien-thoi-trang,178514902,"1 Miếng Mặt Nạ Tái Sinh Tinh Chất Rau Má Cho Da Dầu Mụn LOOKS &amp; MEII Centella Relaxation Perfect Calming Mask",29000,29000,0,0
TIKI,phu-kien-thoi-trang,154781232,"Mũ lưỡi trai - nón Ulzzang thêu chữ ký unisex nam nữ chống nắng phong cách thời trang, cá tính",55000,110000,55000,50
TIKI,phu-kien-thoi-trang,55611636,"combo 10 dây cột tóc lò xo dây điện thoại mẫu mới",20000,20000,0,0
TIKI,phu-kien-thoi-trang,192712577,"váy chống nắng xẻ tà cố định bằng miếng dán kết hợp nút bấm chất mềm mại co giãn tốt xòe rộng dài dưới tà váy có nút bấm cố định",119000,119000,0,0
TIKI,phu-kien-thoi-trang,177548500,"Combo 5 đôi Vớ nữ cổ ngắn Vintage, Tất nữ sử dụng cả tuần - GOMTAT - CB39K",29000,55000,26000,47
TIKI,phu-kien-thoi-trang,164022009,"Kính Mát Nam Thời Trang, Mắt Vuông Tròng Phân Cực Đổi Màu Chống Lóa Đi Đêm, Gọng Kính Gập Tiện Lợi AK026 - AORON",220000,330000,110000,33
TIKI,phu-kien-thoi-trang,140807019,"Mũ Lưỡi Trai Nam Thời Trang Lính Cao Cấp U368, Nón Kết Nam Vành Cong Thời Trang US ARMY -HÀNG CHÍNH HÃNG",74000,178000,104000,58
TIKI,phu-kien-thoi-trang,177163752,"Găng Tay Chống Nắng, Bao Tay Chống Nắng Xỏ Ngón Hàn Quốc Nam Nữ Chống Tia UV - LISU-GANGTAY-001",15999,15999,0,0
TIKI,phu-kien-thoi-trang,26091206,"Set 10 Đôi Vớ Nữ In Hình Gấu Brown Xinh Xắn (Kèm Túi Đựng Hình Gấu)",29972,29972,0,0
TIKI,phu-kien-thoi-trang,4562083,"Tất Vớ Nam Nữ Cổ Ngắn AS-PS101. 4 màu: Trắng, Đen, Xanh đen, Xám. Mềm mại, kháng khuẩn khử mùi, không hôi chân",10000,24000,14000,58
TIKI,phu-kien-thoi-trang,49210060,"Vỉ 3 Kẹp Tóc Càng Cua PASTEL 3 Chấu Loại Xịn MP120.3",19000,19000,0,0
TIKI,phu-kien-thoi-trang,5516513,"Khăn Choàng Dạ Cashmere Thu Đông Cao Cấp HN18",251000,251000,0,0
TIKI,phu-kien-thoi-trang,105112268,"kính lão đọc sách tròng kính thủy tinh gọng si vàng chuẩn độ from đẹp",82000,105000,23000,22
TIKI,phu-kien-thoi-trang,57300908,"Khăn trùm kín mặt chống nắng, chống tia UV khi đi xe dành cho cả nam và nữ Rimix - Hàng chính hãng",99000,188000,89000,47
TIKI,phu-kien-thoi-trang,195823157,"Tròng kính HT Hàn Quốc",135000,150000,15000,10
TIKI,phu-kien-thoi-trang,120379364,"Kẹp Tóc Càng Cua Hình Nơ Lớn Kiểu Hàn Quốc Xinh Xắn Cho Nữ",25000,25000,0,0
TIKI,phu-kien-thoi-trang,165994967,"Gọng kính chính hãng SARIFA 2250",178000,520000,342000,66
TIKI,phu-kien-thoi-trang,46160133,"Hộp đựng mắt kính có móc treo, Hộp đựng mắt kính thiết kế khóa kéo có móc treo nhỏ gọn tiện dụng - Màu đen",29500,29500,0,0
TIKI,phu-kien-thoi-trang,145243741,"Băng đô cài tóc, Bờm cài tóc bản 1cm nhiều màu xinh xắn cho nữ - Culi accessories",22000,24000,2000,8
TIKI,phu-kien-thoi-trang,112562057,"Dây Lưng Vải Nam U689 US ARMY Phong Cách Lính, Mặt Khóa Hợp Kim Thép Không Ghỉ Sáng Bóng-HÀNG CHÍNH HÃNG",85000,178000,93000,52
TIKI,phu-kien-thoi-trang,102889070,"Tóc giả búi xoăn kẹp ngoạm, búi ngoạm tóc giả Sỉ 35k",50000,50000,0,0
TIKI,phu-kien-thoi-trang,188381543,"Dây Buộc Tóc Nữ In Hoa 3D Khăn Choàng Cổ Khăn lụa Thời Trang Phụ Kiện Mặc Đi Chơi Quà Tặng Cao Cấp-New Design PK0011",40000,62000,22000,35
TIKI,phu-kien-thoi-trang,167524539,"Mắt kính chữ V dành cho nam nữ nhiều màu sắc lựa chọn giá rẻ - ANCHI HOUSE",35000,35000,0,0
TIKI,phu-kien-thoi-trang,87093174,"Dây nịt thắt lưng nam khóa tự động (không khóa) D&D Fashion - Bo tròn đen",28000,50000,22000,44
TIKI,giay-dep-nu,104261269,"Dép kẹp nữ đế cao 7cm chống trơn trượt",119000,119000,0,0
TIKI,giay-dep-nu,192135155,"Dép Nữ Da Bò Thật BIGGBEN Cao Cấp DNQN51",299000,350000,51000,15
TIKI,giay-dep-nu,106901880,"Giày Búp Bê Nữ Da Bò BIGGBEN Cao Cấp BB109",309000,400000,91000,23
TIKI,giay-dep-nu,74301261,"Giày Búp Bê Nữ Da Bò BIGGBEN Cao Cấp BB76",309000,400000,91000,23
TIKI,giay-dep-nu,177642266,"Giày Búp Bê Nữ Da Bò BIGGBEN Cao Cấp BB122",309000,350000,41000,12
TIKI,giay-dep-nu,179911875,"Giày Thể Thao Nữ Sneaker Kiểu Hàn Quốc Mẫu Mới 2022 Êm Chân Thoáng Khí Cổ Vừa Trẻ Trung Năng Động SUNO STORE GTTN11",199000,199000,0,0
TIKI,giay-dep-nu,77715686,"Lót giày cao gót chống trượt bàn chân về phía mũi và đệm êm gang bàn chân - 1 cặp - buybox - BBPK161",15000,30000,15000,50
TIKI,giay-dep-nu,46760225,"Combo 01 cặp lót giày nguyên bàn chân đa năng và 01 cặp lót giày bảo vệ gót chân 2 trong 1_buybox_BBPK11&09",50000,100000,50000,50
TIKI,giay-dep-nu,112861738,"Dép Đi Trong Nhà, Dép Bông Nam Nữ Đế Chống Trơn, Dép Đi Trong Văn Phòng Êm Chân D37",79000,79000,0,0
TIKI,giay-dep-nu,98069554,"Giày sneaker thể thao nữ buộc dây siêu nhẹ V280",69000,69000,0,0
TIKI,giay-dep-nu,148072539,"Dép quai ngang hình khủng long siêu hot 2021",49000,49000,0,0
TIKI,may-anh,107611553,"Sạc thay thế dành cho sạc máy ảnh Canon",129999,129999,0,0
TIKI,may-anh,181976961,"Camera wifi Yoosee 4 Râu 17 Led FULL HD 6.0Mpx, Xoay 360° Chuyên Dụng Ngoài Trời - Hàng Nhập Khẩu",429000,680000,251000,37
TIKI,may-anh,173570812,"Camera WiFi Thông Minh TP-Link Tapo C100 An Ninh Cho Gia Đình - Hàng Chính Hãng",399000,790000,391000,49
TIKI,may-anh,159482551,"Pin sạc Kingma Ver 2 cho Sony NP-FZ100, Hàng chính hãng",269999,269999,0,0
TIKI,giay-dep-nu,68400998,"Hàng Chính Hãng - Pixie Giày Búp Bê Bệt Da Bò Thật Gắn Nơ Độ Bền Cao Siêu Êm Không Đau Chân  X424",189000,189000,0,0
TIKI,may-anh,199631218,"Túi đựng máy ảnh dây rút nhỏ gọn chống thấm nước có dây đeo chéo",200000,200000,0,0
TIKI,giay-dep-nu,59107611,"Cầu vai bảo vệ (nền xanh đen-gạch vàng-viền đỏ-sao bạc)",40000,40000,0,0
TIKI,may-anh,2416333,"Bộ 2 Pin AA Panasonic Eneloop 2000mAh - Hàng chính hãng",199000,199000,0,0
TIKI,may-anh,90835786,"Tủ đựng đầu ghi camera, các bộ switch nhà mạng, các bo mạch điện, điện tử...",179000,179000,0,0
TIKI,may-anh,4688897,"Chân Máy Ảnh Tripod Weifeng 3520 - Hàng Nhập Khẩu",224999,224999,0,0
TIKI,may-anh,142217257,"Camera Imou C22SP - Chip Hình Ảnh Thế Hệ Mới 2022 - Đàm Thoại 2 Chiều - Full HD 1080 - Góc Siêu Rộng - Hàng Chính Hãng",405000,405000,0,0
TIKI,may-anh,194139957,"Thẻ nhớ SDHC SanDisk Extreme Pro SDSDXXO-032G U3 V30 32GB 100MB/s New 2022 - Hàng Nhập Khẩu",245000,245000,0,0
TIKI,giay-dep-nu,168282118,"Cặp lót giày cao gót massage êm chân nguyên bàn (XLGCG02)",15000,30000,15000,50
TIKI,may-anh,2419567,"Tản sáng Omni bounce cho flash speedlite ",49999,49999,0,0
TIKI,may-anh,52341716,"Pin AAA Panasonic Ankaline LEO Vua Năng Lượng Vỉ 4 Viên - Hàng Chính Hãng",70000,70000,0,0
TIKI,may-anh,38089568,"Vỉ 2 Viên Pin Sạc AAA Eneloop BK4MCCE Made In Japan - Chính Hãng",200000,200000,0,0
TIKI,giay-dep-nu,151489262,"Giày búp bê nữ da bò cao cấp BIGGBEN BB120",309000,400000,91000,23
TIKI,giay-dep-nu,197668980,"Giày cao gót HT.NEO cao 9p gót trụ vân kẻ, chất liệu da cao cấp, thiết kế đơn giản, mới lạ, đi êm chân, thoải mái CS246",480000,1100000,620000,56
TIKI,may-anh,20712070,"Pin CR123A Panasonic_Hàng Chính Hãng",100000,100000,0,0
TIKI,may-anh,242643936,"Camera wifi IP 2M IMOU C22EP chống trộm, chống ngược sáng - Hàng chính hãng",489000,700000,211000,30
TIKI,giay-dep-nu,22388687,"Jibbitz Sticker Icon 3D Gắn Dép Sục (Combo 10 sticker) - Giao Mẫu Ngẫu Nhiên",22000,22000,0,0
TIKI,giay-dep-nu,28737579,"2 cặp miếng lót mũi giày cao gót 4D êm chân thoáng khí - buybox - BBPK14",38000,65000,27000,42
TIKI,giay-dep-nu,168117359,"COMBO 10 ĐÔI DÉP XỐP QUAI NGANG CHO KHÁCH SẠN, NHÀ NGHỈ",115000,115000,0,0
TIKI,may-anh,148713428,"Camera Yoosee Trong Nhà Thế Hệ Mới Ban Đêm Có Màu, Đàm Thoại Hai Chiều Full HD 1080P-Hàng Nhập Khẩu",208050,219000,10950,5
TIKI,may-anh,2566029,"Hắt Sáng 5 Trong 1 Hongkong Electronic 110cm (Trắng) - Hàng Nhập Khẩu",207000,207000,0,0
TIKI,giay-dep-nu,15000222,"Dép nữ xỏ ngón -Dép kẹp đen  da bò thật mềm mại  XN0016- đen - 35",196000,229000,33000,14
TIKI,may-anh,13407305,"Dây đeo  chống mỏi thổ cẩm cho máy ảnh - Q00121",79000,79000,0,0
TIKI,giay-dep-nu,59207075,"Giày Sandal Nữ Da Bò BIGGBEN Cao Cấp SDCG49",349000,400000,51000,13
TIKI,giay-dep-nu,188486981,"Quai giày thun đan hồi, bản to phối khoen, thiết kế chắc chắn, chống tuột gót giày, dùng cho nữ - buybox - BBPK218",53200,70000,16800,24
TIKI,may-anh,110255755,"Chân máy quay Weifeng WF-717, Hàng chính hãng",2249999,2249999,0,0
TIKI,may-anh,44801520,"Tủ Chống Ẩm Andbon AB-21C (20 Lít) - Hàng Chính Hãng",949999,949999,0,0
TIKI,giay-dep-nu,144180526,"Dép nhựa nữ quai ngang BS huyền thoại mang trong nhà chống trơn trượt",49500,49500,0,0
TIKI,may-anh,2596899,"Túi Máy Ảnh Canvas Photoman For Mirroless Sony Nex, Sony A7, Fujifilm",134999,134999,0,0
TIKI,may-anh,242644479,"Camera WIFI ngoài trời IMOU S21FP, S41FP có màu ban đêm, xoay 360 độ - Hàng chính hãng",792000,792000,0,0
TIKI,may-anh,50569192,"Gói hút ẩm Silicagel loại 5gram (1kg có 200 gói nhỏ kích thước 5x5,5cm)",89000,89000,0,0
TIKI,giay-dep-nu,125098879,"Giày lười nữ Anh Khoa D993-7",220000,220000,0,0
TIKI,giay-dep-nu,197674887,"Giày cao gót HT.NEO 9p gót trụ khuy nơ viền kim loại, thiết kế trẻ trung, da cao cấp, đi cực tôn dáng, êm chân CS248",450000,980000,530000,54
TIKI,giay-dep-nu,155381539,"Dây giày thông minh không cần buộc Sans945 co giãn bản dẹt cho giày thể thao sneaker nam nữ nhiều màu trắng đen xanh xám",59999,59999,0,0
TIKI,may-anh,19583872,"Tripod giá đỡ 3 chân mini đa năng hỗ trợ tay cầm, để bàn cho điện thoại, gopro",55000,55000,0,0
TIKI,may-anh,13335028,"Ống nhòm đôi cao cấp 3D 30x60 (màu đen)",88000,88000,0,0
TIKI,may-anh,116987925,"Camera ip Yoosee Wifi 3 Râu 8 Led Có Màu Ban Đêm, xoay 360 độ, Bản Chuẩn 1080Pixel - Hàng Nhập Khẩu",218500,230000,11500,5
TIKI,giay-dep-nu,159437923,"Dép Đúc Nguyên Khối Cao Su Dẻo Chống Trơn Trượt Mang Trong Nhà Mẫu Mới Nhất",49000,49000,0,0
TIKI,giay-dep-nu,172077680,"Giày Nữ Búp Bê Đính Nơ Tomoyo Da Micro Fiber Khắc Hoạ Tiết Laser TMW31105",800000,800000,0,0
TIKI,giay-dep-nu,24843053,"Dép massage chân cải thiện sức khỏe",119000,119000,0,0
TIKI,may-anh,153860641,"Camera IMOU Ranger 2C, Camera Xoay 360, AI Phát hiện người, màng trập riêng tư 2MP/4MP - Hàng Chính Hãng",550000,780000,230000,29
TIKI,giay-dep-nu,98070256,"Giày lười nữ êm chân phong cách hàn quốc V281",69000,69000,0,0
TIKI,may-anh,117076592,"Camera IP Wifi Trong Nhà EZVIZ C6N 4MP 2K - Hàng Chính Hãng",720000,839000,119000,14
TIKI,giay-dep-nu,143799896,"Dép Nữ quai ngang một bản thời trang cao cấp Trường Hải đế PU nhẹ cao 2.5cm Màu Kem thời trang nữ cao cấp N146K",207000,259000,52000,20
TIKI,may-anh,104070115,"Đầu đọc thẻ nhớ SSK cho máy ảnh - Hàng chính hãng",155000,155000,0,0
TIKI,may-anh,56416440,"Hộp Sạc Pin Telesin Cho GoPro Hero 5 6 7 8 / Dock Sạc Pin Cho GoPro - Hàng Nhập Khẩu",371040,463800,92760,20
TIKI,giay-dep-nu,192832023,"Dép Nữ Pierre Cardin - PCWFWSG 169",490000,1290000,800000,62
TIKI,giay-dep-nu,137966471,"Giày Nữ Pierre Cardin - PCWFWS160",490000,1690000,1200000,71
TIKI,giay-dep-nu,193889750,"Bốt Đùi Nữ Da Lì Trắng Đen Thời Trang Khoá Sau Ulzzang Siêu Hót Cao Cổ Giày Boot Xinh",525000,755000,230000,30
TIKI,may-anh,2566045,"Dây Đeo Ngực Cho Gopro Yicamera SJcam (Đen) - Hàng Nhập Khẩu",84900,84900,0,0
TIKI,giay-dep-nu,97103083,"Giày búp bê Doris đế bệt, ️️️️giày da thật mũi tròn gắn nơ vuông màu kem, thời trang cho nữ DR004",199000,199000,0,0
TIKI,giay-dep-nu,57760484,"Giày Sandals nữ 3 phân chống nước cao su quai chéo V246",55000,55000,0,0
TIKI,may-anh,50014370,"Ống nhòm một mắt zoom 7x - 21x Carson ZM-721 - Hàng chính hãng",1890000,1890000,0,0
TIKI,may-anh,40757037,"Pin LP-E8 dùng cho máy ảnh Canon 550D 600D 650D 700D - Hàng nhập khẩu",199999,199999,0,0
TIKI,giay-dep-nu,126090214,"Dép Đế Trấu Quai Chéo Nam Nữ Đi Mưa Deaunisex Màu Đen - DETA23F",300000,300000,0,0
TIKI,may-anh,82983828,"Filter Kính lọc UV Marumi 37-82cm, Chính hãng",239999,239999,0,0
TIKI,may-anh,14241258,"Sạc Pin NP-FW50 Cho Máy Ảnh Sony Nex/A5000/A6000 - Hàng Nhập Khẩu",91000,91000,0,0
TIKI,giay-dep-nu,80849903,"2 cặp lót mũi giày bằng mút bọc vải đệm êm ngón chân, giảm rộng cho giày - buybox - BBPK38_2",48000,80000,32000,40
TIKI,may-anh,12321426,"khăn da cừu lau ống kính máy ảnh",45000,45000,0,0
TIKI,giay-dep-nu,188487235,"Lót giày bảo vệ gót hình vỏ sò tăng độ bám chân chuyên dùng mang giày thể thao - buybox - BBPK224",48000,70000,22000,31
TIKI,may-anh,7176411,"Chân máy ảnh Tripod 3110 tặng Giá kẹp điện thoại, Remote bluetooth và Túi đựng",61900,61900,0,0
TIKI,giay-dep-nu,71681207,"Giày búp bê công sở tôn dáng siêu xinh có khả năng chịu nước chống trơn trượt V259",65000,65000,0,0
TIKI,may-anh,461038,"Thẻ Nhớ SD SanDisk Ultra Class 10 32GB - 48MB/s - Hàng Chính Hãng",159000,169000,10000,6
TIKI,may-anh,53089354,"Bộ 10 Adapter - Nguồn - 12V-2A Actiontec",345000,345000,0,0
TIKI,may-anh,180239300,"Ống Nhòm 1 Mắt 10-30x25mm Chuyên Nghiệp",261250,275000,13750,5
TIKI,giay-dep-nu,125098606,"Giày Lười Nữ Anh Khoa A923-1",199000,199000,0,0
TIKI,giay-dep-nu,201657293,"Giày Nhựa Nữ Nam Cao Cấp, Giày Đi Mưa, Đi Biển FITTOP GIAY-030-2",529000,529000,0,0
TIKI,giay-dep-nu,118848830,"Dép cói viền ren đi biển đang cực kỳ hot khách ơi",125000,125000,0,0
TIKI,giay-dep-nu,217185554,"Giày Cao Gót 6 Phân KD221328-3A",249000,249000,0,0
TIKI,giay-dep-nu,186279292,"Dép mang trong nhà hình trái tim chử hello - Giao màu ngẫu nhiên",95000,95000,0,0
TIKI,giay-dep-nu,90797394,"MIẾNG DÁN GÓT GIÀY SILICON - TRONG SUỐT",26000,26000,0,0
TIKI,giay-dep-nu,165704180,"Giấy lau giầy Sneaker 30 tờ, Dung dịch chuyên lau giày thấm sẵn trong khăn tiện dụng",36000,36000,0,0
TIKI,giay-dep-nu,55783046,"Sandal Đế Cao 10CM X445",445000,445000,0,0
TIKI,giay-dep-nu,189267954,"Giày Sandal Nữ The Bily 03W Quai Ngang - Màu Xám BL03WX",329000,329000,0,0
TIKI,giay-dep-nu,108382671,"Giày Thể Thao Sneaker Nữ Đế 2 Lớp Êm Chân , Đi Dạo Đi Chơi Tập Thể Dục G183B",59000,80000,21000,26
TIKI,giay-dep-nu,55315244,"Giày đế xuồng nữ Trường Hải da bò thât màu xanh đen cao 3cm đế cao su dẻo không trơn DX189",236000,279000,43000,15
TIKI,giay-dep-nu,271382565,"[Original] Timberland Giày Boot Nữ - Women’s Waterville 6-Inch Waterproof Boot Black Nubuck TB0A17VM01",5990000,5990000,0,0
TIKI,giay-dep-nu,197677652,"DÉP SỤC NHỰA ĐẾ CAO NỮ NHIỀU MÀU KÈM 6 STICK SIZE 36-40",79900,79900,0,0
TIKI,giay-dep-nu,84199259,"Sandal Vento Nữ Thời Trang NB81",345000,345000,0,0
TIKI,giay-dep-nu,74896976,"Giày nữ thời trang cao cấp ELLY – EG120",1199000,1199000,0,0
TIKI,giay-dep-nu,196382462,"HAVAIANAS - Dép nữ Slim Glitter Neon 4147111",699000,699000,0,0
TIKI,giay-dep-nu,89931441,"Giày boot dây kéo phía trước nữ 20414",444400,690800,246400,36
TIKI,giay-dep-nu,79580223,"Giày Búp Bê Nữ Siêu Êm TOMOYO TMW20406",699000,699000,0,0
TIKI,giay-dep-nu,19728150,"Giày boot chelsea 4 phân trơn cổ ngắn S402",196000,209000,13000,6
TIKI,giay-dep-nu,89242604," 1 Đôi dép xốp đi trong nhà cho nam và nữ gồm nhiều màu",35000,35000,0,0
TIKI,giay-dep-nu,13629812,"Miếng mút lót mũi giày êm chân (Màu Đen)",20000,20000,0,0
TIKI,giay-dep-nu,101043789," Một Đôi Dép Xốp Lỗ Đi Trong Nhà Và Nhà Tắm",35000,35000,0,0
TIKI,giay-dep-nu,173130684,"Mặt gỗ me tây nguyên tấm cắt vuông mặt dài 87 x rộng 61 x dày 6.5 (cm) KL20356",2268000,2268000,0,0
TIKI,giay-dep-nu,149425833,"Giày lười nữ đế bệt ChristinA-Q GLM028",549000,549000,0,0
TIKI,giay-dep-nu,37813711,"Dép Nữ Đông Hải - D5636",550000,550000,0,0
TIKI,giay-dep-nu,99030705,"Dép Xỏ Ngón Nữ Đế Bệt HÀ NAM Da Bò Cao Cấp 2,5cm DNU2067",360000,360000,0,0
TIKI,giay-dep-nu,68882021,"Dép đi trong nhà 2020 chống trơn trượt  thiết kế trơn, màu đơn giản PVC sâu",99000,159000,60000,38
TIKI,giay-dep-nu,51151385,"Giày mọi nữ thời trang đi êm chân 177",93000,93000,0,0
TIKI,giay-dep-nu,127379992,"Giày Sneaker Vải Canvas Unisex C20 Grey Dincox Sang Trọng Tinh Tế Đơn Giản",376000,376000,0,0
TIKI,giay-dep-nu,52386332,"Combo 5 Jitbitz Lò Xo 2D  gắn dép cá sấu - gắn dép sục",49000,49000,0,0
TIKI,giay-dep-nu,149532730,"Dép Thái Quai Ngang Siêu Nhẹ Nhiều Màu",39000,39000,0,0
TIKI,giay-dep-nu,167980353,"Sục Lưới đế cao 8CM da vi sợi S599-2001",599000,599000,0,0
TIKI,giay-dep-nu,179880534,"Dép Nữ Quai Chéo Đế Bệt HÀ NAM Da Bò Thật Thời Trang Cao Cấp DNU2081c",290000,290000,0,0
TIKI,giay-dep-nu,61278554,"Giày thể thao nữ hoa cúc đi bộ cực êm siêu xinh V253 - Hồng - Size 39",55000,55000,0,0
TIKI,giay-dep-nu,101071574,"Giày múa bale nữ màu ngẫu nhiên 21115",364300,364300,0,0
TIKI,giay-dep-nu,171198084,"Giày cao gót phối màu đỏ đen cao cấp 9 - 11cm",249600,249600,0,0
TIKI,giay-dep-nu,2921667,"Bốt Nữ Lót Lông Mùa Đông",99000,99000,0,0
TIKI,giay-dep-nu,89936072,"Giày múa bale nữ 21113",111100,256500,145400,57
TIKI,giay-dep-nu,190635299,"GIÀY THỂ THAO NỮ PHẢN QUANG CỰC ĐẸP",180000,180000,0,0
TIKI,giay-dep-nu,13986746,"Giày cao gót 7cm đế vuông da bóng đen CG01",256000,299000,43000,14
TIKI,may-anh,171202931,"Giày sandal 4 dây quai ngang phối chéo Giavy SL524",198000,198000,0,0
TIKI,may-anh,97546164,"Giày Tây Nam Buộc Dây Bảo Hân Mã CS89",295000,590000,295000,50
TIKI,may-anh,141237392,"Giày Tây nam tăng chiều cao Đông Hải kiểu dáng Derby  thanh lịch da cao cấp đế 6cm cải thiện chiều cao - G0615",1980000,1980000,0,0
TIKI,may-anh,192889107,"Sticker nhựa jibbitz unisex Crocs Beer",145000,145000,0,0
TIKI,may-anh,50694122,"Bọt vệ sinh giày đa năng, sneaker + tặng kèm  bản chải đánh giày",120000,120000,0,0
TIKI,may-anh,111092834,"Chai xịt khử mùi hôi giày PenGuin; Nhập khẩu Malaysia, diệt vi khuẩn và nấm mốc trong giày",51000,68000,17000,25
TIKI,giay-dep-nu,171202931,"Giày sandal 4 dây quai ngang phối chéo Giavy SL524",198000,198000,0,0
TIKI,may-anh,139078021,"Chai xịt tẩy trắng giày dép túi xách Plac - Chai xịt tẩy trắng ",6000,15000,9000,60
TIKI,may-anh,135370236,"Chai Làm Sạch Giày Dép Túi Xách, Lọ Xịt Chà Trắng Giày Dép",9998,9998,0,0
TIKI,may-anh,135852613,"Giày tây lười nam cao cấp, Giày lười da pu in vân nổi bật trẻ trung tăng chiều cao đế cao su đúc - Mã DR01",199000,199000,0,0
TIKI,may-anh,193054679,"Giày thể thao nam, giày sneakers nam kẻ bo chun 2 màu C80",200000,200000,0,0
TIKI,giay-dep-nu,193054679,"Giày thể thao nam, giày sneakers nam kẻ bo chun 2 màu C80",200000,200000,0,0
TIKI,may-anh,177748957,"Giày Lười Nam Cao Da Bò Thật BIGGBEN Tăng Chiều Chiều Cao Thêm 6cm GM272",899000,1200000,301000,25
TIKI,giay-dep-nu,177748957,"Giày Lười Nam Cao Da Bò Thật BIGGBEN Tăng Chiều Chiều Cao Thêm 6cm GM272",899000,1200000,301000,25
TIKI,giay-dep-nu,141237392,"Giày Tây nam tăng chiều cao Đông Hải kiểu dáng Derby  thanh lịch da cao cấp đế 6cm cải thiện chiều cao - G0615",1980000,1980000,0,0
TIKI,may-anh,153792840,"Đón gót giày gỗ",44000,44000,0,0
TIKI,giay-dep-nu,97546164,"Giày Tây Nam Buộc Dây Bảo Hân Mã CS89",295000,590000,295000,50
TIKI,may-anh,17970831,"Lót giày da mộc êm chân hình chữ T Woly Galant - NK Đức",69000,69000,0,0
TIKI,may-anh,186232739,"Dép xỏ ngón nam da cá sấu màu đen chính hãng Trường Hải may viền chắc chắn DCS255",591000,699000,108000,15
TIKI,giay-dep-nu,13586787,"Lót giày tăng chiều cao eva nguyên bàn cao 3 cm (Màu Xám)",67000,67000,0,0
TIKI,may-anh,179546441," GIÀY TÂY NAM DA BÒ THẬT 100%, DONAVY GTN, HÀNG CÔNG TY CAO CẤP DOGTN",449000,850000,401000,47
TIKI,giay-dep-nu,15762316,"Sữa làm sạch và dưỡng đồ da Saphir Creme Universelle 150ml",360000,360000,0,0
TIKI,may-anh,141245183,"Dép bít mũi nam da bò thật BIGGBEN cao cấp SB108",459000,600000,141000,24
TIKI,giay-dep-nu,202708835,"Giày thể thao nam cổ cao GNC-T22-BL, giày thể thao thoáng khí phong cách hàn quốc",299000,299000,0,0
TIKI,may-anh,13980705,"Giày Mọi Nam BIGGBEN Da Bò Thật Cao Cấp GM159",549000,720000,171000,24
TIKI,giay-dep-nu,50694122,"Bọt vệ sinh giày đa năng, sneaker + tặng kèm  bản chải đánh giày",120000,120000,0,0
TIKI,giay-dep-nu,141245183,"Dép bít mũi nam da bò thật BIGGBEN cao cấp SB108",459000,600000,141000,24
TIKI,giay-dep-nu,111092834,"Chai xịt khử mùi hôi giày PenGuin; Nhập khẩu Malaysia, diệt vi khuẩn và nấm mốc trong giày",51000,68000,17000,25
TIKI,may-anh,197618496,"Giày Sneaker Nam Vải Canvas DINCOX E06 Blue Đơn Giản Tinh Tế Sang Trọng",442000,442000,0,0
TIKI,giay-dep-nu,186232739,"Dép xỏ ngón nam da cá sấu màu đen chính hãng Trường Hải may viền chắc chắn DCS255",591000,699000,108000,15
TIKI,may-anh,13360653,"Giày Da Nam BH002",450000,900000,450000,50
TIKI,giay-dep-nu,191592703,"Dép da bò đế trấu, Sandal da bò sáp, may thủ công Lucas Shoes, bảo hành 6 tháng",375000,375000,0,0
TIKI,giay-dep-nu,98039876,"Giày Thể Thao Nam Màu Đen Đế Cao Su Non Đúc",160000,169990,9990,6
TIKI,giay-dep-nu,168587075,"Giày thể thao sneaker nam cổ thấp, giày đế tăng chiều cao mẫu mới k1",155000,155000,0,0
TIKI,giay-dep-nu,146414112,"Giày quai nang nam, dép quai hậu nam đẹp phong cách thời trang Hàn Quốc mã DEP11LE",159000,299000,140000,47
TIKI,may-anh,13883504,"Giày sneaker TMN05404",1400000,1400000,0,0
TIKI,giay-dep-nu,13883504,"Giày sneaker TMN05404",1400000,1400000,0,0
TIKI,giay-dep-nu,191592535,"Giày da nam Boat Shoes Xám da bò sáp cao cấp Hanmade, Lucas Shoes, Bảo hành 1 năm",659000,659000,0,0
TIKI,giay-dep-nu,272384051,"Giày Sục Nam S92 Da Bò Thật Sục nam trẻ trung năng động Màu Đen Giày hở gót da mềm mại Bảo Hành 12 Tháng",392000,392000,0,0
TIKI,may-anh,168587075,"Giày thể thao sneaker nam cổ thấp, giày đế tăng chiều cao mẫu mới k1",155000,155000,0,0
TIKI,may-anh,272384051,"Giày Sục Nam S92 Da Bò Thật Sục nam trẻ trung năng động Màu Đen Giày hở gót da mềm mại Bảo Hành 12 Tháng",392000,392000,0,0
TIKI,may-anh,102796815," Giày thể thao nam, giày sneaker nam độn đế mới nhất HOT 2021",169000,169000,0,0
TIKI,giay-dep-nu,179546441," GIÀY TÂY NAM DA BÒ THẬT 100%, DONAVY GTN, HÀNG CÔNG TY CAO CẤP DOGTN",449000,850000,401000,47
TIKI,may-anh,15762316,"Sữa làm sạch và dưỡng đồ da Saphir Creme Universelle 150ml",360000,360000,0,0
TIKI,giay-dep-nu,88081802," Giày thể thao nam, giày nam da lộn 2801",200000,200000,0,0
TIKI,giay-dep-nu,17970831,"Lót giày da mộc êm chân hình chữ T Woly Galant - NK Đức",69000,69000,0,0
TIKI,may-anh,148717398,"Máy đánh bóng giày dép công suất cao Bóng Đẹp Như Mới",222000,222000,0,0
TIKI,may-anh,146414112,"Giày quai nang nam, dép quai hậu nam đẹp phong cách thời trang Hàn Quốc mã DEP11LE",159000,299000,140000,47
TIKI,may-anh,191592535,"Giày da nam Boat Shoes Xám da bò sáp cao cấp Hanmade, Lucas Shoes, Bảo hành 1 năm",659000,659000,0,0
TIKI,giay-dep-nu,135370236,"Chai Làm Sạch Giày Dép Túi Xách, Lọ Xịt Chà Trắng Giày Dép",9998,9998,0,0
TIKI,giay-dep-nu,197618496,"Giày Sneaker Nam Vải Canvas DINCOX E06 Blue Đơn Giản Tinh Tế Sang Trọng",442000,442000,0,0
TIKI,giay-dep-nu,73820375,"Giày Sneaker thể thao nam buộc dây, đế cao su nguyên khối, đế nén khí đàn hồi G147",157000,176000,19000,11
TIKI,may-anh,73820375,"Giày Sneaker thể thao nam buộc dây, đế cao su nguyên khối, đế nén khí đàn hồi G147",157000,176000,19000,11
TIKI,may-anh,98039876,"Giày Thể Thao Nam Màu Đen Đế Cao Su Non Đúc",160000,169990,9990,6
TIKI,may-anh,178958545,"Giày Sneaker nam da thật màu trắng cao cấp NEW 2022",189000,189000,0,0
TIKI,giay-dep-nu,156216180,"GIÀY LƯỜI NAM DA BÒ THẬT 100% KHÂU ĐẾ CHẮC CHẮN BAO ĐI NƯỚC",500000,500000,0,0
TIKI,giay-dep-nu,139078021,"Chai xịt tẩy trắng giày dép túi xách Plac - Chai xịt tẩy trắng ",6000,15000,9000,60
TIKI,giay-dep-nu,192889107,"Sticker nhựa jibbitz unisex Crocs Beer",145000,145000,0,0
TIKI,giay-dep-nu,13360653,"Giày Da Nam BH002",450000,900000,450000,50
TIKI,may-anh,191592703,"Dép da bò đế trấu, Sandal da bò sáp, may thủ công Lucas Shoes, bảo hành 6 tháng",375000,375000,0,0
TIKI,may-anh,156216180,"GIÀY LƯỜI NAM DA BÒ THẬT 100% KHÂU ĐẾ CHẮC CHẮN BAO ĐI NƯỚC",500000,500000,0,0
TIKI,giay-dep-nu,135852613,"Giày tây lười nam cao cấp, Giày lười da pu in vân nổi bật trẻ trung tăng chiều cao đế cao su đúc - Mã DR01",199000,199000,0,0
TIKI,may-anh,183544565,"Giày Lười Nam Penny Loafer George TMN22801",2890000,2890000,0,0
TIKI,giay-dep-nu,13980705,"Giày Mọi Nam BIGGBEN Da Bò Thật Cao Cấp GM159",549000,720000,171000,24
TIKI,giay-dep-nu,102796815," Giày thể thao nam, giày sneaker nam độn đế mới nhất HOT 2021",169000,169000,0,0
TIKI,giay-dep-nu,153792840,"Đón gót giày gỗ",44000,44000,0,0
TIKI,giay-dep-nu,192450907,"GIÀY BOOTS COLE HAAN NAM ZERØGRAND OMNI CITY BOOT WP C34238",2190000,5490000,3300000,60
TIKI,giay-dep-nu,183544565,"Giày Lười Nam Penny Loafer George TMN22801",2890000,2890000,0,0
TIKI,giay-dep-nu,178958545,"Giày Sneaker nam da thật màu trắng cao cấp NEW 2022",189000,189000,0,0
TIKI,giay-dep-nu,189233352,"Dép Hai Quai Ngang Nam KEEDO-KD1705 Full hộp siêu bền",480000,480000,0,0
TIKI,may-anh,72770419,"Giày cao cổ nam g12",650000,650000,0,0
TIKI,may-anh,202708835,"Giày thể thao nam cổ cao GNC-T22-BL, giày thể thao thoáng khí phong cách hàn quốc",299000,299000,0,0
TIKI,giay-dep-nu,72770419,"Giày cao cổ nam g12",650000,650000,0,0
TIKI,giay-dep-nu,125244241,"Giày nam công sở phong cách lịch lãm, Giày da nam cao cấp chất liệu da bò pu in vân nổi bật đế cao su đúc - Mã GEA01",210000,210000,0,0
TIKI,may-anh,125244241,"Giày nam công sở phong cách lịch lãm, Giày da nam cao cấp chất liệu da bò pu in vân nổi bật đế cao su đúc - Mã GEA01",210000,210000,0,0
TIKI,may-anh,192450907,"GIÀY BOOTS COLE HAAN NAM ZERØGRAND OMNI CITY BOOT WP C34238",2190000,5490000,3300000,60
TIKI,may-anh,189233352,"Dép Hai Quai Ngang Nam KEEDO-KD1705 Full hộp siêu bền",480000,480000,0,0
TIKI,giay-dep-nu,148717398,"Máy đánh bóng giày dép công suất cao Bóng Đẹp Như Mới",222000,222000,0,0
TIKI,may-anh,88081802," Giày thể thao nam, giày nam da lộn 2801",200000,200000,0,0
TIKI,may-anh,13586787,"Lót giày tăng chiều cao eva nguyên bàn cao 3 cm (Màu Xám)",67000,67000,0,0
TIKI,phu-kien-thoi-trang,163572502,"Thắt lưng da nam cao cấp- dây nịt da bò 2 lớp EMRENEW -Full hộp đựng cao cấp",290000,580000,290000,50
TIKI,phu-kien-thoi-trang,175432446,"[COMBO 5 ĐÔI] Vớ Nữ Cổ Ngắn Vintage, Tất Nữ Cổ Ngắn Cute sử dụng cả tuần - CB069",29000,50000,21000,42
TIKI,phu-kien-thoi-trang,163572598,"Thắt lưng da nam cao cấp- dây nịt da bò 2 lớp EMRENEW -Full hộp đựng cao cấp",290000,580000,290000,50
TIKI,phu-kien-thoi-trang,16621985,"Bộ găng tay chống nắng xỏ ngón",13000,13000,0,0
TIKI,phu-kien-thoi-trang,57941013,"Mắt kính mát thời trang nữ chống tia UV. Bộ kèm hộp đựng kính và khăn lau kính.",169000,169000,0,0
TIKI,phu-kien-thoi-trang,74384808,"Thắt Lưng Nam Da Lộn Bảng Lớn 4cm Cá Tính Khóa Đồng Đúc Nguyên Khối Nguyen Leather + Đục Lỗ Cài",550000,550000,0,0
TIKI,phu-kien-thoi-trang,116019075,"Vớ nữ cổ ngắn Vintage, Tất nữ sử dụng cả tuần",29000,50000,21000,42
TIKI,phu-kien-thoi-trang,192360614,"Dây đeo khẩu trang chống thất lạc màu sắc thời trang cho nữ",27000,27000,0,0
TIKI,phu-kien-thoi-trang,165704958,"Tất, vớ màu xanh rêu ( màu xanh công an, màu xanh bộ đội )",25000,25000,0,0
TIKI,phu-kien-thoi-trang,173617008,"Combo 5 khẩu trang vải 3 lớp kháng khuẩn May 10 họa tiết trẻ trung, hiện đại",20000,20000,0,0
TIKI,phu-kien-thoi-trang,174376472,"Thắt Lưng Dây Nịt Nam Khóa Kim Đơn Giản Hot Thời Trang Hàn Quốc Thời Thắt Lưng Nam Thắt Lưng  DT100",50000,70000,20000,29
TIKI,phu-kien-thoi-trang,160299898,"Nón bucket vải nhung tăm - mũ tai bèo Ulzzang Unisex nam nữ phong cách thời trang, cá tính",38800,38800,0,0
TIKI,phu-kien-thoi-trang,170507394,"SET 3 Chiếc Khẩu Trang Vải Y Tế Kháng Khuẩn Cao Cấp BADBIRD 3 Lớp 4 Tính Năng, Antibacterial Mask, Thương hiệu Việt",122000,135000,13000,10
TIKI,phu-kien-thoi-trang,141472642,"Mũ lưỡi trai - nón chống nắng chữ M unisex nam nữ phong cách thời trang, cá tính",49500,99000,49500,50
TIKI,phu-kien-thoi-trang,44184176,"Mắt kính mát V tây ulzzang hot trend nhiều màu",34000,50000,16000,32
TIKI,phu-kien-thoi-trang,140949115,"Kẹp búi tóc, kẹp quấn tóc dẻo củ tỏi đa năng, kẹp tóc đính hoa - ngọc hot trend style Hàn Quốc cho nữ - Culi.accessories",31900,31900,0,0
TIKI,phu-kien-thoi-trang,164021643,"Kính Mát Thời Trang Nam Nữ, Mắt Kính Vuông Thời Thượng, Tròng Kính Phân Cực Chống Loá Chống Chói AK029 AORON",150000,180000,30000,17
TIKI,phu-kien-thoi-trang,4562049,"Tất Vớ nam cổ trung Cotton M201 kháng khuẩn khử mùi. Trắng, Đen, Xanh đen, Xám",20000,36000,16000,44
TIKI,phu-kien-thoi-trang,56262370,"Thắt Lưng Nữ Khóa Kim Loại Tròn TL002 MayHomes, Dây Lưng Nữ, Dây Nịt Nữ Mặt Tròn Chất Liệu Da PU Bền Đẹp",56050,59000,2950,5
TIKI,phu-kien-thoi-trang,69927219,"Gọng kính, mắt kính LD2408-LD2412 (55-17-148)",450000,450000,0,0
TIKI,phu-kien-thoi-trang,154163089,"Thắt lưng nam da bò cao cấp khóa tự động NUTUSHOP TH02",320000,320000,0,0
TIKI,phu-kien-thoi-trang,91969820," Thanh búi tóc, kẹp cài búi tóc đính hoa style Hàn Quốc siêu xinh",31900,31900,0,0
TIKI,phu-kien-thoi-trang,168946130,"Combo 5 đôi Vớ nam công sở chất liệu sợi Modal",200000,200000,0,0
TIKI,phu-kien-thoi-trang,186350307,"Kẹp búi tóc tròn đính đá cực đẹp Kiểu Hàn Quốc sang trọng lấp lánh",37620,38000,380,1
TIKI,phu-kien-thoi-trang,189737740,"Tất Dài Trên Đùi Co Giãn Nhiều Màu Độc Đáo Chất Lượng Cao Vớ Siêu Cao Cổ Vintage Cho Nữ",14000,14000,0,0
TIKI,phu-kien-thoi-trang,184468806,"Tất Vớ  Trắng Đen Thể Thao Cổ Ngắn, Cổ Trung, Cổ Cao Nam Nữ Vải Dệt Kim HBH",9000,9000,0,0
TIKI,phu-kien-thoi-trang,167605963,"Kẹp Tóc Càng Cua 5 Răng",14000,14950,950,6
TIKI,phu-kien-thoi-trang,89662185,"Combo 2 ghim cài quần điều chỉnh eo - ghim cài áo",32000,32000,0,0
TIKI,phu-kien-thoi-trang,75600980,"Thắt Lưng Nữ Da Thật Mặt Oval Aaa Jeans",299000,299000,0,0
TIKI,phu-kien-thoi-trang,46118172,"THẮT LƯNG NỮ , DÂY NỊT NỮ ĐẸP CAO CẤP MANG ĐẦM VÁY DN19122711",83600,88000,4400,5
TIKI,phu-kien-thoi-trang,127346858,"Khẩu Trang Vải 3D Chống Ô Nhiễm Bụi Mịn, chống Nắng Công Nghệ NHẬT BẢN,khẩu trang chống tia uv,khẩu trang vải su co giãn 4 chiều tao cảm giác thoải mái khi sủ dụng",15000,15000,0,0
TIKI,phu-kien-thoi-trang,72659361,"Set 3 kẹp càng cua kèm 2 dây buộc tóc xoắn đính hạt hàn quốc",25900,25900,0,0
TIKI,phu-kien-thoi-trang,124248461,"Kính viễn thị lão thị đọc sách , đi đường đủ số gọng nhựa giá rẻ",39000,39000,0,0
TIKI,phu-kien-thoi-trang,172939030,"GOTI - Set Ghim Cài Áo Hình Hoa Cao Cấp Sang Trọng Kiểu Charm Trang Trí Váy Đầm Dành Cho Nữ  - Ghim Cài Áo Cao Cấp SET05",6000,9000,3000,33
TIKI,phu-kien-thoi-trang,73778565,"Hộp 5 Đôi Tất Nam Cổ Ngắn, Vớ Nam Cổ Ngắn Chống Hôi TK Chính Hãng Laceva Mix Màu Mã PK03",59000,59000,0,0
TIKI,phu-kien-thoi-trang,197892646,"Khẩu trang y tế 4 lớp 5D MASK FAMAPRO NAM ANH kháng khuẩn cao cấp hộp 10 chiếc siêu vừa vặn, Không bí thở",16000,20000,4000,20
TIKI,phu-kien-thoi-trang,193368267,"Nón lưỡi trai fom mềm thêu logo nhỏ vải xịn chất rất đẹp",300000,300000,0,0
TIKI,phu-kien-thoi-trang,84547035,"Thắt lưng nam, dây nịt da đen trơn D&D Fashion",55000,110000,55000,50
TIKI,phu-kien-thoi-trang,168964983,"Vớ cổ cao nam nữ basic gân tâm thoáng khí, đi mát, êm chân  - LISU-TRONCAO-GANTAM",19900,35000,15100,43
TIKI,phu-kien-thoi-trang,182774290,"Tất Thể Thao Nam Nữ GOMTAT Cao Cấp, Vớ Thể Thao Cổ Ngắn Có Lớp Đệm Nút Cotton Thoải Mái Êm Chân - GOM501-THETHAO",39000,70000,31000,44
TIKI,may-anh,48930886,"Miếng lót cho giày rộng V.11 miếng lót giảm size giày cho giày rộng - Màu kem",15000,15000,0,0
TIKI,may-anh,153515458,"Dép chiếu mang trong nhà Hương Quế",68000,68000,0,0
TIKI,may-anh,207024183,"Giầy Thể Thao nữ B9811 Thiết Kế Kiểu Lưới Kín",299000,299000,0,0
TIKI,may-anh,138822114,"MỘT ĐÔI MIẾNG LÓT ĐỆM ÊM MŨI GIÀY, GUỐC CHO NỮ",18000,18000,0,0
TIKI,may-anh,57711487,"Dép đi trong nhà massage MT10 ( xanh cô ban)",89000,89000,0,0
TIKI,may-anh,15879754,"Chai xịt vệ sinh tẩy trắng giày dép  - Xi đánh giày không màu - Phụ kiện thời trang",99000,99000,0,0
TIKI,may-anh,127379464,"Xịt Khử Mùi Hôi Chuyện Dụng Chính Hãng Dincox X Matteo",60000,60000,0,0
TIKI,may-anh,11782941,"Giày đế xuồng phối ren nữ cao cấp Kem, Đen 9 phân full size full box có ảnh thật Size 35 đến 40 V68",119000,119000,0,0
TIKI,may-anh,153411908,"[Dép nữ][GDSG11] Dép đi trong nhà cực kỳ xinh xắn, Dép trong nhà kẻ sọc [Ảnh thật",46000,46000,0,0
TIKI,may-anh,132820926,"Miếng dán gót giày chống trầy chân silicon trong",10000,10000,0,0
TIKI,may-anh,191500752,"Giày sandal nữ cao gót 7 phân hàng hiệu rosata hai màu đen kem ro418",430000,430000,0,0
TIKI,may-anh,197516391,"COMBO 4 Miếng Đệm Gel Lót Giày Tăng Chiều Cao Hamart Tuyệt Đỉnh Êm Ái Thoải Mái Gấp 4 Lần",41000,90000,49000,54
TIKI,may-anh,8641346,"Bộ 1 cặp lót giày tăng chiều cao gel nửa bàn 2 lớp (cao 4cm)",30600,30600,0,0
TIKI,may-anh,137673823,"Combo 4 miếng lót giày AIR có đệm khí siêu êm ái GIÀY ĐỘN giày cao độn gót",39000,39000,0,0
TIKI,may-anh,52252644,"Lót độn đế silicon nguyên khối trong suốt tăng 1cm, 2cm, 3cm chiều cao - buybox - BBPK47",65000,120000,55000,46
TIKI,may-anh,126092809,"Dép Đế Trấu Nữ Quai Chéo Detaunisex Màu Trắng - DETA23T",300000,300000,0,0
TIKI,may-anh,125021600,"( HÀNG SẴN) Giày Vải Lười Tăng Chiều Cao Phong Cách Châu Âu AG38 - Hàng Quảng Châu Cao Cấp",325000,325000,0,0
TIKI,may-anh,107801853,"Cặp Lót Gót Giày XIMO XC01X Bảo vệ Gót Giày Khỏi Trầy Xước, Chống Nhấc Và Đau Gót",12000,18000,6000,33
TIKI,may-anh,50449568,"Giày lười nhựa nữ đi mưa đi biển V163",51000,51000,0,0
TIKI,may-anh,96011452,"Giày nhựa nữ đi mưa thời trang, giày y tá nữ siêu êm",59000,59000,0,0
TIKI,may-anh,125098644,"Giày lười nữ Anh Khoa A993",199000,199000,0,0
TIKI,may-anh,57712064,"Dép đi trong nhà massage huyệt đạo MT1 (TÍM)",89000,89000,0,0
TIKI,may-anh,126122201,"Giày Đế Trấu Xỏ Ngón Sandal Quai Hậu Nữ Detaunisex Màu Trắng - SATA22T",350000,350000,0,0
TIKI,may-anh,168105736,"Chai xịt khử mùi mũ bảo hiểm, giày dép Hando 120ml",26000,26000,0,0
TIKI,may-anh,85137283,"Giày quai ngang nữ giày sandals nữ dép quai hậu nữ cao 2.5 cm-  MÃ 588-61",299000,399000,100000,25
TIKI,may-anh,2601613,"Bộ 3 chai xịt khử mùi giày dép, mũ bảo hiểm 120ml Hando",68000,68000,0,0
TIKI,may-anh,116623618,"Dép Có Lỗ đi trong nhà tắm / đi trong văn phòng siêu êm siêu thoáng TL02",25000,25000,0,0
TIKI,may-anh,163911947,"Combo 10 đôi dép xốp cho khách sạn,nhà nghỉ màu trắng , xanh, đen",112500,112500,0,0
TIKI,may-anh,48995625,"Dép lỗ táo đi trong nhà, nhà tắm nâu",22000,22000,0,0
TIKI,may-anh,177553640,"Combo 2 Miếng lót gót giầy hình bướm có keo dán vào giầy  21165 - kaki",38000,65145,27145,42
TIKI,may-anh,244750140,"WAO Fashion - Giày Sandal nữ xỏ ngón dây mảnh thời trang cao 5cm - WC01",159000,159000,0,0
TIKI,may-anh,56747495,"Giày sandal nữ TRƯỜNG HẢI thời trang cao cấp đế kếp siêu nhẹ XDN0159",236000,279000,43000,15
TIKI,may-anh,195465015,"Cặp Miếng mút lót mũi giày êm chân cho giày cao gót , giày bị chật, bị rộng, giảm đau ngón chân cho giày chật #lot38",35000,35000,0,0
TIKI,may-anh,160887203,"[Loại Tốt] Chai Tẩy Trắng Vết Dơ - Ố Vàng - Ẩm Mốc Giày Dép KhoNCC Hàng Chính Hãng - Nhanh Chóng và Hiệu Quả Tức Thì",15000,25000,10000,40
TIKI,may-anh,2600431,"Chai xịt khử mùi giày dép, mũ bảo hiểm 120ml Hando",25000,25000,0,0
TIKI,may-anh,244691260,"WAO Fashion - Giày sandal cao gót nữ mũi vuông quai nhún cao 4cm - WA01",139000,139000,0,0
TIKI,may-anh,55863950,"Sandal trơn (Tặng kèm kẹp tóc ngẫu nghiên)",170000,170000,0,0
TIKI,may-anh,19761110,"Dán Gót Giày Chống Phồng Rộp Chân Lót Cho Giày Rộng",14500,14500,0,0
TIKI,may-anh,263041569,"Dép lê nam nữ đi trong nhà thêu hoạt tiết Vintage Hàn Quốc , Dép văn phòng vải lanh chống trơn trượt TA.Kẻ Hoa 96",48000,48000,0,0
TIKI,may-anh,115715354,"Giày bata đế bằng thiết kế meow cho nữ dáng thể thao",129000,129000,0,0
TIKI,giay-dep-nu,83193759,"Giày Sneaker  Tomoyo Nữ Da Microfiber TMW20501",699000,699000,0,0
TIKI,giay-dep-nu,187313016,"Lót gót chân chất liệu EVA ép hạt silicone cao cấp giúp giảm size, bảo vệ gót chân có keo dán cố định - Buybox - BBPK208",52000,96000,44000,46
TIKI,giay-dep-nu,49260363,"Set 2 miếng lót mũi giày silicon , lót giày cao gót massage bàn chân trước chống sốc, êm chân, chống trơn trượt",15000,15000,0,0
TIKI,giay-dep-nu,108842429,"Dép đế trấu nam nữ kẹp ngón màu Đen Detaunisex - DETA11D",199000,199000,0,0
TIKI,giay-dep-nu,59115500,"Cầu vai bảo vệ - Cầu vai cấp hiệu lực lượng bảo vệ - vệ sĩ chuyên nghiệp - cầu vai gắn áo bảo vệ ( nền xanh dương ,gạch đồng, viền vàng,nút đồng,có thêu bông lúa)",90000,90000,0,0
TIKI,giay-dep-nu,120169186,"COMBO 2 chiếc Đón gót giày bằng sừng nhỏ gọn, làm móc khóa hoặc để túi (DGH902) Cho giày Nam & Nữ",60000,60000,0,0
TIKI,giay-dep-nu,100262159,"Dép xỏ ngón cao gót bebe 5cm  dona21052102",65550,69000,3450,5
TIKI,giay-dep-nu,77875157,"Dép Lông Đi Trong Nhà Êm Chân Cao Cấp Hàn Quốc Cà Rốt NineRed M42",89000,89000,0,0
TIKI,giay-dep-nu,52240877,"Giày Thể Thao Nữ Biti's Hunter X DSWH02800HOG (Size",830000,902000,72000,8
TIKI,giay-dep-nu,148935410,"Giày Thể Thao Nữ Sneaker Siêu Nhẹ Chống trượt Mang Đi Làm,Chạy Bộ,Tập gym,Chơi Thể Thao SUNO GTTN14",256000,256000,0,0
TIKI,giay-dep-nu,125777196,"Dép bít nam nữ nhựa mềm 2051",80000,80000,0,0
TIKI,giay-dep-nu,127379023,"Giày Sneaker Vải Nữ DINCOX C20 Nữ Tính Sang Trọng Off/White",470000,470000,0,0
TIKI,giay-dep-nu,44590185,"Set 2 miếng độn giày silicon đệm khí êm chân 2 lớp, lót giày cả bàn tăng chiều cao 5cm siêu tiện ích, mã DG2L - màu ĐEN",46900,46900,0,0
TIKI,giay-dep-nu,73984369,"Giày thể thao nữ giày sneaker nữ màu trắng đế 3cm bằng da màu trắng hiệu ZAVAS - S387",339000,360000,21000,6
TIKI,giay-dep-nu,184769000,"Dép quai ngang nữ cao su hình BOY GIRL hot 2021",52250,55000,2750,5
TIKI,giay-dep-nu,40826513,"Dép thổ cẩm quai ngang truyền thống bằng chiếu quế mang trong nhà, văn phòng và du lịch - 39",107000,107000,0,0
TIKI,giay-dep-nu,39271997,"Dép  Nhựa Nam Nữ, Dép Đi Trong Nhà BGH Cao Cấp DN9855",45000,45000,0,0
TIKI,giay-dep-nu,191511012,"Giày nữ cao cấp ELLY – EGM117",1399000,1399000,0,0
TIKI,giay-dep-nu,198430922,"Dép Mang Trong Nhà ED1 Chống Trượt 3 Gạch-Hàng Chính Hãng",69000,75000,6000,8
TIKI,giay-dep-nu,117684998,"Miếng lót giày nam lót giày rộng lót gót giày giảm size chống rộng chống đau chân từ gót đến mũi bàn chân",59000,59000,0,0
TIKI,giay-dep-nu,177750603,"Giày sandal nữ da bò thật BIGGBEN cao cấp SDN73",339000,450000,111000,25
TIKI,giay-dep-nu,36979068,"Giày Sandal Nữ BIGGBEN Da Bò Thật SDN42 - 35",339000,450000,111000,25
TIKI,giay-dep-nu,54050939,"Giày Cao Gót 7cm Basic Mũi Nhọn Êm Chân Màu Đen X457",279000,279000,0,0
TIKI,giay-dep-nu,91030021,"Dép Cao Gót Nữ Da Bò BIGGBEN Cao 5 Phân DCG50",319000,400000,81000,20
TIKI,giay-dep-nu,58328906,"Giày nhựa đi mưa nữ 3p dáng công sở thời trang nhiều màu V251",54000,54000,0,0
TIKI,giay-dep-nu,101774291," Giày múa bale, giầy múa ballet (Size 34 -> 44)",38000,38000,0,0
TIKI,giay-dep-nu,177164437,"Giày Lười Nữ NATIVE AD Jericho",1400000,1400000,0,0
TIKI,giay-dep-nu,137847124,"Dép lê nữ nam đi trong nhà Hàn Quốc, Dép văn phòng siêu nhẹ, vải lanh, siêu êm chống trơn trượt TA.Caro",51600,51600,0,0
TIKI,giay-dep-nu,115263821,"Dép Thái Lan Quai Ngang Nữ  4.2 , Dép đi bộ, dép đi trong nhà",90000,90000,0,0
TIKI,giay-dep-nu,96075099,"Giày nhựa dẻo nhiều màu đi mưa, đi biển siêu bền - GN11",65000,65000,0,0
TIKI,giay-dep-nu,48995616,"Dép lỗ táo đi trong nhà, nhà tắm xanh",22000,22000,0,0
TIKI,giay-dep-nu,155370273,"Dây giày không cần buộc Sans944 thông minh co giãn bản tròn cột giày thể thao sneaker nam nữ nhiều màu đen trắng xám",29999,29999,0,0
TIKI,giay-dep-nu,52275306,"Giày Sandal Cao Gót BIGGBEN Da Bò Thật SDCG44",339000,500000,161000,32
TIKI,giay-dep-nu,1998767,"Giày Sandal Nữ Cao Gót Huy Hoàng HT7055 - Hồng Tím (Size",469000,469000,0,0
TIKI,giay-dep-nu,52240827,"Giày Sandal Nữ Đế Xuồng BIGGBEN Da Bò Thật SDX17",349000,400000,51000,13
TIKI,giay-dep-nu,36978601,"Giày Sandal Nữ BIGGBEN Da Bò Thật SDN40 - 35",339000,400000,61000,15
TIKI,giay-dep-nu,66494165,"Dép Nữ Cao Gót BIGGBEN Cao Cấp DCG39",309000,350000,41000,12
TIKI,giay-dep-nu,178323168,"DÉP LÊ QUAI NGANG NAM NỮ CHẤT LIỆU CAO SU HÌNH ĐỘNG VẬT DẼ THƯƠNG UNISEX",61750,65000,3250,5
TIKI,giay-dep-nu,20536328,"Giày sandal hở mũi kiểu khiêu vũ 3059",210000,210000,0,0
TIKI,giay-dep-nu,31716333,"2 cặp lót giày cao gót mũi nhọn giảm size cho giày bị rộng, thoáng khí và êm chân- buybox - BBPK55",64000,120000,56000,47
TIKI,dien-tu-dien-lanh,83193759,"Giày Sneaker  Tomoyo Nữ Da Microfiber TMW20501",699000,699000,0,0
TIKI,dien-tu-dien-lanh,187313016,"Lót gót chân chất liệu EVA ép hạt silicone cao cấp giúp giảm size, bảo vệ gót chân có keo dán cố định - Buybox - BBPK208",52000,96000,44000,46
TIKI,dien-tu-dien-lanh,49260363,"Set 2 miếng lót mũi giày silicon , lót giày cao gót massage bàn chân trước chống sốc, êm chân, chống trơn trượt",15000,15000,0,0
TIKI,dien-tu-dien-lanh,125777196,"Dép bít nam nữ nhựa mềm 2051",80000,80000,0,0
TIKI,dien-tu-dien-lanh,108842429,"Dép đế trấu nam nữ kẹp ngón màu Đen Detaunisex - DETA11D",199000,199000,0,0
TIKI,dien-tu-dien-lanh,59115500,"Cầu vai bảo vệ - Cầu vai cấp hiệu lực lượng bảo vệ - vệ sĩ chuyên nghiệp - cầu vai gắn áo bảo vệ ( nền xanh dương ,gạch đồng, viền vàng,nút đồng,có thêu bông lúa)",90000,90000,0,0
TIKI,dien-tu-dien-lanh,100262159,"Dép xỏ ngón cao gót bebe 5cm  dona21052102",65550,69000,3450,5
TIKI,dien-tu-dien-lanh,120169186,"COMBO 2 chiếc Đón gót giày bằng sừng nhỏ gọn, làm móc khóa hoặc để túi (DGH902) Cho giày Nam & Nữ",60000,60000,0,0
TIKI,dien-tu-dien-lanh,40826513,"Dép thổ cẩm quai ngang truyền thống bằng chiếu quế mang trong nhà, văn phòng và du lịch - 39",107000,107000,0,0
TIKI,dien-tu-dien-lanh,44590185,"Set 2 miếng độn giày silicon đệm khí êm chân 2 lớp, lót giày cả bàn tăng chiều cao 5cm siêu tiện ích, mã DG2L - màu ĐEN",46900,46900,0,0
TIKI,dien-tu-dien-lanh,52240877,"Giày Thể Thao Nữ Biti's Hunter X DSWH02800HOG (Size",830000,902000,72000,8
TIKI,dien-tu-dien-lanh,127379023,"Giày Sneaker Vải Nữ DINCOX C20 Nữ Tính Sang Trọng Off/White",470000,470000,0,0
TIKI,dien-tu-dien-lanh,54050939,"Giày Cao Gót 7cm Basic Mũi Nhọn Êm Chân Màu Đen X457",279000,279000,0,0
TIKI,dien-tu-dien-lanh,191511012,"Giày nữ cao cấp ELLY – EGM117",1399000,1399000,0,0
TIKI,dien-tu-dien-lanh,148935410,"Giày Thể Thao Nữ Sneaker Siêu Nhẹ Chống trượt Mang Đi Làm,Chạy Bộ,Tập gym,Chơi Thể Thao SUNO GTTN14",256000,256000,0,0
TIKI,dien-tu-dien-lanh,96075099,"Giày nhựa dẻo nhiều màu đi mưa, đi biển siêu bền - GN11",65000,65000,0,0
TIKI,dien-tu-dien-lanh,137847124,"Dép lê nữ nam đi trong nhà Hàn Quốc, Dép văn phòng siêu nhẹ, vải lanh, siêu êm chống trơn trượt TA.Caro",51600,51600,0,0
TIKI,dien-tu-dien-lanh,117684998,"Miếng lót giày nam lót giày rộng lót gót giày giảm size chống rộng chống đau chân từ gót đến mũi bàn chân",59000,59000,0,0
TIKI,dien-tu-dien-lanh,20536328,"Giày sandal hở mũi kiểu khiêu vũ 3059",210000,210000,0,0
TIKI,dien-tu-dien-lanh,31716333,"2 cặp lót giày cao gót mũi nhọn giảm size cho giày bị rộng, thoáng khí và êm chân- buybox - BBPK55",64000,120000,56000,47
TIKI,dien-tu-dien-lanh,178323168,"DÉP LÊ QUAI NGANG NAM NỮ CHẤT LIỆU CAO SU HÌNH ĐỘNG VẬT DẼ THƯƠNG UNISEX",61750,65000,3250,5
TIKI,dien-tu-dien-lanh,77875157,"Dép Lông Đi Trong Nhà Êm Chân Cao Cấp Hàn Quốc Cà Rốt NineRed M42",89000,89000,0,0
TIKI,dien-tu-dien-lanh,198430922,"Dép Mang Trong Nhà ED1 Chống Trượt 3 Gạch-Hàng Chính Hãng",69000,75000,6000,8
TIKI,dien-tu-dien-lanh,58328906,"Giày nhựa đi mưa nữ 3p dáng công sở thời trang nhiều màu V251",54000,54000,0,0
TIKI,dien-tu-dien-lanh,36978601,"Giày Sandal Nữ BIGGBEN Da Bò Thật SDN40 - 35",339000,400000,61000,15
TIKI,dien-tu-dien-lanh,155370273,"Dây giày không cần buộc Sans944 thông minh co giãn bản tròn cột giày thể thao sneaker nam nữ nhiều màu đen trắng xám",29999,29999,0,0
TIKI,dien-tu-dien-lanh,177164437,"Giày Lười Nữ NATIVE AD Jericho",1400000,1400000,0,0
TIKI,dien-tu-dien-lanh,48995616,"Dép lỗ táo đi trong nhà, nhà tắm xanh",22000,22000,0,0
TIKI,dien-tu-dien-lanh,73984369,"Giày thể thao nữ giày sneaker nữ màu trắng đế 3cm bằng da màu trắng hiệu ZAVAS - S387",339000,360000,21000,6
TIKI,dien-tu-dien-lanh,101774291," Giày múa bale, giầy múa ballet (Size 34 -> 44)",38000,38000,0,0
TIKI,dien-tu-dien-lanh,184769000,"Dép quai ngang nữ cao su hình BOY GIRL hot 2021",52250,55000,2750,5
TIKI,dien-tu-dien-lanh,36979068,"Giày Sandal Nữ BIGGBEN Da Bò Thật SDN42 - 35",339000,450000,111000,25
TIKI,dien-tu-dien-lanh,115263821,"Dép Thái Lan Quai Ngang Nữ  4.2 , Dép đi bộ, dép đi trong nhà",90000,90000,0,0
TIKI,dien-tu-dien-lanh,52275306,"Giày Sandal Cao Gót BIGGBEN Da Bò Thật SDCG44",339000,500000,161000,32
TIKI,dien-tu-dien-lanh,91030021,"Dép Cao Gót Nữ Da Bò BIGGBEN Cao 5 Phân DCG50",319000,400000,81000,20
TIKI,dien-tu-dien-lanh,66494165,"Dép Nữ Cao Gót BIGGBEN Cao Cấp DCG39",309000,350000,41000,12
TIKI,dien-tu-dien-lanh,52240827,"Giày Sandal Nữ Đế Xuồng BIGGBEN Da Bò Thật SDX17",349000,400000,51000,13
TIKI,dien-tu-dien-lanh,177750603,"Giày sandal nữ da bò thật BIGGBEN cao cấp SDN73",339000,450000,111000,25
TIKI,dien-tu-dien-lanh,39271997,"Dép  Nhựa Nam Nữ, Dép Đi Trong Nhà BGH Cao Cấp DN9855",45000,45000,0,0
TIKI,dien-tu-dien-lanh,1998767,"Giày Sandal Nữ Cao Gót Huy Hoàng HT7055 - Hồng Tím (Size",469000,469000,0,0
TIKI,giay-dep-nu,48930886,"Miếng lót cho giày rộng V.11 miếng lót giảm size giày cho giày rộng - Màu kem",15000,15000,0,0
TIKI,giay-dep-nu,153515458,"Dép chiếu mang trong nhà Hương Quế",68000,68000,0,0
TIKI,giay-dep-nu,207024183,"Giầy Thể Thao nữ B9811 Thiết Kế Kiểu Lưới Kín",299000,299000,0,0
TIKI,giay-dep-nu,138822114,"MỘT ĐÔI MIẾNG LÓT ĐỆM ÊM MŨI GIÀY, GUỐC CHO NỮ",18000,18000,0,0
TIKI,giay-dep-nu,15879754,"Chai xịt vệ sinh tẩy trắng giày dép  - Xi đánh giày không màu - Phụ kiện thời trang",99000,99000,0,0
TIKI,giay-dep-nu,57711487,"Dép đi trong nhà massage MT10 ( xanh cô ban)",89000,89000,0,0
TIKI,giay-dep-nu,127379464,"Xịt Khử Mùi Hôi Chuyện Dụng Chính Hãng Dincox X Matteo",60000,60000,0,0
TIKI,giay-dep-nu,52252644,"Lót độn đế silicon nguyên khối trong suốt tăng 1cm, 2cm, 3cm chiều cao - buybox - BBPK47",65000,120000,55000,46
TIKI,giay-dep-nu,191500752,"Giày sandal nữ cao gót 7 phân hàng hiệu rosata hai màu đen kem ro418",430000,430000,0,0
TIKI,giay-dep-nu,57712064,"Dép đi trong nhà massage huyệt đạo MT1 (TÍM)",89000,89000,0,0
TIKI,giay-dep-nu,107801853,"Cặp Lót Gót Giày XIMO XC01X Bảo vệ Gót Giày Khỏi Trầy Xước, Chống Nhấc Và Đau Gót",12000,18000,6000,33
TIKI,giay-dep-nu,50449568,"Giày lười nhựa nữ đi mưa đi biển V163",51000,51000,0,0
TIKI,giay-dep-nu,11782941,"Giày đế xuồng phối ren nữ cao cấp Kem, Đen 9 phân full size full box có ảnh thật Size 35 đến 40 V68",119000,119000,0,0
TIKI,giay-dep-nu,197516391,"COMBO 4 Miếng Đệm Gel Lót Giày Tăng Chiều Cao Hamart Tuyệt Đỉnh Êm Ái Thoải Mái Gấp 4 Lần",41000,90000,49000,54
TIKI,giay-dep-nu,126092809,"Dép Đế Trấu Nữ Quai Chéo Detaunisex Màu Trắng - DETA23T",300000,300000,0,0
TIKI,giay-dep-nu,168105736,"Chai xịt khử mùi mũ bảo hiểm, giày dép Hando 120ml",26000,26000,0,0
TIKI,giay-dep-nu,132820926,"Miếng dán gót giày chống trầy chân silicon trong",10000,10000,0,0
TIKI,giay-dep-nu,2601613,"Bộ 3 chai xịt khử mùi giày dép, mũ bảo hiểm 120ml Hando",68000,68000,0,0
TIKI,giay-dep-nu,56747495,"Giày sandal nữ TRƯỜNG HẢI thời trang cao cấp đế kếp siêu nhẹ XDN0159",236000,279000,43000,15
TIKI,giay-dep-nu,48995625,"Dép lỗ táo đi trong nhà, nhà tắm nâu",22000,22000,0,0
TIKI,giay-dep-nu,160887203,"[Loại Tốt] Chai Tẩy Trắng Vết Dơ - Ố Vàng - Ẩm Mốc Giày Dép KhoNCC Hàng Chính Hãng - Nhanh Chóng và Hiệu Quả Tức Thì",15000,25000,10000,40
TIKI,giay-dep-nu,8641346,"Bộ 1 cặp lót giày tăng chiều cao gel nửa bàn 2 lớp (cao 4cm)",30600,30600,0,0
TIKI,giay-dep-nu,126122201,"Giày Đế Trấu Xỏ Ngón Sandal Quai Hậu Nữ Detaunisex Màu Trắng - SATA22T",350000,350000,0,0
TIKI,giay-dep-nu,85137283,"Giày quai ngang nữ giày sandals nữ dép quai hậu nữ cao 2.5 cm-  MÃ 588-61",299000,399000,100000,25
TIKI,giay-dep-nu,125098644,"Giày lười nữ Anh Khoa A993",199000,199000,0,0
TIKI,giay-dep-nu,195465015,"Cặp Miếng mút lót mũi giày êm chân cho giày cao gót , giày bị chật, bị rộng, giảm đau ngón chân cho giày chật #lot38",35000,35000,0,0
TIKI,giay-dep-nu,96011452,"Giày nhựa nữ đi mưa thời trang, giày y tá nữ siêu êm",59000,59000,0,0
TIKI,giay-dep-nu,177553640,"Combo 2 Miếng lót gót giầy hình bướm có keo dán vào giầy  21165 - kaki",38000,65145,27145,42
TIKI,giay-dep-nu,2600431,"Chai xịt khử mùi giày dép, mũ bảo hiểm 120ml Hando",25000,25000,0,0
TIKI,giay-dep-nu,244691260,"WAO Fashion - Giày sandal cao gót nữ mũi vuông quai nhún cao 4cm - WA01",139000,139000,0,0
TIKI,giay-dep-nu,263041569,"Dép lê nam nữ đi trong nhà thêu hoạt tiết Vintage Hàn Quốc , Dép văn phòng vải lanh chống trơn trượt TA.Kẻ Hoa 96",48000,48000,0,0
TIKI,giay-dep-nu,163911947,"Combo 10 đôi dép xốp cho khách sạn,nhà nghỉ màu trắng , xanh, đen",112500,112500,0,0
TIKI,giay-dep-nu,19761110,"Dán Gót Giày Chống Phồng Rộp Chân Lót Cho Giày Rộng",14500,14500,0,0
TIKI,giay-dep-nu,153411908,"[Dép nữ][GDSG11] Dép đi trong nhà cực kỳ xinh xắn, Dép trong nhà kẻ sọc [Ảnh thật",46000,46000,0,0
TIKI,giay-dep-nu,244750140,"WAO Fashion - Giày Sandal nữ xỏ ngón dây mảnh thời trang cao 5cm - WC01",159000,159000,0,0
TIKI,giay-dep-nu,137673823,"Combo 4 miếng lót giày AIR có đệm khí siêu êm ái GIÀY ĐỘN giày cao độn gót",39000,39000,0,0
TIKI,giay-dep-nu,125021600,"( HÀNG SẴN) Giày Vải Lười Tăng Chiều Cao Phong Cách Châu Âu AG38 - Hàng Quảng Châu Cao Cấp",325000,325000,0,0
TIKI,giay-dep-nu,116623618,"Dép Có Lỗ đi trong nhà tắm / đi trong văn phòng siêu êm siêu thoáng TL02",25000,25000,0,0
TIKI,giay-dep-nu,55863950,"Sandal trơn (Tặng kèm kẹp tóc ngẫu nghiên)",170000,170000,0,0
TIKI,giay-dep-nu,115715354,"Giày bata đế bằng thiết kế meow cho nữ dáng thể thao",129000,129000,0,0
TIKI,phu-kien-thoi-trang,1998839,"Giày Nữ Đế Xuồng Huy Hoàng HT7066 - Đen (Size",489000,489000,0,0
TIKI,phu-kien-thoi-trang,14997019,"Dép nữ xỏ ngón -Dép kẹp đen đính bông da bò thật mềm mại  trường hải XN0014",196000,229000,33000,14
TIKI,phu-kien-thoi-trang,172979520,"TLG Dép Sandal Nam Nữ Hot Trend 2020 Quai Ngang 21406",228000,228000,0,0
TIKI,phu-kien-thoi-trang,23098538,"Giày thể thao da cao cấp siêu mềm siêu nhẹ chữ M",199000,199000,0,0
TIKI,phu-kien-thoi-trang,105274172,"Giày Sandal Cao Gót 3cm Quai Ngang Pixie X713",522000,522000,0,0
TIKI,phu-kien-thoi-trang,173238186,"Giày sandal cao gót Hoa giày công sở TL20198",311100,345900,34800,10
TIKI,phu-kien-thoi-trang,183912535,"Dép xuồng nữ 5 phân êm chân siêu bền đi mưa thoải mái V304",91000,91000,0,0
TIKI,phu-kien-thoi-trang,187605461,"GIÀY THỂ THAO CAO GÓT NỮ_TBG 64",669000,669000,0,0
TIKI,phu-kien-thoi-trang,6815081,"Combo miếng lót cho giày rộng V.2 Trong suốt (2 bộ / 4 miếng dán)",20000,20000,0,0
TIKI,phu-kien-thoi-trang,52250860,"Dép Nữ Đế Xuồng BIGGBEN Da Bò Thật DX22",329000,400000,71000,18
TIKI,phu-kien-thoi-trang,161938775,"Giày cao gót bít mũi 7p phân trong suốt Đen",119000,119000,0,0
TIKI,phu-kien-thoi-trang,95211921,"Sandal Bitis nữ",330000,330000,0,0
TIKI,phu-kien-thoi-trang,205803176,"Giày cao gót nữ 8p RO470 ROSATA tại BCASHOP bít mũi, gót trụ tròn quai cài ôm cổ chân - màu trắng kem",449000,449000,0,0
TIKI,phu-kien-thoi-trang,171202520,"Dép nữ Giavy đế xốp quai ngang M12",180000,180000,0,0
TIKI,phu-kien-thoi-trang,44806125,"Dép đi trong nhà",149000,149000,0,0
TIKI,phu-kien-thoi-trang,171196923,"Giày cao gót xanh đen cao cấp 11cm",240000,240000,0,0
TIKI,phu-kien-thoi-trang,161393112,"Xịt khử mùi giày mùi dịu nhẹ, thơm mát, nhẹ nhàng, hương thơm dễ chịu 50ml CHONGIAY tại Hà Nội",60000,60000,0,0
TIKI,phu-kien-thoi-trang,15021162,"dép nữ xỏ ngón nâu da bò cao cấp mềm mại XN017",196000,229000,33000,14
TIKI,phu-kien-thoi-trang,176544079,"dép sục nhún cao su dẻo cao cấp đi mưa thoải mái",70000,70000,0,0
TIKI,phu-kien-thoi-trang,196382542,"HAVAIANAS - Dép nữ Slim Glitter Neon 4147111",799000,799000,0,0
TIKI,phu-kien-thoi-trang,70639908,"Dép đi trong nhà siêu mềm siêu nhẹ nam nữ size M Nội địa NHẬT BẢN",210000,210000,0,0
TIKI,phu-kien-thoi-trang,49485236,"GIÀY THỂ THAO NỮ SỐ 8 DÂY KÉO ĐEN",115000,115000,0,0
TIKI,phu-kien-thoi-trang,193053222,"Sandal cao gót nữ đế 6F",229000,229000,0,0
TIKI,phu-kien-thoi-trang,74181349,"Giày cao gót 7cm Trường Hải gót to da bóng màu đen thời trang cao cấp CG01280",256000,298999,42999,14
TIKI,phu-kien-thoi-trang,70937634,"Dép massage đi trong nhà Nachidu MT1-Màu CHANH",89000,89000,0,0
TIKI,phu-kien-thoi-trang,186211289,"Dép cao gót nữ đế 9F",249000,249000,0,0
TIKI,phu-kien-thoi-trang,125099089,"Giày nữ Anh Khoa A993-8",110000,110000,0,0
TIKI,phu-kien-thoi-trang,143858533,"Giày Cao Gót Quai Sau (Da Thật) Slingback - Da Siêu Mềm Mũi Nhọn FFAN STORE",470000,470000,0,0
TIKI,phu-kien-thoi-trang,52575315,"Giày Nữ Búp Bê Mũi Nhọn Đế Xuồng 7cm Enako TP13264",350000,350000,0,0
TIKI,phu-kien-thoi-trang,61278550,"Giày thể thao nữ hoa cúc đi bộ cực êm siêu xinh V253 - Hồng - Size 37",55000,55000,0,0
TIKI,phu-kien-thoi-trang,101058016,"Giày boot nữ cao cấp cổ thấp phong cách sành điệu 21204",277800,597800,320000,54
TIKI,phu-kien-thoi-trang,114253332,"Huy hiệu (Jibbitz) Crocs Peanuts Charlie Brown 10007402 - 1 cái",215000,215000,0,0
TIKI,phu-kien-thoi-trang,253629101,"Giày lười nữ vải mềm đế cao su êm chân cao 2cm",132000,149000,17000,11
TIKI,phu-kien-thoi-trang,22010630,"Giày Búp Bê Nữ 3cm Thời Trang Mũi Nhọn JUNO Da Trơn Khoét Eo BB03021",402000,402000,0,0
TIKI,phu-kien-thoi-trang,177663329,"Giày Cao Gót Nữ GEOX D Pheby 50 B",4600000,4600000,0,0
TIKI,phu-kien-thoi-trang,44573112,"Dép nữ Huy Hoàng màu đen HT7049",459000,459000,0,0
TIKI,phu-kien-thoi-trang,20121416,"Combo 2 bộ lót giày cao gót đệm êm chân chống trầy da do ma sát với giày chất liệu cứng - PK48",27000,27000,0,0
TIKI,phu-kien-thoi-trang,129352281,"Dép VENTO Nam/Nữ Quai Ngang Xuất Khẩu FL06 ( 2 Màu )",205000,205000,0,0
TIKI,phu-kien-thoi-trang,153839822,"Lót mũi giày su non đệm êm ngón chân, có tác dụng giảm đau cho ngón chân và giảm size giày bị rộng",19000,19000,0,0
TIKI,phu-kien-thoi-trang,90796927," MIẾNG DÁN ĐẾ GIÀY CHỐNG TRƠN TRỢT (MÀU ĐEN)",15000,15000,0,0
TIKI,phu-kien-thoi-trang,44381944,"kính màu gọng đen V",69000,90000,21000,23
TIKI,phu-kien-thoi-trang,59425731,"Mắt kính mát nữ DKY1886M tròng không viền, phân cực, chống tia UV. Gọng Polycarbonate ôm sát mặt",99000,99000,0,0
TIKI,phu-kien-thoi-trang,52420394,"Vỉ 6 kẹp tóc đủ màu mix đồ thêm cá tính ( giao mẫu ngẫu nhiên )",33900,33900,0,0
TIKI,phu-kien-thoi-trang,53832550,"Combo 3 Kep Tóc Mỏ Vịt Nhiều Màu Hàn Quốc Loại Xịn Cực Bền Siêu Đáng Yêu - Giao Mầu Ngẫu Nhien - MP130 ",20000,60000,40000,67
TIKI,phu-kien-thoi-trang,144333494,"Thùng 300 khẩu trang 4D Kf94 dc mask kháng khuẩn lọc bụi mịn cao cấp",300000,300000,0,0
TIKI,phu-kien-thoi-trang,80959586,"dây đeo khẩu trang, Dây đeo kính thời trang chống rơi rớt, 2 trong 1, dây hạt nhựa trắng sang trọng",50000,50000,0,0
TIKI,phu-kien-thoi-trang,52133939,"Sét 10 ghim cúc cài áo thời trang nhiều mẫu (GC110)",28000,28000,0,0
TIKI,phu-kien-thoi-trang,180852562,"Găng Tay Cụt Ngón Phản Quang Chạy Xe Đạp, Xe Máy Hatsu MCFK 0202 | Bao Tay Cụt Ngón Thể Thao, Phản Quang Cảnh Báo An Toàn Ban Đêm | Găng Tay Phượt Nam/Nữ - Theyanch Half-Finger Gloves",112000,118000,6000,5
TIKI,phu-kien-thoi-trang,83618489,"Khẩu trang ninja che kín mặt kín tai vải nỉ dán gáy chống nắng chống gió lạnh mùa đông - khau trang",15000,15000,0,0
TIKI,phu-kien-thoi-trang,190214480,"DÂY THUN CỘT TÓC Loại size nhỏ Co giãn Bịch 40g",8000,8000,0,0
TIKI,phu-kien-thoi-trang,162189812,"Tất nam nữ cổ lửng GOM TẤT coton 90% êm mềm đi mát, thiết kế thoáng khí - GOM-KLB-TRONLUNG",18900,33000,14100,43
TIKI,phu-kien-thoi-trang,216559156,"Kẹp càng cua - Kẹp tóc 3 răng đẹp cho nữ",14000,15000,1000,7
TIKI,phu-kien-thoi-trang,43039803,"Bộ 3 kẹp tóc kim loại xi vàng thiết kế phối ngọc trai giả sang trọng",7000,35000,28000,80
TIKI,phu-kien-thoi-trang,72903153,"Dây cột tóc scrunchies mới mẫu chữ",19000,20000,1000,5
TIKI,phu-kien-thoi-trang,108007738,"Dây thắt lưng nam dây nịt nam da bò Nutushop kích thước 3.5cm có răng cưa dùng cho khóa tự động (không đầu khóa)- NT15",164000,164000,0,0
TIKI,phu-kien-thoi-trang,138283056,"Thun cột tóc, Dây cột tóc nữ - nhiều mẫu xinh xắn - Culi accessories",20000,20000,0,0
TIKI,phu-kien-thoi-trang,17630777,"Găng tay chống nắng UV Aqua X (Màu xám)",15000,15000,0,0
TIKI,phu-kien-thoi-trang,88785595,"Hình xăm dán chống nước đa dạng chủ đều cho bé trai và bé gái thỏa thích sáng tạo cùng bạn bè – ST008",8000,12000,4000,33
TIKI,phu-kien-thoi-trang,135726384,"Găng Tay Bao Tay Len Hở Ngón Giữ Ấm Chống Nắng Phong Cách Đơn Giản Cho Nữ",55000,110000,55000,50
TIKI,phu-kien-thoi-trang,46644609,"Kính Mắt Chống Tia UV Từ Điện Thoại, Máy Tính, Chống Mỏi Mắt Gọng Đen - BLUE LIGHT SHOP",95000,100000,5000,5
TIKI,phu-kien-thoi-trang,115290336,"Kẹp Tóc Càng Cua Chữ Nhật Cặp Tóc Phụ Kiện Tóc Cao Cấp ( giao ngẫu nhiên )",6000,25000,19000,76
TIKI,phu-kien-thoi-trang,190588701,"Băng đô Rửa mặt Trang điểm Phụ Kiện tóc Hình Trái Tim Xinh Xắn Dày dặn Mềm mịn Co giãn tốt",32000,32000,0,0
TIKI,phu-kien-thoi-trang,167469163,"Cài Tóc Kim Loại Đơn Giản Cho Cả Nam Và Nữ",15000,15000,0,0
TIKI,phu-kien-thoi-trang,115124886,"Hộp 10 đôi tất nam siêu chống thối Nhật.tất nam cổ ngắn,vớ cổ cao",52000,52000,0,0
TIKI,phu-kien-thoi-trang,157125390,"Tất vớ trơn cổ cao cotton, tất cao cổ nam nữ cổ gân tâm Gom Tất - LISU-TRONCAO-GANTAM",19900,35000,15100,43
TIKI,phu-kien-thoi-trang,181782239,"Mũ Lưỡi Trai Nam Phong Cách, Mũ Mỏ Vịt Phong Cách Hàn Quốc Phù Hợp Với Mọi Lứa Tuổi, Mũ Beret Chất Liệu Vải Kaki Cao Cấp Có Thể Điều Chỉnh Size",123000,258000,135000,52
TIKI,phu-kien-thoi-trang,169641436,"MÓC GÀI TAI SILICON CHỐNG TRƯỢT KÍNH, VẬN ĐỘNG MẠNH",10000,14000,4000,29
TIKI,phu-kien-thoi-trang,71116729,"Dung Dịch Xịt Chống Hơi Nước Đọng Trên Mắt Kính 20ml",25000,25000,0,0
TIKI,phu-kien-thoi-trang,74548356,"Kẹp Tóc Càng Cua Đính Ngọc Trai Nhân Tạo Phong Cách Hồng Kông Thâp Niên 90s",28000,28000,0,0
TIKI,phu-kien-thoi-trang,76033315,"Combo 3 đôi Tất thể thao Redikick Cổ cao R365 Sợi Cotton Cao Cấp Vớ Nam Nữ Unisex có đệm Cushion Chống hôi chân, Thoáng khí, Thấm mồ hôi phù hợp chơi Bóng Rổ Bóng đá Bóng Chuyền Tennis Chạy Bộ Đá banh - Hàng Chính Hãng",140000,170000,30000,18
TIKI,phu-kien-thoi-trang,97257194,"Đinh Đục Lỗ Thắt Lưng Da 3.0mm Aaa Jeans",3500,3500,0,0
TIKI,phu-kien-thoi-trang,192346252,"Lens trong suốt cận Angel Eyes cho mắt nhạy cảm có độ cận từ 0 đến 15 độ",125000,125000,0,0
TIKI,phu-kien-thoi-trang,50885562,"KẸP GẤP TÓC 5 RĂNG NHÁM NHIỀU MÀU GIAO MÀU NGẪU NHIÊN",15000,15000,0,0
TIKI,phu-kien-thoi-trang,181804486,"Thắt Lưng Dây Nịt Nam Công Sở Da Bò 2 Lớp Khóa Tự Động Trẻ Trung Phong Cách Hàn DT112",65000,110000,45000,41
TIKI,phu-kien-thoi-trang,77199949,"Bộ sưu tập bờm cài tóc sắt nam nữ unisex dễ thương",7500,7500,0,0
TIKI,phu-kien-thoi-trang,103510468,"Kẹp càng cua 5 răng loại nhám",14000,15000,1000,7
TIKI,phu-kien-thoi-trang,83744816,"[Kẹp Tóc,Cột Tóc] Combo 20 Cái Kẹp Tóc Ngọc Màu Trắng - Hàng Chính Hãng",79000,99000,20000,20
TIKI,phu-kien-thoi-trang,1489333,"[Một cặp] Kính Áp Tròng Trong Suốt Dùng 3 Tháng Eye Secret KT3T (6 Độ)",180000,199000,19000,10
TIKI,phu-kien-thoi-trang,183544352,"Kính mát vuông nam nữ ROBEO - R0424 , phong cách cổ điển mắt chống tia uv - Fullbox",299000,450000,151000,34
TIKI,phu-kien-thoi-trang,111536259,"Dây đeo khẩu trang-mắt kinh combo gia đình ,mắc xích phong cách Hàn Quốc chống đau vành tai-thất lạc-rơi ,tiện dụng-thời trang",33000,39000,6000,15
TIKI,dien-tu-dien-lanh,27793913,"Ống Nhòm Một Mắt Siêu Nét Monocular 16x52 - Hàng Nhập Khẩu",115000,115000,0,0
TIKI,dien-tu-dien-lanh,5849479,"Chân Máy Ảnh Tripod Yunteng VCT-691 - Hàng Nhập Khẩu",512000,1200000,688000,57
TIKI,dien-tu-dien-lanh,46267732,"Camera hành trình ô tô f960x tích hợp Wifi GPS, cảnh báo làn đường, độ phân giải camera trước siêu nét Full HD 2304*1296P",2343000,2343000,0,0
TIKI,dien-tu-dien-lanh,109957482,"Balo máy ảnh Safrotto SM3032, thao tác nhanh - Hàng chính hãng",1999999,1999999,0,0
TIKI,dien-tu-dien-lanh,26429203,"10 Jack Nối dùng cho Camera giám sát",55000,55000,0,0
TIKI,dien-tu-dien-lanh,63162584,"Ống nhòm chống thấm nước Carson RD-042MO (10x42) (tìm ong rừng, ngắm chim) - Hàng chính hãng",7250000,7250000,0,0
TIKI,dien-tu-dien-lanh,109310320,"Dây đeo máy ảnh Peak Design (nhiều loại), Hàng chính hãng",449999,449999,0,0
TIKI,dien-tu-dien-lanh,194082865,"Camera Wifi Trong Nhà EZVIZ C6W 4MP 2K Quay Quét 355 độ Tích Hợp AI- Đàm thoại 2 chiều - Hàng Chính Hãng",1092500,1150000,57500,5
TIKI,dien-tu-dien-lanh,195523175,"Camera Di Động Kèm Màn Hình chăm sóc bé từ xa đo Nhiệt Độ - Báo khóc thông minh",2580000,2580000,0,0
TIKI,may-anh,27793913,"Ống Nhòm Một Mắt Siêu Nét Monocular 16x52 - Hàng Nhập Khẩu",115000,115000,0,0
TIKI,may-anh,46267732,"Camera hành trình ô tô f960x tích hợp Wifi GPS, cảnh báo làn đường, độ phân giải camera trước siêu nét Full HD 2304*1296P",2343000,2343000,0,0
TIKI,dien-tu-dien-lanh,5876257,"Kính lọc Filter Hoya HMC PL-Cir 77mm - Hàng nhập khẩu",999999,999999,0,0
TIKI,dien-tu-dien-lanh,197421523,"Camera quan sát Eufy Indoor 2K T8400 - Hàng chính hãng",979000,1190000,211000,18
TIKI,dien-tu-dien-lanh,8729404,"Combo Chân Máy Ảnh Tripod Yunteng VCT-668 + Remote Cho Máy Ảnh - Hàng Nhập Khẩu",469999,469999,0,0
TIKI,may-anh,5849479,"Chân Máy Ảnh Tripod Yunteng VCT-691 - Hàng Nhập Khẩu",512000,1200000,688000,57
TIKI,may-anh,109957482,"Balo máy ảnh Safrotto SM3032, thao tác nhanh - Hàng chính hãng",1999999,1999999,0,0
TIKI,dien-tu-dien-lanh,113627915,"Đầu ghi hình camera 4 kênh 2MP H.265+ AI-Coding Dahua DH-XVR1B04-I hàng chính hãng DSS Việt Nam",715000,715000,0,0
TIKI,may-anh,63162584,"Ống nhòm chống thấm nước Carson RD-042MO (10x42) (tìm ong rừng, ngắm chim) - Hàng chính hãng",7250000,7250000,0,0
TIKI,dien-tu-dien-lanh,25621506,"[Tặng remote chụp hình] Gậy Chụp hình Tripod 3110",67850,67850,0,0
TIKI,dien-tu-dien-lanh,126702214,"Điều khiển Điều Hòa dành cho DaiKin Loại ngắn,thường",64600,68000,3400,5
TIKI,may-anh,194082865,"Camera Wifi Trong Nhà EZVIZ C6W 4MP 2K Quay Quét 355 độ Tích Hợp AI- Đàm thoại 2 chiều - Hàng Chính Hãng",1092500,1150000,57500,5
TIKI,dien-tu-dien-lanh,160290342,"Tủ chống ẩm 100 lít Andbon AD-100S, Hàng chính hãng",3899999,3899999,0,0
TIKI,dien-tu-dien-lanh,190630682,"Túi vệ sinh máy lạnh 1m7 và 2m, đuôi dài 3m [HÀNG CHẤT LƯỢNG CAO",39000,39000,0,0
TIKI,may-anh,109310320,"Dây đeo máy ảnh Peak Design (nhiều loại), Hàng chính hãng",449999,449999,0,0
TIKI,dien-tu-dien-lanh,7263277,"Đèn Godox AD200 Pocket Fash TTL - Hàng nhập khẩu",5700000,5700000,0,0
TIKI,dien-tu-dien-lanh,123432496,"Thiết bị bảo vệ dành cho tủ lạnh, bảo vệ thiết bị lạnh",135000,135000,0,0
TIKI,dien-tu-dien-lanh,191475533,"Dây máy ảnh Peak Design Slide Lite Midnight (màu xanh tím than), Hàng chính hãng",1849999,1849999,0,0
TIKI,may-anh,26429203,"10 Jack Nối dùng cho Camera giám sát",55000,55000,0,0
TIKI,dien-tu-dien-lanh,119692556,"CÔNG TẮC CHO CỬA MÁY GIẶT ELECTROLUX EWF 85752, 85742, 10742, 10842, 12732, 12732S – HÀNG CHÍNH HÃNG",320000,320000,0,0
TIKI,may-anh,195523175,"Camera Di Động Kèm Màn Hình chăm sóc bé từ xa đo Nhiệt Độ - Báo khóc thông minh",2580000,2580000,0,0
TIKI,dien-tu-dien-lanh,82435104,"Máy Giặt AQUA 9.8 Kg AQD-AF980A (W) -hàng chính hãng- Chỉ giao tại Hà Nội",8690000,8690000,0,0
TIKI,dien-tu-dien-lanh,74240825,"Ống nhòm một mắt chống nước, chống sương mù Barska Blackhawk 10x40 WP - Hàng chính hãng",2420000,2420000,0,0
TIKI,dien-tu-dien-lanh,192202335,"MÁY RỬA CHÉN KAFF KF-S770TFTS (Màu Inox) KF-S770TFTB (Màu Đen) - Seri 2022 - Hàng Chính Hãng",24800000,24800000,0,0
TIKI,may-anh,197421523,"Camera quan sát Eufy Indoor 2K T8400 - Hàng chính hãng",979000,1190000,211000,18
TIKI,may-anh,5876257,"Kính lọc Filter Hoya HMC PL-Cir 77mm - Hàng nhập khẩu",999999,999999,0,0
TIKI,dien-tu-dien-lanh,155764379,"Camera IP 2mp có màu ban đêm Hikvision mã DS-2CD1027G0-L - Hàng Chính Hãng",1190000,1190000,0,0
TIKI,dien-tu-dien-lanh,71111373,"Android Tivi TCL 4K 55 inch 55P618",8690000,8690000,0,0
TIKI,dien-tu-dien-lanh,25919457,"(TẶNG KÈM THẺ NHỚ 16GB)CAMERA HÀNH TRÌNH FULL BỘ 3 MẮT",890000,890000,0,0
TIKI,may-anh,8729404,"Combo Chân Máy Ảnh Tripod Yunteng VCT-668 + Remote Cho Máy Ảnh - Hàng Nhập Khẩu",469999,469999,0,0
TIKI,may-anh,113627915,"Đầu ghi hình camera 4 kênh 2MP H.265+ AI-Coding Dahua DH-XVR1B04-I hàng chính hãng DSS Việt Nam",715000,715000,0,0
TIKI,dien-tu-dien-lanh,60815887,"Kệ chân để lọc nước có thể tùy chỉnh kích thước từ 30cm-40cm GNG",39000,89000,50000,56
TIKI,dien-tu-dien-lanh,113359107,"Ống nhòm cao cấp Swarovski Habicht 10 x 40W - Hàng chính hãng",31125000,31125000,0,0
TIKI,dien-tu-dien-lanh,109487629,"Chân máy ảnh kết hợp gậy chụp ảnh tự sướng Coman MT55, Hàng chính hãng",999999,999999,0,0
TIKI,dien-tu-dien-lanh,176289422,"[HCM] Máy Giặt Cửa Trước Electrolux EWF1142R7SB 11kg - Inverter - Hàng Chính Hãng",20990000,20990000,0,0
TIKI,dien-tu-dien-lanh,107711395,"Astra - Camera 3D Orbbec - Hàng chính Hãng",7740900,7740900,0,0
TIKI,may-anh,25621506,"[Tặng remote chụp hình] Gậy Chụp hình Tripod 3110",67850,67850,0,0
TIKI,dien-tu-dien-lanh,46184503,"Remote Điều Khiển Dành Cho TV LCD, TV LED SAMSUNG AA59-00602A (Kèm Pin AAA Maxell)",29900,29900,0,0
TIKI,may-anh,160290342,"Tủ chống ẩm 100 lít Andbon AD-100S, Hàng chính hãng",3899999,3899999,0,0
TIKI,dien-tu-dien-lanh,180992296,"Camera sau trên gương chiếu hậu Full 2K với màn hình cảm ứng 12 inch IPS Gương Dash Cam",2485000,2485000,0,0
TIKI,dien-tu-dien-lanh,157424564,"Điều khiển điều hoà Panasonic inverter 2 chiều",95000,95000,0,0
TIKI,dien-tu-dien-lanh,109862511,"Hộp chụp ảnh sản phẩm, lồng chụp ảnh (nhiều loại), Hàng nhập khẩu",1049999,1049999,0,0
TIKI,may-anh,7263277,"Đèn Godox AD200 Pocket Fash TTL - Hàng nhập khẩu",5700000,5700000,0,0
TIKI,dien-tu-dien-lanh,142852181,"Bộ điều khiển từ xa dành cho quạt trần và đèn (Hàng cao cấp)",93100,98000,4900,5
TIKI,dien-tu-dien-lanh,4727681,"Bộ Kích Đèn Trigger Yongnuo YN603 II Lẻ 1 Cục - Hàng Nhập Khẩu",344999,344999,0,0
TIKI,may-anh,191475533,"Dây máy ảnh Peak Design Slide Lite Midnight (màu xanh tím than), Hàng chính hãng",1849999,1849999,0,0
TIKI,dien-tu-dien-lanh,72954000,"Tấm Chắn Gió Điều Hòa - Tản Nhiệt Máy Lạnh - Thiết Kế Lỗ Nhỏ Tránh Gió Trực Tiếp Từ Điều Hòa - Xoay 180 độ - Chăm Sóc Sức Khỏe Gia Đình, nhựa pvc thân thiện môi trường",113000,113000,0,0
TIKI,may-anh,74240825,"Ống nhòm một mắt chống nước, chống sương mù Barska Blackhawk 10x40 WP - Hàng chính hãng",2420000,2420000,0,0
TIKI,dien-tu-dien-lanh,25479295,"ĐIỀU KHIỂN DÀNH CHO TIVI SONY RMT - TZ300A",35000,35000,0,0
TIKI,dien-tu-dien-lanh,101305987," Combo Soft box 70 x 50cm và chân đèn cao cho studio (có nhiều tùy chọn combo và tách lẻ)",89000,89000,0,0
TIKI,dien-tu-dien-lanh,195660650,"Smart Tivi NanoCell LG 4K 65 inch 65NANO76SQA - Model 2022",14800000,14800000,0,0
TIKI,may-anh,155764379,"Camera IP 2mp có màu ban đêm Hikvision mã DS-2CD1027G0-L - Hàng Chính Hãng",1190000,1190000,0,0
TIKI,dien-tu-dien-lanh,120444794,"Gậy Chống Rung Gimbal Stabilizer L08 - Có 3 Chân Đỡ - Nút Bấm Bluetooh Hàng Cao Cấp - Hàng Nhập Khẩu",400000,400000,0,0
TIKI,may-anh,25919457,"(TẶNG KÈM THẺ NHỚ 16GB)CAMERA HÀNH TRÌNH FULL BỘ 3 MẮT",890000,890000,0,0
TIKI,dien-tu-dien-lanh,126701879,"Remote điều khiển tivi dành cho Sony RM-ED047",50000,50000,0,0
TIKI,dien-tu-dien-lanh,126097755,"Camera Wifi PROLiNK PIC3003WP thông minh giá rẻ, siêu nét Full HD 1080P, góc nhìn rộng, âm thanh 2 chiều - Hàng chính hãng",629000,999000,370000,37
TIKI,dien-tu-dien-lanh,169277370,"GIÁ TREO TIVI ĐA NĂNG SP2 40-70 INCH",1190000,1190000,0,0
TIKI,may-anh,113359107,"Ống nhòm cao cấp Swarovski Habicht 10 x 40W - Hàng chính hãng",31125000,31125000,0,0
TIKI,dien-tu-dien-lanh,194123786,"Camera IP Wifi Ngoài Trời EZVIZ BC1C 2MP Tặng Kèm Tắm Pin Năng Lượng Tích Hợp Bộ Nhớ Trong 32G - Có Màu Ban Đêm - Đàm Thoại 2 Chiều - Hàng Chính Hãng",2270500,2390000,119500,5
TIKI,may-anh,109487629,"Chân máy ảnh kết hợp gậy chụp ảnh tự sướng Coman MT55, Hàng chính hãng",999999,999999,0,0
TIKI,dien-tu-dien-lanh,21327077,"Giá treo màn hình máy tính, tivi 14-27 inch đa năng xoay góc 180 độ nhập khẩu",190000,190000,0,0
TIKI,may-anh,107711395,"Astra - Camera 3D Orbbec - Hàng chính Hãng",7740900,7740900,0,0
TIKI,dien-tu-dien-lanh,272456536,"Băng dính chịu nhiệt 10mm x 33m, 15mm x 33m, 20mm x 33m, 25mm x 33m, 30mm x 33m",23000,23000,0,0
TIKI,dien-tu-dien-lanh,3597911,"Bộ Chân Máy Ảnh Bạch Tuộc Lớn Và Đầu Bi Chân Máy Ảnh Thân Kim Loại Q00160",159000,159000,0,0
TIKI,may-anh,180992296,"Camera sau trên gương chiếu hậu Full 2K với màn hình cảm ứng 12 inch IPS Gương Dash Cam",2485000,2485000,0,0
TIKI,dien-tu-dien-lanh,121259030,"Android Tivi TCL 43 inch L43S5200 model 2021- Hàng chính hãng- Chỉ giao tại Hà Nội",9700000,9700000,0,0
TIKI,dien-tu-dien-lanh,165189326,"Kính hiển vi 7 chức năng cho trẻ em khám phá Carson CP-11 X-Scope - Hàng chính hãng",759000,759000,0,0
TIKI,may-anh,109862511,"Hộp chụp ảnh sản phẩm, lồng chụp ảnh (nhiều loại), Hàng nhập khẩu",1049999,1049999,0,0
TIKI,dien-tu-dien-lanh,195226962,"Dây CUROA Máy Giặt M18.5",25000,25000,0,0
TIKI,may-anh,4727681,"Bộ Kích Đèn Trigger Yongnuo YN603 II Lẻ 1 Cục - Hàng Nhập Khẩu",344999,344999,0,0
TIKI,dien-tu-dien-lanh,206144224,"Camera PTZ Wifi 5MP DAHUA DH-SD2A500-GN-AW-PV- Hàng Chính Hãng",1696000,1696000,0,0
TIKI,dien-tu-dien-lanh,192972253,"Khung Treo TiVi Nghiêng CP từ 39-65inch C65N - Hàng Chính Hãng",350000,350000,0,0
TIKI,may-anh,101305987," Combo Soft box 70 x 50cm và chân đèn cao cho studio (có nhiều tùy chọn combo và tách lẻ)",89000,89000,0,0
TIKI,dien-tu-dien-lanh,73176691,"Điều khiển bằng giọng nói dùng cho Smartbox MyTV Chính hãng Cao cấp",237500,250000,12500,5
TIKI,dien-tu-dien-lanh,159244041,"Pin giả/ pin ảo/ pin Dummy Kingma for Canon LP-E6",349999,349999,0,0
TIKI,may-anh,120444794,"Gậy Chống Rung Gimbal Stabilizer L08 - Có 3 Chân Đỡ - Nút Bấm Bluetooh Hàng Cao Cấp - Hàng Nhập Khẩu",399999,650000,250001,38
TIKI,may-anh,126097755,"Camera Wifi PROLiNK PIC3003WP thông minh giá rẻ, siêu nét Full HD 1080P, góc nhìn rộng, âm thanh 2 chiều - Hàng chính hãng",629000,999000,370000,37
TIKI,dien-tu-dien-lanh,77872136,"Túi máy ảnh vải bố kết hợp với da imax-V4321",749999,749999,0,0
TIKI,dien-tu-dien-lanh,4688909,"Chân Máy Ảnh Tripod Mefoto A0350Q0 - Hàng Nhập Khẩu",1974999,1974999,0,0
TIKI,may-anh,194123786,"Camera IP Wifi Ngoài Trời EZVIZ BC1C 2MP Tặng Kèm Tắm Pin Năng Lượng Tích Hợp Bộ Nhớ Trong 32G - Có Màu Ban Đêm - Đàm Thoại 2 Chiều - Hàng Chính Hãng",2270500,2390000,119500,5
TIKI,dien-tu-dien-lanh,8356903,"Máy làm đá viên tinh khiết HA180 - Hàng Chính Hãng",67200000,67200000,0,0
TIKI,may-anh,3597911,"Bộ Chân Máy Ảnh Bạch Tuộc Lớn Và Đầu Bi Chân Máy Ảnh Thân Kim Loại Q00160",159000,159000,0,0
TIKI,dien-tu-dien-lanh,113048833,"Điều khiển chuột bay chức năng giọng nói.",95000,95000,0,0
TIKI,dien-tu-dien-lanh,177614676,"Thẻ nhớ Mirco SD HIKVISION 64GB - 92MB/s Class 10 chuyên dùng ghi hình cho các dòng camera IP, điện thoại, máy ảnh, máy tính bản - hàng chính hãng",95000,95000,0,0
TIKI,may-anh,165189326,"Kính hiển vi 7 chức năng cho trẻ em khám phá Carson CP-11 X-Scope - Hàng chính hãng",759000,759000,0,0
TIKI,dien-tu-dien-lanh,93374789,"Van cấp đôi dành cho máy giặt Electrolux",250000,250000,0,0
TIKI,dien-tu-dien-lanh,248466163,"Đầm Bông Họa Tiết Nhiệt Đới Nổi Bật HOYANG D123",1550000,1550000,0,0
TIKI,may-anh,206144224,"Camera PTZ Wifi 5MP DAHUA DH-SD2A500-GN-AW-PV- Hàng Chính Hãng",1696000,1696000,0,0
TIKI,dien-tu-dien-lanh,56365724,"Túi đựng đèn kit",583000,583000,0,0
TIKI,dien-tu-dien-lanh,94586492,"TÚI BỌC REMOTE ĐIỀU KHIỂN TV ĐIỀU HÒA (50 Tờ)",349700,349700,0,0
TIKI,dien-tu-dien-lanh,10240573,"Mount thao tác nhanh gắn GoPro Hero xoay 360 độ",69000,69000,0,0
TIKI,may-anh,159244041,"Pin giả/ pin ảo/ pin Dummy Kingma for Canon LP-E6",349999,349999,0,0
TIKI,dien-tu-dien-lanh,96355635," BỌC MÁY LẠNH KITTY   KITTY HOUSE",120000,120000,0,0
TIKI,may-anh,77872136,"Túi máy ảnh vải bố kết hợp với da imax-V4321",749999,749999,0,0
TIKI,dien-tu-dien-lanh,22194656,"Tủ Đựng Đầu Ghi Camera Cao Cấp",204000,204000,0,0
TIKI,dien-tu-dien-lanh,189466193,"Google Tivi TCL 4K 43 inch 43P737 - Hàng Chính Hãng - Chỉ Giao Hà Nội",8800000,8800000,0,0
TIKI,may-anh,4688909,"Chân Máy Ảnh Tripod Mefoto A0350Q0 - Hàng Nhập Khẩu",1974999,1974999,0,0
TIKI,may-anh,177614676,"Thẻ nhớ Mirco SD HIKVISION 64GB - 92MB/s Class 10 chuyên dùng ghi hình cho các dòng camera IP, điện thoại, máy ảnh, máy tính bản - hàng chính hãng",95000,95000,0,0
TIKI,dien-tu-dien-lanh,32402057,"Remote Điều Khiển Cho Máy Lạnh, Máy Điều Hòa MIDEA MSMA3-10CRN1, MSMA3-18CRN1",53000,53000,0,0
TIKI,dien-tu-dien-lanh,58531097,"Máy rửa bát Texgio TG-BI205 - 8 bộ bát đĩa Châu Âu - Điều khiển cảm ứng - Hàng nhập khẩu",12600000,12600000,0,0
TIKI,dien-tu-dien-lanh,168042362,"Smart Tivi QLED Samsung 4K 75 inch QA75Q70BA - Model 2022",28950000,28950000,0,0
TIKI,dien-tu-dien-lanh,74459324,"  Tivi Box Android HDgo 4K Ram 2Gb Hàng chính hãng",800000,800000,0,0
TIKI,may-anh,22194656,"Tủ Đựng Đầu Ghi Camera Cao Cấp",204000,204000,0,0
TIKI,dien-tu-dien-lanh,178058668,"Google Tivi Sony 4K 43 inch KD-43X75K - Model 2022",8749000,8749000,0,0
TIKI,may-anh,10240573,"Mount thao tác nhanh gắn GoPro Hero xoay 360 độ",69000,69000,0,0
TIKI,dien-tu-dien-lanh,48316378,"Máy lạnh Panasonic Inverter 1.5 HP CU/CS-XPU12WKH-8",19599000,19599000,0,0
TIKI,dien-tu-dien-lanh,93066063,"Smart Tivi Samsung 4K 75 inch UA75AU7700",17280000,17280000,0,0
TIKI,may-anh,56365724,"Túi đựng đèn kit",583000,583000,0,0
TIKI,dien-tu-dien-lanh,183555266,"Điều khiển hồng ngoại android tivi box",64600,68000,3400,5
TIKI,dien-tu-dien-lanh,119194733,"Remote dành cho máy lạnh Sumikura",75000,75000,0,0
TIKI,dien-tu-dien-lanh,25476219," ĐIỀU KHIỂN DÀNH CHO TIVI SONY TX-102D ",33000,33000,0,0
TIKI,dien-tu-dien-lanh,4587055,"Máy giặt Aqua 7.2 kg AQW-S72CT",4600000,4600000,0,0
TIKI,dien-tu-dien-lanh,90162758,"Máy Giặt Samsung Inverter 9.5kg WW95TA046AX/SV - Chỉ Giao Hà Nội",7990000,8950000,960000,11
TIKI,dien-tu-dien-lanh,105911486,"ANTEN NHÔM DÙNG CHO TIVI KỸ THUẬT SỐ,VÀ ĐẦU THU KỸ THUẬT SỐ DVB T2 ,KÈM DÂY 15 MÉT.",75000,75000,0,0
TIKI,dien-tu-dien-lanh,1923643,"Bình Nước Nóng Ferroli QQ SE15L, 3 Công Suất, Thanh Đốt Tráng Bạc, Chống Giật (2500W) - Hàng Chính Hãng",2580000,2580000,0,0
TIKI,dien-tu-dien-lanh,90163735,"Máy giặt Samsung Inverter 10 Kg WA10T5260BV/SV - Chỉ giao Hà Nội",7950000,7950000,0,0
TIKI,dien-tu-dien-lanh,197076329,"MÁY RỬA CHÉN BÁT TEXGIO TG-DTW558 8 BỘ, HÀNG CHÍNH HÃNG",6590000,6590000,0,0
TIKI,dien-tu-dien-lanh,55769146,"Tủ lạnh Hitachi Inverter 569 lít R-WB640VGV0 GBK",35500000,35500000,0,0
TIKI,dien-tu-dien-lanh,536240,"Tủ lạnh Sharp Inverter 556 lít SJ-FX630V-ST - Chỉ giao tại Hà Nội",15455000,16990000,1535000,9
TIKI,dien-tu-dien-lanh,74459280,"COMBO 10 BỘ CHIA CÁP TÍN HIỆU 2-3-4-6-8 TIVI",200000,200000,0,0
TIKI,may-anh,84566847,"Camera IP Wifi Không Dây Xoay Thông Minh Kawasan IPC02 Full HD1080P - Hàng Chính Hãng",1000000,1000000,0,0
TIKI,may-anh,91648636,"Pin Cho Camera Action Gopro Hero 5/6/7 Li-ion 1250mAh AHDBT-501",156750,165000,8250,5
TIKI,may-anh,108089799,"Chân máy ảnh Benro dòng FIF28, Hàng chính hãng",2699999,2699999,0,0
TIKI,may-anh,47878241,"Kính Lọc Filter Hoya UX UV 67mm - Hàng Chính Hãng",441999,441999,0,0
TIKI,dien-tu-dien-lanh,84750259,"Magic Remote Điều Khiển Smart Tivi, TV OLED 4K Dành Cho LG 2020 MR20GA AKB75855501 -  Có Chuột Bay, Giọng Nói",265000,265000,0,0
TIKI,may-anh,93741171,"Bóng Thổi Bụi Cho Máy Ảnh",99000,99000,0,0
TIKI,dien-tu-dien-lanh,113048568,"Điều khiển TV Skyworth Smart (nút youtube)",59900,59900,0,0
TIKI,dien-tu-dien-lanh,5502417,"Áo trùm vệ sinh máy lạnh RO _ vệ sinh máy lạnh tại nhà _ RO02",119000,119000,0,0
TIKI,dien-tu-dien-lanh,15503900,"Điều Khiển Dùng Cho Điều Hòa National",46100,46100,0,0
TIKI,dien-tu-dien-lanh,165964602,"Bộ Ron Tủ lạnh dành cho tủ lạnh  Panasonic NR B16V2",200000,200000,0,0
TIKI,may-anh,4708387,"Bộ 8 Dụng Cụ Mount Dán Gopro (Đen Đỏ) - Hàng Nhập Khẩu",59999,59999,0,0
TIKI,dien-tu-dien-lanh,119822179,"Remote Điều khiển TV dành cho Casper giọng nói",315000,315000,0,0
TIKI,may-anh,174811081,"Camera Hành Trình Vietmap C61 Pro cảnh báo giọng nói kèm thẻ nhớ 32 GB - Hàng chính hãng",3275000,3275000,0,0
TIKI,dien-tu-dien-lanh,75379796,"KHUNG TREO TIVI NGHIÊNG 26-32 INCH ",89000,89000,0,0
TIKI,dien-tu-dien-lanh,84796563,"Van khóa gas chống bỏng lạnh R410A",102000,102000,0,0
TIKI,may-anh,200657326,"[ tặng thẻ nhớ 64G] Camera Hành Trình Cho Xe Hơi/Ô Tô Màn Hình Cảm Ứng 12 Inch Ips Bên Trước Và Sau 2K/Full HD1080P, Buletooth, Có Wifi Quay Video Vòng Lặp",4404884,4404884,0,0
TIKI,dien-tu-dien-lanh,95917817,"Máy giặt Samsung AI Inverter 9kg WW90TP44DSH/SV - Chỉ giao Hà Nội",9100000,9100000,0,0
TIKI,dien-tu-dien-lanh,134754522,"Tủ lạnh mini 16L dùng được cả trong nhà và trên xe hơi - TRANG16",1800000,1800000,0,0
TIKI,may-anh,11370580,"Combo Giá đỡ chụp hình Tripod 3120 dành cho điện thoại, máy ảnh, tặng kẹp điện thoại",54100,54100,0,0
TIKI,may-anh,71690345,"Tủ chống ẩm Dry Cabi DHC-80 II Tủ ngang, 80 Lít, Hàng nhập khẩu",3249999,3249999,0,0
TIKI,dien-tu-dien-lanh,90407360,"Remote Điều Khiển Máy Lạnh, Máy Điều Hòa Dành Cho DAIKIN ARC433A87 ECONO - POWERFUL",96000,96000,0,0
TIKI,dien-tu-dien-lanh,459554,"Máy Nước Nóng Gián Tiếp FERROLI QQ EVO 15L M (2500W) - Hàng Chính Hãng",2097000,2097000,0,0
TIKI,dien-tu-dien-lanh,178331613,"BỘ 2 TẤM LƯỚI LỌC MÁY LẠNH PANASONIC 1HP– HÀNG CHÍNH HÃNG",195000,195000,0,0
TIKI,dien-tu-dien-lanh,73104850,"Vỏ bọc ĐIỀU HÒA chống thấm nước, chống bụi, côn trùng siêu tiện lợi - giao ngẫu nhiên",28400,28400,0,0
TIKI,dien-tu-dien-lanh,174241117,"Máy lạnh Panasonic Inverter 2.5Hp CU/CS-XPU24XKH-8-Hàng Chính Hãng-Giao Hàng Toàn Quốc.",25130000,25130000,0,0
TIKI,may-anh,107184715,"Camera IP WIFI IMOU RANGER 2 IPC - A22EP Full HD 1080P ,KÈM THẺ NHỚ 128G - Hàng Chính Hãng",749000,749000,0,0
TIKI,may-anh,158890697,"Chân đèn Ciya Inox IN-210, 210cm - Hàng nhập khẩu",379999,379999,0,0
TIKI,dien-tu-dien-lanh,36978332,"Remote Điều Khiển Dùng Cho TV LED, Smart TV SAMSUNG RM-D1078",35900,35900,0,0
TIKI,dien-tu-dien-lanh,132786001,"Tủ lạnh Beko Inverter 340 lít RDNT371E50VZGB - Hàng chính hãng - Giao toàn quốc",11200000,11200000,0,0
TIKI,may-anh,155997739,"Filter Kính lọc Hoya UV UX 62mm - Hàng Chính Hãng",409555,409555,0,0
TIKI,dien-tu-dien-lanh,115701176,"REMOTE ĐIỀU KHIỂN SMART TIVI LG 2020, 2019, 2018, 2017 AN-MR20BA - HÀNG CHÍNH HÃNG",595000,595000,0,0
TIKI,may-anh,52324969,"Camera Kim Loại SQ8 HD Camera Thể Thao DV Ngoài Trời SQ8",130000,199000,69000,35
TIKI,dien-tu-dien-lanh,55585632,"Điều khiển điều hòa âm trần Daikin",123000,123000,0,0
TIKI,may-anh,47570169,"Phông 3D chụp ảnh sản phẩm – mã MB51",160000,160000,0,0
TIKI,may-anh,270812879,"Camera WIFI FullColor 4MP có đàm thoại 2 chiều IMOU BULLET 2 IPC-F42FEP hàng chính hãng",1045000,1045000,0,0
TIKI,may-anh,10120870,"Camera IP Wifi Ngoài Trời EZVIZ CS-CV310 (1080P) - Hàng Chính Hãng",949000,949000,0,0
TIKI,dien-tu-dien-lanh,119194373,"Remote Điều khiển dành cho tivi led Skyworth Smart",49000,49000,0,0
TIKI,dien-tu-dien-lanh,118522974,"FPT PLAY BOX S 2021 mã T590 - Trung tâm điều khiển nhà thông minh bằng giọng nói - TẶNG bộ điều khiển thông minh Tuya Smart life - HÀNG CHÍNH HÃNG",1599000,1599000,0,0
TIKI,may-anh,2564513,"Bộ Kéo Phông 3 Trục Và Khung Treo",1199000,1199000,0,0
TIKI,dien-tu-dien-lanh,81971467,"Tủ lạnh Toshiba Inverter 194 lít GR-A25VM(UKG1)-Hàng chính hãng- Chỉ Giao Tại Hà Nội",5490000,5490000,0,0
TIKI,dien-tu-dien-lanh,114921753,"Tủ lạnh 6 cửa Hitachi Inverter 735 lít R-ZX740KV(X) - Hàng chính hãng (chỉ giao HCM)",111000000,111000000,0,0
TIKI,may-anh,155997868,"Giấy lau, bóng thổi, bút lau VSGO -Hàng Chính Hãng",75555,75555,0,0
TIKI,may-anh,108087879,"Camera giám sát IMOU Ranger 2C 2MP, 1080P IPC-TA22CP-B - Hàng Chính Hãng",569000,569000,0,0
TIKI,may-anh,155761583,"Camera hành trình xe hơi, ô tô thương hiệu HP f960x cao cấp tích hợp Wifi GPS Full HD 2304*1296P - Hàng Nhập Khẩu ",2300000,2300000,0,0
TIKI,may-anh,95526954,"Camera IP Wifi ngoài trời PTZ SriHome SP028 2.0MP FullHD 1080P, Xoay 355 độ, chống nước IP66 (Trắng) HÀNG CHÍNH HÃNG",539000,539000,0,0
TIKI,dien-tu-dien-lanh,123433770,"Dây truyền hình cáp (tivi)",5000,5000,0,0
TIKI,dien-tu-dien-lanh,173299836,"Rờ le que bình nóng lạnh",115000,115000,0,0
TIKI,may-anh,101639481,"Camera mô hình robot đàm thoại 2 chiều 1080p",1035000,1035000,0,0
TIKI,dien-tu-dien-lanh,97769229,"MÁY LẠNH AKINO 1HP Inverter ID-09INT1FA-9000BTU-GAS32-HÀNG CHÍNH HÃNG-GIAO HÀNG TOÀN QUỐC",6000000,6000000,0,0
TIKI,may-anh,158889876,"Chân đèn Beike AR-189, Hàng nhập khẩu",349999,349999,0,0
TIKI,may-anh,188907056,"CAMERA YOOSEE WIFI 4 RÂU 20 LED XOAY 180 ĐỘ 5.0 MPX CẢNH BÁO CHỐNG TRỘM KÈM THẺ 32-HÀNG CHÍNH HÃNG",545000,545000,0,0
TIKI,may-anh,10979816,"Sạc đôi kèm cáp sạc và 2 pin sạc KingMa LP-E17 cho Canon EOS M3 M5 M6 760D 800D - Hàng chính hãng",649999,649999,0,0
TIKI,may-anh,184771570,"Giá đở Camera hành trình và camera thể thao gắn trên kính xe hơi",69000,69000,0,0
TIKI,dien-tu-dien-lanh,459574,"Máy Nước Nóng Ferroli QQ EVO 15L TE (2500W)",2010000,2010000,0,0
TIKI,may-anh,269899146,"Kính Hiển Vi Điện Tử Đa Năng 3 trong 1 50x -1000x",590000,590000,0,0
TIKI,may-anh,142872424,"Mount nối gắn camera",100000,100000,0,0
TIKI,dien-tu-dien-lanh,53650063,"Điều Hòa 2 Chiều LG Inverter 9200 BTU B10END - Chỉ giao tại Hà Nội",9290000,9290000,0,0
TIKI,may-anh,153037267,"Camera IP POE Thân 2.0MP DAHUA DS2230SFIP-S2 hàng chính hãng DSS Việt Nam",721500,721500,0,0
TIKI,may-anh,91729501,"Pin Cho Máy Ảnh Nikon Li-ion 7.4V 2200mAh EN-EL3E",170050,179000,8950,5
TIKI,may-anh,23417162," Kính thiên văn cao cấp Carson SkySeeker JC-1000 - Hàng chính hãng",5400000,5400000,0,0
TIKI,may-anh,16458389,"Nguồn Camera 12V - 2A",32000,32000,0,0
TIKI,may-anh,157425728,"Camera IP Wifi Yoosee 3 Râu - hàng chính hãng",550000,550000,0,0
TIKI,dien-tu-dien-lanh,242719877,"Remote Điều Khiển Cho Máy Lạnh, Điều Hòa SHARP AH-X9UEW, AH-X12VEW, AH-X12STW, AH-X18VEW",49000,49000,0,0
TIKI,dien-tu-dien-lanh,16147225,"Điều Khiển Máy Lạnh DAIKIN ARC433A1 Home Leave - Hàng Chính Hãng",59000,59000,0,0
TIKI,dien-tu-dien-lanh,114842436,"[CHỈ GIAO TẠI HCM] - Máy giặt Panasonic 14 kg NA-FD14V1BRV - Hàng Chính Hãng",19690000,19690000,0,0
TIKI,may-anh,9423471,"Kẹp Jaws Flex Clamp cho Gopro",269000,269000,0,0
TIKI,may-anh,92165099,"Camera Dahua 2 Mp DH HAC B1A21P 1080P - Thân Trụ Ngoài Trời - Hàng chính hãng",313000,313000,0,0
TIKI,may-anh,152647094,"Camera IP POE Dome 2.0MP DAHUA DS2230TDIP-S2 hàng chính hãng DSS Việt Nam",721500,721500,0,0
TIKI,may-anh,54478379,"Micro thu âm Saramonic Blink 500 B6 - Hàng Chính Hãng",6178000,6178000,0,0
TIKI,may-anh,230082338," 200 Gói chống ẩm 1,2,5,10 gram đóng túi 200 gram",27000,27000,0,0
TIKI,may-anh,169343191,"Chân Máy Ảnh Tripod YungFeng 3388, Giá Đỡ Kèm nút bấm Bluetooth Cao Cấp Chuyên Dùng ChO Điện Thoại Camera Model 2020",239000,239000,0,0
TIKI,phu-kien-thoi-trang,177527856,"Kẹp tóc càng cua đính đá sang chảnh - UniLabel",45000,45000,0,0
TIKI,phu-kien-thoi-trang,67011505,"VÁY CHỐNG NẮNG XẺ TÀ THÔNG MINH - Váy chống nắng Xẻ tà vải Jean mềm Cao cấp có thêu Họa tiết Chuồn chuồn",250000,250000,0,0
TIKI,phu-kien-thoi-trang,25202380,"Kính mát phân cực Xiaomi Turok Steinhardt STR004 - Hàng Nhập Khẩu",405000,405000,0,0
TIKI,phu-kien-thoi-trang,28533205,"Gọng kính Unisex VELOCITY VL36459",77000,420000,343000,82
TIKI,phu-kien-thoi-trang,151689452,"Vớ Nam CỔ NGẮN cao cấp , Tất Cổ Ngắn Nam chất liệu cotton khử mùi kháng khuẩn",20000,38000,18000,47
TIKI,phu-kien-thoi-trang,15932596,"Bộ uốn tóc không nhiệt lò xo tiện lợi",24900,24900,0,0
TIKI,phu-kien-thoi-trang,144180784,"Dây thun tròn Dây chun tròn cột bọc size tiểu trung đại bịch 500g",63000,63000,0,0
TIKI,phu-kien-thoi-trang,171949817,"Găng tay chống nắng xỏ ngón (đen) Freesize cho nam và nữ, co giãn, thun lạnh, chất vải dày dặn, chống tia UV 95%",65000,75000,10000,13
TIKI,phu-kien-thoi-trang,2583377,"Đai kẹp giữ áo sơ mi loại kẹp sắt bấm",68000,68000,0,0
TIKI,phu-kien-thoi-trang,169641326,"Combo Chai xịt nano mắt kính chống bám dính hơi nước cho mắt kính (chơi thể thao, đeo khẩu trang...)",45000,50000,5000,10
TIKI,phu-kien-thoi-trang,28324202,"Cặp Kính Áp Tròng Dùng 1 Ngày Eye Secret KM1N - Okinawa Brown",60000,70000,10000,14
TIKI,phu-kien-thoi-trang,141123868,"Khẩu trang cao cấp Vải Nano Kháng Khuẩn OneMask tái sử dụng được 30 lần",32000,50000,18000,36
TIKI,phu-kien-thoi-trang,75530137,"Thắt Lưng Nữ Thời Trang Kiểu Classic Mặt Khóa Kim Loại Hình Tròn Chất Liệu Da PU TL013 MayHomes Dây Lưng Nữ, Dây Nịt Nữ Đa Năng Bền Chắc Dùng Cho Đầm, Jeans, Quần Âu Và Shorts",51700,55000,3300,6
TIKI,phu-kien-thoi-trang,191893743,"Set 2 lược chải đầu-giao mẫu ngẫu nhiên",28500,30000,1500,5
TIKI,phu-kien-thoi-trang,183726216,"[MẪU MỚI]- Khăn choàng cổ họa tiết thổ cẩm Vintage 180x90cm- CHỌN MẪU- Khăn choàng đi biển Boho",148000,148000,0,0
TIKI,phu-kien-thoi-trang,138283949,"Thun cột tóc, Set thun cột tóc, Hộp thun cột tóc sợi kép nhiều màu xinh xắn, tiện lợi cho nữ",60000,60000,0,0
TIKI,phu-kien-thoi-trang,179146183,"Thắt lưng nam dây nịt nam chất liệu da bò thật khóa tự động hàng hiệu cao cấp NT335- Nutushop",335000,335000,0,0
TIKI,phu-kien-thoi-trang,44153500,"HỘP ĐỰNG GỌNG KÍNH CẬN NHỰA DA ĐEN",56000,60000,4000,7
TIKI,phu-kien-thoi-trang,164021654,"Kính Mát Nam, Mắt Kính Nam, Kính Mát Nam Phi Công Tròng Phân Cực Chống Chói, Chống Lóa Đi Xe Ngày Đêm AK037 - Aoron",320000,360000,40000,11
TIKI,phu-kien-thoi-trang,96933950,"GỌNG KÍNH GIẢ CẬN GỌNG CHỮ V FORM VUÔNG 2 CHẤM HOTTREND CỰC ĐẸP",41000,99000,58000,59
TIKI,phu-kien-thoi-trang,102130535,"Băng đô cài tóc đính ngọc trai nhỏ phong cách Hàn Quốc - Hột tròn đều - Trắng",23750,25000,1250,5
TIKI,phu-kien-thoi-trang,117775885,"Kính Râm, Kính Mát Nam Nữ Mắt Vuông Bản Dày Đơn Giản Chống Nắng, Chống Lóa UV (ĐEN)",95000,100000,5000,5
TIKI,phu-kien-thoi-trang,186738636,"Set 5 Đôi Tất Nữ Cổ Cao Họa Tiết Chú Gấu Dễ Thương, Vớ Cao Cổ Nữ Thời Trang Đơn Giản- CBCC83",45000,69000,24000,35
TIKI,phu-kien-thoi-trang,157449049,"Thắt lưng dây nịt nam da bò thật thắt lưng khóa tự động  phong cách Châu Âu mã Kiểu 7.74230CLG",199000,369000,170000,46
TIKI,phu-kien-thoi-trang,189552678,"Găng Tay Chống Tia UV 99% BONAS HATSU  Unisex | Công Nghệ Aqua Làm Mát | Bao Tay Đi Nắng Xỏ Ngón | Ống Tay Thể Thao Chống Nóng Loại Dày Tốt",71000,75000,4000,5
TIKI,phu-kien-thoi-trang,92911297,"Mắt kính mát nam đổi màu đi ngày đêm 7K570DM. Kính nam tròng Polarized chống tia UV, chống nắng. Gọng kính kim loại, ôm mặt",279000,279000,0,0
TIKI,phu-kien-thoi-trang,183513090,"Mũ Lưỡi Trai Nam Lính Mỹ Cao Cấp US ARMY U789 Chóp Vuông, Nón Kết Nam Thiết Kế Đơn Giản, Màu Sắc Đa Dạng, Kiểu Dáng Năng Động Trẻ Trung - HÀNG CHÍNH HÃNG",85000,178000,93000,52
TIKI,phu-kien-thoi-trang,50336176,"Dây Cột Tóc Lò Xo Combo 10 cái ( Màu ngẫu nhiên )",37905,39900,1995,5
TIKI,phu-kien-thoi-trang,92803167,"Mắt Kính Thời Trang Nam Nữ Sành Điệu, Kính Râm Gọng Vuông To Bản KM21",122000,145000,23000,16
TIKI,phu-kien-thoi-trang,66607989,"Dụng cụ búi tóc nữ ( Thái Lan ) - Tặng Kèm 1 Kẹp Tóc ( Giao Màu Ngẫu Nhiên )",17500,17500,0,0
TIKI,phu-kien-thoi-trang,189897266,"Kẹp tóc gấp cao cấp đính đá, kết hoa xà cừ sang chảnh phong cách Hàn Quốc ",100000,100000,0,0
TIKI,phu-kien-thoi-trang,102888897,"Tóc búi xoăn cột J25C, tóc dày đẹp - Nâu đỏ",30000,30000,0,0
TIKI,phu-kien-thoi-trang,22782537,"Dụng Cụ Vệ Sinh - Lau Mắt Kính Tiện Lợi",5900,7566,1666,22
TIKI,phu-kien-thoi-trang,42553617,"Hộp đựng kính cận thời trang",35280,49000,13720,28
TIKI,phu-kien-thoi-trang,20854795,"Set 3 Kẹp Tóc Ngọc Trai , Kiểu Dáng Hàn Quốc",34000,50000,16000,32
TIKI,phu-kien-thoi-trang,195750202,"Mắt Kính Mát Nam Thời Trang Form Dáng Hiện Tại , Cảm Giác Dễ Chịu 901 [BỘ ĐỰNG KÍNH 5 MÓN]  BK002",144000,180000,36000,20
TIKI,phu-kien-thoi-trang,56033417,"Nón tai bèo nam nữ đội 2 mặt hình chiếc lông chim We Will Fly, may 2 lớp màu khác nhau độc đáo, vải cotton mềm mại thoải mái",37000,37000,0,0
TIKI,phu-kien-thoi-trang,114587974,"Mắt kính thời trang chống bụi gọng nhựa viền kim loại vuông K3016 unisex nam nữ style giả cận, phong cách tri thức, lịch sự",27000,149000,122000,82
TIKI,phu-kien-thoi-trang,114739740,"Cột tóc srunchies mẫu mới màu hồng phấn đẹp",18000,18000,0,0
TIKI,phu-kien-thoi-trang,124273306,"Bộ 24 Kim May Vá Tiện Lợi",6000,7000,1000,14
TIKI,dien-tu-dien-lanh,11104347,"Máy giặt Toshiba Inverter 8.5 Kg TW-BH95S2V WK",6850000,6850000,0,0
TIKI,dien-tu-dien-lanh,155254331,"TiVi Box Bluetooth Android 11 X98 Mini Chip S905W2 Phiên Bản 2021 Xem Phim Truyền Hình Game Online Thỏa Thích- Hàng Chính Hãng",900000,900000,0,0
TIKI,dien-tu-dien-lanh,5794385,"Bàn Phím Chuột Wireless Cho Smart Tivi",93000,99000,6000,6
TIKI,dien-tu-dien-lanh,96424861,"MÁY RỬA CHÉN BÁT TEXGIO 8 BỘ TGWF98SB- HÀNG NHẬP KHẨU",20000000,20000000,0,0
TIKI,dien-tu-dien-lanh,195220196,"Máy rửa chén Junger 2400W DWJ-600 - Hàng chính hãng",24950000,24950000,0,0
TIKI,dien-tu-dien-lanh,126702041,"Điều khiển tivi dành cho TCL smart Netflix ",57475,60500,3025,5
TIKI,dien-tu-dien-lanh,135040137,"điều khiển điều hoà đa năng điều khiển đa năng remote đa năng tích hợp đèn pin(tặng kèm pin)",33900,33900,0,0
TIKI,dien-tu-dien-lanh,102115851,"FPT Play Box S 2021 mã T590 Điều khiển giọng nói không chạm Đầu thu Android TV Box Smart Home tivi box Fpt box 2021",2390000,2390000,0,0
TIKI,dien-tu-dien-lanh,49393228,"Tủ ướp, bảo quản rượu vang thương hiệu Homesun, Model: BCW-70A, Thể tích 70L(Chứa được 28 chai), Hàng chính hãng",11770000,11770000,0,0
TIKI,dien-tu-dien-lanh,195651197,"Smart Tivi QNED LG 4K 55 inch 55QNED80SQA - Model 2022",16500000,16500000,0,0
TIKI,dien-tu-dien-lanh,196009397,"Tủ lạnh Samsung Inverter 236 lít RT22M4032BU - Hàng chính hãng [Giao hàng toàn quốc]",6770000,9590000,2820000,29
TIKI,dien-tu-dien-lanh,162736006,"Tủ lạnh LG Inverter 374L GN-D372PSA - Chỉ giao Hà Nội",10590000,10590000,0,0
TIKI,dien-tu-dien-lanh,48635497,"Bộ Chia 6 Pacific 4206AP Dùng Chia Chảo, Truyền Hình Cáp, Anten KTS - Hàng Nhập Khẩu",139000,139000,0,0
TIKI,dien-tu-dien-lanh,57340004,"BÌNH NƯỚC NÓNG GIÁN TIẾP AQUA E 150 LÍT TREO ĐỨNG (SEV)-HÀNG CHÍNH HÃNG",11250000,11250000,0,0
TIKI,dien-tu-dien-lanh,172068904,"Android Tivi Sony 4K 75 inch KD-75X80K - Model 2022",27200000,27200000,0,0
TIKI,dien-tu-dien-lanh,171273566,"Áo vệ sinh máy lạnh đuôi dài 2,5m- giá tận gốc
- Xanh Bích - không dây",55000,55000,0,0
TIKI,dien-tu-dien-lanh,181153214,"Set 4 Chân Đế Kê Chống Rung Máy Giặt Chống Ồn Hiệu Quả",25000,25000,0,0
TIKI,dien-tu-dien-lanh,117276195,"Máy Giặt Casper Nhập Khẩu nguyên chiếc từ Thái Lan cửa trước 12,5kg- WF125I140BGB [ CHỈ GIAO HÀ NỘI ]",10500000,10500000,0,0
TIKI,dien-tu-dien-lanh,273654329,"Ron tủ lạnh kiểu gài dài 2 mét",86000,86000,0,0
TIKI,dien-tu-dien-lanh,10828332,"Bàn phím kiêm chuột không dây mini cho tivi box, smart tivi UKB-500RF có đèn led",85000,85000,0,0
TIKI,dien-tu-dien-lanh,136825944,"Máy giặt LG Inverter 10 kg FV1410S3B - Chỉ giao tại HN",11500000,11500000,0,0
TIKI,dien-tu-dien-lanh,26487804,"Tủ lạnh mini 2 chế độ nóng lạnh 10 lít",949000,949000,0,0
TIKI,dien-tu-dien-lanh,13670649,"Anten tàu bay DVB T2 có thể treo tường ban công, để bàn tiện lợi",179000,179000,0,0
TIKI,dien-tu-dien-lanh,176289253,"Máy Nước Nóng Trực Tiếp Electrolux EWE351LB-DAX1 - Công Suất 3500W - Hàng Chính Hãng",4490000,4490000,0,0
TIKI,dien-tu-dien-lanh,121744039,"Máy sấy bơm nhiệt LG 9 Kg DVHP09W - Chỉ giao tại HN",18500000,18500000,0,0
TIKI,dien-tu-dien-lanh,186711348,"Lưới kim loại, lưới bảo vệ quạt máy tính kích thước 8cm",10000,10000,0,0
TIKI,dien-tu-dien-lanh,74324330,"Máy Rửa Bát Độc Lập 14 Bộ BOSCH SMS8YCI01E Seri 8 - Hàng Nhập Khẩu Đức - Made in Germany",49856000,49856000,0,0
TIKI,dien-tu-dien-lanh,10194899,"Tủ lạnh Toshiba Inverter 555 lít GR-AG58VA-XK ",16600000,16600000,0,0
TIKI,dien-tu-dien-lanh,126702104,"Remote điều khiển Điều hòa dành cho PANASONIC-1 chiều và 2 chiều INVERTER",365750,385000,19250,5
TIKI,dien-tu-dien-lanh,12870909,"Bình nóng lạnh gián tiếp Ariston Slim SL30ST B 30L - Hàng Chính Hãng",3500000,3500000,0,0
TIKI,dien-tu-dien-lanh,135501110,"Máy rửa chén bát Texgio độc lập 15 bộ hé cửa TGF3815B - Hàng chính hãng",14000000,14000000,0,0
TIKI,dien-tu-dien-lanh,162736016,"Tủ lạnh LG Inverter 334L GN-D332PS - Chỉ giao Hà Nội",8950000,8950000,0,0
TIKI,dien-tu-dien-lanh,162105883,"Louver - chuyển hướng gió dàn nóng điều hoà hàng loại 1 thép dày dặn sơn PU",175000,175000,0,0
TIKI,dien-tu-dien-lanh,51982010,"Điều khiển dành cho đầu Mytv VNPT Box đời mới",136000,136000,0,0
TIKI,giay-dep-nu,125099350,"Giày nữ Anh Khoa CH993-4",199000,199000,0,0
TIKI,giay-dep-nu,32183606,"Giày đi mưa đi biển form chuẩn chống trơn trượt đế bằng 163",48000,48000,0,0
TIKI,giay-dep-nu,32113867,"GIÀY ĐI MƯA NHỰA BỀN",47000,47000,0,0
TIKI,giay-dep-nu,95013392,"Giày thể thao nữ đi bộ cực êm siêu xinh V278",59000,59000,0,0
TIKI,giay-dep-nu,8176564,"Miếng Lót Giày Tăng Chiều Cao 4D - 3,5cm",54000,54000,0,0
TIKI,giay-dep-nu,109347133,"Dép đế trấu quai ngang nam nữ thời trang Detaunisex màu Bò - DETA24B",245000,245000,0,0
TIKI,giay-dep-nu,86963159,"Giày Sandal Cao Gót Da Bò BIGGBEN Cao 5 Phân SDCG61",359000,400000,41000,10
TIKI,dien-tu-dien-lanh,55824912,"Tủ lạnh Hitachi Inverter 569 lít R-WB640VGV0-GMG - HÀNG CHÍNH HÃNG",36369000,36369000,0,0
TIKI,giay-dep-nu,128088051,"GIÀY KHIÊU VŨ MÀU ĐỒNG 7 DÂY ÔM NGÓN ÚT 7 và 5cm",189000,189000,0,0
TIKI,giay-dep-nu,170069022,"Giày cao gót nữ 7 phân gót vuông cao cấp ORSIL",149000,149000,0,0
TIKI,giay-dep-nu,169372118,"Giày búp bê nữ đế bằng 2cm đi bộ thoáng khi cực êm chân V300",69000,69000,0,0
TIKI,giay-dep-nu,177793665,"Dép Đi Trong Nhà, Văn Phòng, Dạo Phố Cho Nữ Hình Thỏ Dễ Thương",145000,145000,0,0
TIKI,giay-dep-nu,105631085,"Giày lười thể thao nữ đi bộ cực êm siêu xinh V282",54000,54000,0,0
TIKI,dien-tu-dien-lanh,3812813,"Tủ lạnh Hitachi Inverter 540 lít R-FW690PGV7 GBK",23500000,23500000,0,0
TIKI,giay-dep-nu,168228817,"Dép Đi Trong Nhà Nam Nữ Massage Chân Cực Êm Chân Tăng Kèm Tất",99000,99000,0,0
TIKI,dien-tu-dien-lanh,153262007,"Tủ Bảo Quản Rượu Âm Tủ Malloca MWC 24CP - Sức Chứa 24 Chai - 54L - Hàng Chính Hãng",21080000,24800000,3720000,15
TIKI,dien-tu-dien-lanh,161409098,"Máy Rửa Chén Để Bàn HAFELE HDW-T50B 539.20.600 - Sức chứa 6 bộ đồ ăn - Hàng Chính Hãng",13189000,13189000,0,0
TIKI,giay-dep-nu,16295209,"Combo 2 cặp lót giày cao gót giảm đau gang bàn chân vị trí dưới các ngón chân, lót giày hút mồ hôi chân khi mang giày bít mũi PK14",42000,42000,0,0
TIKI,giay-dep-nu,133431963,"MIẾNG LÓT SILICON BẢO VỆ GÓT CHÂN | DỤNG CỤ BẢO VỆ GÓT CHÂN",14900,14900,0,0
TIKI,giay-dep-nu,32737711,"2 cặp lót giày cao gót đa năng 4D cực êm chân, chống thốn gót chân và thấm hút mồ hôi - buybox - BBPK56",64000,100000,36000,36
TIKI,giay-dep-nu,48995818,"Dép lỗ tròn nhỏ đi trong nhà, nhà tắm",25000,25000,0,0
TIKI,giay-dep-nu,157062466,"Khăn Giấy Lau Giày Sneaker Chuyên Dụng Khăn Ướt Vệ Sinh Giày Dép Dép Da Siêu Sạch 1 Gói 30 Tờ - Hàng Chính Hãng MINIIN",45000,45000,0,0
TIKI,giay-dep-nu,10733022,"Ủng Đi Mưa Cao Cổ Tiện Lợi",27900,27900,0,0
TIKI,giay-dep-nu,186553880,"Giày Búp Bê Nữ Da Bò Thật BIGGBEN Cao 5 Phân BB123",319000,400000,81000,20
TIKI,giay-dep-nu,151976581,"Dây giày dạ quang phản quang bản tròn giầy cao cổ boot thể thao sneaker nam nữ dài 1m 1m2 1m4 1m6 1m8 Sans943",40000,40000,0,0
TIKI,giay-dep-nu,88205112,"(Được chọn Size) Miếng lót giày thể thao Yellow Sport chuyên dụng cao cấp, Lót giày cả bàn siêu êm chân, khoáng khí, khử mùi hôi",79000,79000,0,0
TIKI,dien-tu-dien-lanh,126701978,"Remote Điều khiển điều hòa dành cho Aqua 1&2 chiều Inverter ",59000,59000,0,0
TIKI,dien-tu-dien-lanh,146161479,"Hệ Thống Máy Lạnh Multi S Daikin Inverter Combo 3HP + 02 dàn lạnh 1.5HP - MKC70SVMV/CTKC35RVMV+CTKC35RVMV - Hàng Chính Hãng - Chỉ giao tại TP.HCM",29177000,29177000,0,0
TIKI,giay-dep-nu,17898018,"Combo 2 cặp lót giày cao gót chống tuột gót chân đệm êm bàn chân và chống thốn gót chân, lót giày giảm size giày bị rộng PK11 - 2",49000,49000,0,0
TIKI,giay-dep-nu,83480711,"Lót giày cao gót 4D chống trượt bàn chân về phía trước - buybox - BBPK165",25000,29000,4000,14
TIKI,giay-dep-nu,50493199,"Giày búp bê nữ size chuẩn nhiều màu siêu xinh thắt nơ V222",55000,55000,0,0
TIKI,giay-dep-nu,19984182,"Xi nước đánh giày Kangaroo Hàn Quốc - Nhập khẩu chính hãng",59000,59000,0,0
TIKI,giay-dep-nu,152047531,"Dây giày dẹt đủ size nhiều màu cột giầy thể thao sneaker boot buộc áo quần dài 100cm 150cm 180cm đen trắng xám Sans942",24000,24000,0,0
TIKI,giay-dep-nu,71027401,"Giày sandal nữ đi mưa đế bánh mỳ siêu bền V256",69000,69000,0,0
TIKI,giay-dep-nu,133235317,"Dép quai kẹp nữ nhựa đúc liền đế, siêu nhẹ, siêu bền Thái Lan Adda 54E05",150000,150000,0,0
TIKI,giay-dep-nu,65993260,"Dép lông đi trong nhà bít mũi tai thỏ CÓ SIZE CHO MẸ VÀ BÉ SC021",146000,155000,9000,6
TIKI,giay-dep-nu,127378961,"Gel Vệ Sinh Giày Chuyên Dụng Đậm Đặc 100ml Chính Hãng Dincox X Matteo",150000,150000,0,0
TIKI,giay-dep-nu,143858681,"GIÀY MŨI VUÔNG (DA THẬT) DA MỀM - CÔNG SỞ TIẾP VIÊN HÀNG KHÔNG NỮ FFAN STORE",470000,470000,0,0
TIKI,giay-dep-nu,125781034,"Dép Lào xốp trắng mang khách sạn",21000,21000,0,0
TIKI,giay-dep-nu,137253920,"Vớ silicon gai gót chân, Chống Nứt Gót Chân, đau gót chân",35000,35000,0,0
TIKI,giay-dep-nu,187396210,"Giày Sandal Xuồng Nữ Da Bò Thật BIGGBEN Cao 5cm SDX38",349000,400000,51000,13
TIKI,giay-dep-nu,51297276,"2 cặp Lót giày cao gót mũi nhọn 4D có gờ giảm sốc đệm êm nguyên bàn chân - buybox - BBPK65-2 - 1 cặp Kem + 1 cặp Đen",70000,140000,70000,50
TIKI,giay-dep-nu,146235133,"Giày sneakers vải canvas họa tiết kẻ đế cao 7cm PS372-1130",372000,372000,0,0
TIKI,giay-dep-nu,180380379,"Lót giày 4D đệm êm chống rớt gót tránh trượt và bảo vệ bàn chân trước siêu mềm thoáng khí cho giày bít mũi",49000,49000,0,0
TIKI,giay-dep-nu,125099673,"Giày lười nữ Anh Khoa A83",170000,170000,0,0
TIKI,giay-dep-nu,148932554,"giày thể thao nữ đẹp ,giày nữ sneaker đế cao su mềm siêu nhẹ nhiều màu SUNO STORE GTTN02",177000,177000,0,0
TIKI,phu-kien-thoi-trang,129006582,"Cột tóc xanh ngọc bích  ánh kim - cột tóc cánh bèo lớn  nổi bật - cột tóc srunchies mẫu mới",22000,22000,0,0
TIKI,phu-kien-thoi-trang,175687126,"KẸP GẤP TÓC 5 RĂNG NHÁM NHIỀU MÀU GIAO MÀU NGẪU NHIÊN",19000,20000,1000,5
TIKI,phu-kien-thoi-trang,122210902,"GOTI - Trâm Cài Áo Hình Thiên Nga  Sang Trọng Nữ Tính Kiểu Phụ Kiện Trang Trí Trâm Cài Váy Đầm Dành Cho Nữ Cài Vest Nữ GOTI 02",9000,15000,6000,40
TIKI,phu-kien-thoi-trang,135290000,"Set Cài Áo Chống Hở Cho Nữ 10 Chi Tiết Họa Tiết Nhã Nhặn, Nút Cài Chắc Chắn, Siêu Tiện",29800,29800,0,0
TIKI,phu-kien-thoi-trang,95066047,"Mũ nón bucket nam nữ trơn tròn vành nhiều màu siêu đẹp MN20",36000,36000,0,0
TIKI,phu-kien-thoi-trang,13569901,"Set 10 đôi tất nam chống thối chân cổ ngắn xuất Nhật",74000,74000,0,0
TIKI,phu-kien-thoi-trang,138053942,"Hộp 4 Đôi Tất Sợi Tre Cổ Cao Cao Cấp, Vớ Cổ Cao Vải Sợi Tre Mềm Mịn Thoáng Mát - GOMTAT-SOITRE-CAO",136000,240000,104000,43
TIKI,phu-kien-thoi-trang,111207139,"Băng đô tai mèo  Băng đô rửa mặt turban tai thỏ tai mèo vải nhung bờm tóc cho bạn nữ cài tóc xinh đẹp",31800,31800,0,0
TIKI,phu-kien-thoi-trang,51111742,"Trâm Cài Áo Nữ Quà Tặng Thiên Nga Đính Đá Trắng Trang Nhã Sang Trọng (Kèm Hộp Quà Tặng)",99000,198000,99000,50
TIKI,phu-kien-thoi-trang,155451051,"Mũ len nam nón len nam khăn choàng cổ dona2201041",160550,169000,8450,5
TIKI,phu-kien-thoi-trang,194182865,"Kẹp tóc nữ hàn quốc NASI chất liệu hợp kim cao cấp bền đẹp kẹp tóc mái mẫu đẹp kẹp mỏ vịt đính cườm sang trọng",8000,8000,0,0
TIKI,phu-kien-thoi-trang,181264838,"Dây đeo khẩu trang, Dây đeo kính thời trang chống rơi rớt 2 trong 1, dây khẩu trang xích nhựa",35000,35000,0,0
TIKI,phu-kien-thoi-trang,184247588,"Gọng kính hợp kim cước thời trang nam nữ siêu nhẹ siêu bền Ouress 58006",253000,280000,27000,10
TIKI,phu-kien-thoi-trang,20865521,"Combo 3 Kẹp Phồng Mái Cute Cho Bạn Gái",7000,7000,0,0
TIKI,phu-kien-thoi-trang,97073912,"Hộp giấy lau kính ",80000,80000,0,0
TIKI,phu-kien-thoi-trang,179718020,"Set 10 Đôi Tất Chân Nam Nữ Chất Liệu Cotton, Vớ Cổ Ngắn Unisex Chuẩn Xuất Nhật - CB073-10DOI",89000,100000,11000,11
TIKI,phu-kien-thoi-trang,176069438,"Thắt lưng nữ đai váy dây nịt nữ mang đầm bản nhỏ mẫu đẹp màu đen thời trang Hàn Quốc dona22041801",79000,89000,10000,11
TIKI,phu-kien-thoi-trang,47301236,"Kính V Southside mắt vuông thời trang hottrend",61000,69000,8000,12
TIKI,phu-kien-thoi-trang,164021952,"Kính Nữ Thời Trang Phân Cực Đổi Màu Chống Tia UV, Chống Chói Đi Biển AK006 - AORON",210000,320000,110000,34
TIKI,phu-kien-thoi-trang,105736087,"Khẩu trang vải Linen trơn nhiều màu sắc mới, phù hợp cả nam và nữ T01",25000,25000,0,0
TIKI,phu-kien-thoi-trang,108897544,"Kẹp cà vạt nam dành cho Cavat bản trung ( 5cm)",119000,119000,0,0
TIKI,phu-kien-thoi-trang,170129807,"Hộp Kim Chỉ May Vá Quần Áo Xách Tay Mini 55 Món Du Lịch Tiện Lợi Giao Màu Ngẫu Nhiên - Hàng Loại 1 - Chính Hãng MINIIN",36400,52000,15600,30
TIKI,phu-kien-thoi-trang,160894109,"Tất vớ cao cổ Nam Nữ, tất cotton GOM TẤT êm mềm đi mát, thiết kế thoáng khí - GOM-KLB-TRONCAO",19900,35000,15100,43
TIKI,phu-kien-thoi-trang,146368996,"[VIDEO]- Khăn lụa choàng cổ dáng dài cao cấp 180x90cm- Quà tặng ý nghĩa cho phái đẹp- CHỌN MẪU",148000,148000,0,0
TIKI,phu-kien-thoi-trang,207779684,"Kính Giả Cận, Gọng Kính Cận Nam Nữ Viền Dày Dáng Tròn Bạc Không Độ Hàn Quốc - BLUE LIGHT SHOP",185000,185000,0,0
TIKI,phu-kien-thoi-trang,79191608,"Khẩu Trang Vải Kháng Khuẩn Thời Trang Miley Lingerie 2 lớp",15000,30000,15000,50
TIKI,phu-kien-thoi-trang,272222569,"Set 10 đôi Tất Nữ xỏ ngón chống nắng, Tất Cổ Cao Da Chân Vải cotton dày dặn, mềm mịn cực êm chân LISU-TATNGON-GVGLUNG",75000,90000,15000,17
TIKI,phu-kien-thoi-trang,166070388,"Gọng kính chính hãng SARIFA 82582",75000,520000,445000,86
TIKI,phu-kien-thoi-trang,192713793,"Thắt Lưng Dây Nịt Nam Da Bò Khóa Tự Động Đa Dạng Nhiều Mẫu Lạ Phong Cách Âu Cá Tính DT115",70000,90000,20000,22
TIKI,phu-kien-thoi-trang,142809625,"Kính cận thị nữ gọng kính TR90 siêu nhẹ",136080,189000,52920,28
TIKI,phu-kien-thoi-trang,168964920,"Tất vớ nam nữ cổ cao trơn màu GOMTAT chất liệu cotton cao cấp, hút ẩm thoáng khí, mềm mại êm chân - KLB-TRONCAO-GANTAM",19900,39000,19100,49
TIKI,phu-kien-thoi-trang,58363201,"Mắt kính mát nam nữ thời trang DKY2017D gọng kim loại, tròng Polariezd chống tia UV",229000,229000,0,0
TIKI,phu-kien-thoi-trang,52462209,"Kính viễn thị lão thị hai tròng nhìn xa và gần loại mắt to cực rõ và sáng Nam nữ HTTPKV92PK cao cấp",219000,219000,0,0
TIKI,phu-kien-thoi-trang,75521817,"Cột Tóc Vải Scrunchies Màu Cầu Vòng",15000,15000,0,0
TIKI,phu-kien-thoi-trang,87093170,"Dây Nịt Nam Không Mặt Khóa, Dùng Cho Đầu Khóa Tự Động D&D Fashion - Bo tròn đen",50000,100000,50000,50
TIKI,phu-kien-thoi-trang,186529149,"Kính lão đọc sách gọng dẻo không viền kiểu dáng thanh lịch dành cho nam và nữ",17000,88000,71000,81
TIKI,phu-kien-thoi-trang,131172564,"30 cái Khẩu trang y tế 4D Khánh An KA99 ngăn bụi vi khuẩn 99% ôm sát khuôn mặt không lem son và rất dễ thở",54400,68000,13600,20
TIKI,phu-kien-thoi-trang,74538119,"Kính Giả Cận, Gọng Kính Cận Nam Nữ Mắt Vuông To Viền Dày GM Không Độ - BLUE LIGHT SHOP",112000,120000,8000,7
TIKI,phu-kien-thoi-trang,90870355,"KÍNH LÃO ĐỌC SÁCH DÀNH CHO NGƯỜI GIÀ (TRÒNG KÍNH)",65000,65000,0,0
TIKI,phu-kien-thoi-trang,10194802,"Đai Đeo Quần Chữ Y Áo Sơ Mi Cố Định 2 Dây Chống Trượt Co Giãn Điều Chỉnh Được",92000,92000,0,0
TIKI,giay-dep-nu,195988870,"Dép Mang Trong Nhà, Trong Phòng Ngủ, Nhà Tắm Lổ Hình Mặt Cười - Hàng Chính Hãng",72680,79000,6320,8
TIKI,giay-dep-nu,59211695,"Giày Sandal Nữ Đế Xuồng BIGGBEN Da Bò Thật SDX19",349000,420000,71000,17
TIKI,giay-dep-nu,76289908,"Giày Búp Bê Nữ Da Bò BIGGBEN Cao Cấp BB77",309000,400000,91000,23
TIKI,giay-dep-nu,22969322,"Dép Nữ BIGGBEN Da Bò Thật DNQN20",289000,400000,111000,28
TIKI,giay-dep-nu,48995794,"Dép dọ bộ đội",40000,40000,0,0
TIKI,giay-dep-nu,109347533,"Dép đế trấu quai chéo nam nữ Detaunisex màu ĐEN - DETA23D",245000,245000,0,0
TIKI,giay-dep-nu,115263791,"Dép Thái Lan Nữ Quai Ngang - Kelly 9",170000,170000,0,0
TIKI,giay-dep-nu,200772589,"Giày nữ cao cấp ELLY – EGM87",824450,1499000,674550,45
TIKI,giay-dep-nu,135373475,"Sandal Biti's nữ",275000,275000,0,0
TIKI,giay-dep-nu,141500349,"Giày sandal xuồng nữ da bò BIGGBEN cao cấp SDX33",299000,410000,111000,27
TIKI,giay-dep-nu,20638254,"Combo 2 Bộ Miếng Dán Gót Giày Silicon V.2 (Trong Suốt, 4 Miếng Dán)",40000,40000,0,0
TIKI,giay-dep-nu,122302168,"Dép đi trong nhà tắm, nhà vệ sinh cao su cao cấp chống trơn trượt không thấm nước đế lỗ thoát nước",48000,55000,7000,13
TIKI,giay-dep-nu,51400704,"Giày lười nữ đi nhẹ êm chân thời trang V229",69000,69000,0,0
TIKI,giay-dep-nu,67601716,"Giày Sandal Cao Gót 3cm Mix Nhiều Màu Pixie X476",300000,300000,0,0
TIKI,giay-dep-nu,153472009,"Giày Búp Bê Nữ Biti’s ÊMBRACE - BLUSH PINK DBW004500HOL (Hồng lợt)",335000,447000,112000,25
TIKI,giay-dep-nu,92555066,"Chai xịt giày Nano Bạc Nano Xclean For Shoes khử mùi hôi giày chống hôi chân 50ML",48400,60500,12100,20
TIKI,giay-dep-nu,59527266,"Giày búp bê nữ đế bằng 2cm đi bộ thời trang mới nhất V252",59000,59000,0,0
TIKI,giay-dep-nu,141474397,"Giày cao gót nữ đẹp đế vuông 5 phân hàng hiệu rosata màu đen đỏ kem ro330",399000,399000,0,0
TIKI,giay-dep-nu,179583715,"Giày búp bê nữ Lolita đính ngọc cao cấp đế 5 phân, 3 phân ôm chân phong cách Hàn Quốc",169000,169000,0,0
TIKI,giay-dep-nu,91010827,"Giày búp bê nữ BIGGBEN da bò cao cấp BB87",309000,400000,91000,23
TIKI,giay-dep-nu,106889202,"giày sanda Dép sandal 3 Quai Ngang kiểu dáng thể thao Hàn Quốc dành cho cặp đôi nam nữ mới",159000,159000,0,0
TIKI,giay-dep-nu,99462355,"Dép xỏ ngón cao gót 7cm bebe Dép Kẹp cao gót 7cm Dép Tông cao gót 7cm Dép 2 quai 7cm Size 35. 36. 37.38.39 dona21051902",61000,69000,8000,12
TIKI,giay-dep-nu,59211327,"Giày Sandal Nữ BIGGBEN Da Bò Thật SDN62",329000,460000,131000,28
TIKI,giay-dep-nu,114252931,"Jibbitz Crocs JB Nature 5 Pcs - 10008700",595000,595000,0,0
TIKI,giay-dep-nu,49264013,"Combo 2 đôi miếng lót mũi giày silicon massage bàn chân trước chống sốc, êm chân, chống trơn trượt",24400,24400,0,0
TIKI,giay-dep-nu,96927613,"Dép nữ Gấu In Hình Chỉ Trần siêu hot- 2 MÀU ĐEN KEM",90000,90000,0,0
TIKI,giay-dep-nu,190759720,"Dép Đế Xuồng Nữ Da Bò Thật BIGGBEN Cao 5cm DX39",299000,400000,101000,25
TIKI,giay-dep-nu,36980153,"Giày Sandal Nữ BIGGBEN Da Bò Thật SDN44 - 38",339000,400000,61000,15
TIKI,giay-dep-nu,195464769,"1 cặp đệm silicon chống chai và cong vẹo/biến dạng ngón chân #sil 13",65000,65000,0,0
TIKI,dien-tu-dien-lanh,114984995,"Tủ lạnh Sharp Inverter 525 lít SJ-FXP600VG-BK - Chỉ giao Hà Nội",20490000,20490000,0,0
TIKI,dien-tu-dien-lanh,45370601,"Remote Điều Khiển Dành Cho Smart TV, Internet TV, LED TV SAMSUNG BN59-01178W  - Hàng nhập khẩu",45000,45000,0,0
TIKI,giay-dep-nu,84880140,"Giày búp bê nữ đế bằng 2cm đi bộ thoáng khi cực êm chân V277",69000,69000,0,0
TIKI,giay-dep-nu,187386074,"Giày Sandal Xuồng Nữ Da Bò Thật BIGGBEN Cao 9cm SDX37",349000,400000,51000,13
TIKI,giay-dep-nu,91255452,"Giày Sandal Đế Xuồng Nữ Da Bò BIGGBEN Cao Cấp SDX28",339000,460000,121000,26
TIKI,dien-tu-dien-lanh,126701894,"Điều khiển đầu thu DV3-T2",33250,35000,1750,5
TIKI,giay-dep-nu,270123060,"GIày Búp Bê BIGGBEN Da Bò Thật Cao Cấp BB43",299000,400000,101000,25
TIKI,giay-dep-nu,2730205,"Combo 4 cặp Lót giày êm chân Size Nữ - Màu ngẫu nhiên size",67000,71000,4000,6
TIKI,dien-tu-dien-lanh,72800012,"[Chính Hãng] Máy Nước Nóng Centon M777E 6.0kW",3100000,3100000,0,0
TIKI,dien-tu-dien-lanh,73098563,"Điều khiển chính hãng Điều hoà Panasonic Model CS-KC12NKH-8",260000,260000,0,0
TIKI,dien-tu-dien-lanh,195959600,"Tủ lạnh Mini Electrolux 94 lít EUM0930AD-VN - Hàng chính hãng [Giao hàng toàn quốc]",3850000,3990000,140000,4
TIKI,dien-tu-dien-lanh,106912535,"Máy Rửa Chén Bát Texgio 15 Bộ TGF3815B- Hé cửa tự động, Hàng nhập khẩu",14000000,14000000,0,0
TIKI,dien-tu-dien-lanh,102639557,"Tủ lạnh Panasonic Inverter 188 lít NR-BA229PAVN - Hàng chính hãng - Giao tại HN và 1 số tỉnh toàn quốc",7372000,7372000,0,0
TIKI,dien-tu-dien-lanh,11505454,"Giá đỡ 2 màn hình Máy Tính Kẹp Bàn, chuyển động Đầy Đủ 360 độ cho màn Hình 10-27inch, tải trọng đến 9,9kg",339000,339000,0,0
TIKI,dien-tu-dien-lanh,127217382,"Máy rửa bát Mini di động Klarstein Amazonia 8 màu bạc - hàng chính hãng",12900000,12900000,0,0
TIKI,giay-dep-nu,171812308,"Giày sandal nữ đế bằng cao 4,5cm Trường Hải màu kem thời trang cao cấp SD2778",293000,399000,106000,27
TIKI,dien-tu-dien-lanh,126702164,"Remote Điều khiển từ xa điều hòa dành cho Mitsubishi dùng cho các dòng MSY- MSZ- MS",55000,55000,0,0
TIKI,dien-tu-dien-lanh,53447185,"Tủ đông Hòa Phát HCF 666S1N2 352 lít - Hàng Chính Hãng",7450000,7450000,0,0
TIKI,dien-tu-dien-lanh,185351186,"Điều hòa 1 chiều inverter 12000BTU/H NIS-C12R2H11- Giao hàng toàn quốc - Hàng chính hãng",7190000,12390000,5200000,42
TIKI,dien-tu-dien-lanh,68248889,"Máy rửa bát Spelier SP-08 UOZ - Hàng Chính Hãng",9900000,9900000,0,0
TIKI,dien-tu-dien-lanh,86155652,"Máy sấy LG 9 Kg DVHP09W - HÀNG CHÍNH HÃNG - CHỈ GIAO TẠI HCM",17990000,17990000,0,0
TIKI,giay-dep-nu,248977575,"Giày Vải Nam Nữ Vải Canvas Cổ Cao Và Cổ Thấp Màu Đen,Giày Vải Học Sinh Sinh Viên GV01",135000,135000,0,0
TIKI,dien-tu-dien-lanh,119823879,"Remote Điều khiển đầu thu dành cho FPT Play Box",89000,89000,0,0
TIKI,dien-tu-dien-lanh,126702153,"Remote Điều khiển từ xa đầu thu dành cho FPT Play Box 2017",86450,91000,4550,5
TIKI,dien-tu-dien-lanh,157425785,"ĐIỀU KHIỂN DÙNG CHO PANASONIC THƯỜNG 1 CHIỀU",95000,95000,0,0
TIKI,dien-tu-dien-lanh,171616931,"Tủ lạnh LG Inverter 635 Lít GR-X257MC - Chỉ giao Hà Nội",38500000,38500000,0,0
TIKI,dien-tu-dien-lanh,165964330,"Ron tủ lạnh  dành cho tủ lạnh  Panasonic NR-BU302",242250,242250,0,0
TIKI,dien-tu-dien-lanh,192074170,"Máy Rửa Chén Âm Bán Phần KAFF KF-BDWSI12.6 - 14 Bộ - Hàng Chính Hãng",26800000,26800000,0,0
TIKI,dien-tu-dien-lanh,4178855,"Máy Nước Nóng Ferroli VERDI 15L SE (2500W)",2438000,2438000,0,0
TIKI,dien-tu-dien-lanh,123602434,"wifi mắt nhận dành cho LG 2020",200000,200000,0,0
TIKI,giay-dep-nu,187375766,"Giày sandal Nữ Da Bò Thật BIGGBEN Cao Cấp SDN79",309000,400000,91000,23
TIKI,dien-tu-dien-lanh,126702246,"Điều khiển điều hòa dành cho Hitachi dùng cho các dòng RAS-X RAS- RAS-EJ 1HP 1.5HP 2HP 9000 12000BTU",53200,56000,2800,5
TIKI,dien-tu-dien-lanh,103223020,"Tủ lạnh Electrolux Inverter 308 lít EBB3402K-A - Hàng chính hãng - Giao tại Hà Nội và 1 số tỉnh toàn quốc",8690000,8690000,0,0
TIKI,giay-dep-nu,160874992,"Lót giày tăng chiều cao nam nữ Sans921 cặp miếng độn giầy nâng đế 2cm 3cm 4cm 5cm cả nửa bàn",39999,39999,0,0
TIKI,dien-tu-dien-lanh,459587,"Máy Nước Nóng Ferroli VERDI 15L TE (2500W)",2208000,2208000,0,0
TIKI,dien-tu-dien-lanh,4176685,"Máy Nước Nóng Ferroli VERDI 30L TE (2500W)",2499000,2499000,0,0
TIKI,dien-tu-dien-lanh,459525,"Máy Nước Nóng Ferroli Divo SSP 4.5S (4500W)",2486000,2486000,0,0
TIKI,dien-tu-dien-lanh,41098424,"Android Tivi Box TX3 Mini A Ram 2Gb Rom 16Gb 4K UltraHD - Hàng Chính Hãng",620000,620000,0,0
TIKI,dien-tu-dien-lanh,197344458,"Máy Rửa Chén Công Nghiệp CLASSEQ P500AS - Hàng Chính Hãng",102300000,102300000,0,0
TIKI,dien-tu-dien-lanh,756761,"Tủ Lạnh Sharp Inverter 556L SJ-FX630V-ST - Giao Tại HCM",16890000,16890000,0,0
TIKI,dien-tu-dien-lanh,165964342,"Ron tủ lạnh kiểu gài nhiều kích thước thích hợp các dòng tủ lạnh SamSung, LG, Sanyo, Pana",170000,170000,0,0
TIKI,dien-tu-dien-lanh,191088392,"Máy Giặt Sấy Cửa Trước Panasonic 10,5 Kg giặt 6kg sấy NA-S056FR1BV - Diệt khuẩn đến 99.99% - Giặt sấy 2 trong 1- Hàng Chính Hãng (Đen) - Giao Toàn Quốc",17890000,23090000,5200000,23
TIKI,giay-dep-nu,106552818,"Giày búp bê nữ đế xuồng da bò BIGGBEN BB93",309000,400000,91000,23
TIKI,giay-dep-nu,193878917,"Giày lười vải nữ, đế cao su mềm , cao 2p",132000,149000,17000,11
TIKI,dien-tu-dien-lanh,96596701,"Smart Tivi LG 4K 43 inch 43UP7720PTC",7350000,7350000,0,0
TIKI,dien-tu-dien-lanh,229721760,"Máy nước nóng trực tiếp Ariston 4500W AURES PREMIUM 4.5 - Hàng Chính Hãng",1989000,1989000,0,0
TIKI,dien-tu-dien-lanh,170921906,"Tủ lạnh LG Inverter 635 Lít GR-D257WB Mới 2022 - Hàng chính hãng- Giao hàng tại Hà Nội",24500000,24500000,0,0
TIKI,dien-tu-dien-lanh,75364280,"ĐIỀU KHIỂN ĐẦU THU KỸ THUẬT SỐ VỆ TINH VTC HD V2 HÀNG CHÍNH HÃNG.",78000,78000,0,0
TIKI,dien-tu-dien-lanh,258496318,"Smart Tivi QLED 4K 98 inch Samsung QA98Q80C - Hàng Chính Hãng - Chỉ Giao Hà Nội",115500000,115500000,0,0
TIKI,dien-tu-dien-lanh,73545529,"Máy Rửa Kết Hợp Bồn KF-SWM6 - Hàng Chính Hãng",23040000,23040000,0,0
TIKI,dien-tu-dien-lanh,145764244,"Tấm Chắn Điều Chỉnh Hướng Gió Cho Máy Lạnh Điều Hòa Cao Cấp 90x27cm",69980,69980,0,0
TIKI,phu-kien-thoi-trang,191747807,"Thắt lưng nam da bò nguyên chất mặt khóa tự động hợp kim cao cấp phong cách cá tính",315000,350000,35000,10
TIKI,phu-kien-thoi-trang,173432915,"Mũ cói lưới chữ M - nón cói vành nhỏ chống nắng, đi biển phong cách Hàn",47500,95000,47500,50
TIKI,phu-kien-thoi-trang,56266792,"Kẹp tóc đính đá đẹp",199000,199000,0,0
TIKI,phu-kien-thoi-trang,168564753,"Tất Cổ Cao Sợi Tre Cao Cấp, Vớ Nam Đi Giày Tây Vải Sợi Tre Mềm Mịn, Thoáng Mát - GOMTAT-TRECAO-1DOI",36000,60000,24000,40
TIKI,phu-kien-thoi-trang,145092613,"Set 2 kẹp tóc phong cách Hàn Quốc - Kẹp tóc đuôi ngựa - Bộ 2 kẹp tóc nơ xoắn ( giao 2 màu khác nhau) ",68000,68000,0,0
TIKI,phu-kien-thoi-trang,73616850,"Gọng Kính Cận Gọng Cận Nam Nữ Cao Cấp Thời Trang Hàn Quốc VINIEL SM17",259000,380000,121000,32
TIKI,phu-kien-thoi-trang,136199696,"Bộ 10 đôi vớ chống nắng nữ màu da - tất da nữ xỏ ngón - P15-10",64000,64000,0,0
TIKI,phu-kien-thoi-trang,179998195,"Mũ lưỡi trai trơn CAPMEN, nón kết nam nữ form dáng thể thao basic ullzang vải kaki cotton cao cấp",34000,34000,0,0
TIKI,phu-kien-thoi-trang,58797572,"Nón bucket 2 mặt hoa cúc vành rộng 5.5Cm 3 màu",38000,38000,0,0
TIKI,phu-kien-thoi-trang,53232442,"Dây cột tóc scrunchies dễ thương",19900,19900,0,0
TIKI,phu-kien-thoi-trang,13771535,"Mũ Bucket It's so nice",33000,33000,0,0
TIKI,phu-kien-thoi-trang,77639754,"Nón kết nam thời trang vài kaki bền đẹp giữ form, dễ dàng tăng giảm size, (Giao logo ngẫu nhiên) - Hạnh Dương",38000,38000,0,0
TIKI,phu-kien-thoi-trang,49739920,"Kính Giả Cận Nam Nữ Gọng Kính Cận Clubmaster TF Đen Bạc",108000,125000,17000,14
TIKI,phu-kien-thoi-trang,23210255,"Tóc Búi Xoăn Cột J25C ",28000,45000,17000,38
TIKI,phu-kien-thoi-trang,62361206,"Nước Nhỏ Mắt Kính Áp Tròng Vision Drop (15ml)",80000,80000,0,0
TIKI,phu-kien-thoi-trang,164021995,"Kính Mát Nam, Kính Mát Nam Nữ, Kính Mát Thời Trang Tròng Kính Phân Cực Chống Chói, Chống Lóa Gọng Vuông Hot Hit AK011 - Aoron",220000,320000,100000,31
TIKI,phu-kien-thoi-trang,148678512,"Mũ bucket nam nữ nón tai bèo họa tiết chữ NY 2 mặt vành tròn Nhiều Màu Phong Cách Ulzzang Unisex",34003,34003,0,0
TIKI,phu-kien-thoi-trang,91089258,"Kính lão thị viễn thị trung niên hai tròng nhìn xa và gần cực tiện lợi",199000,199000,0,0
TIKI,phu-kien-thoi-trang,194807589,"Kẹp tóc nữ hàn quốc NASI hoa hồng nhỏ xinh dễ thương cute kẹp tóc mái kẹp tóc càng cua",9000,9000,0,0
TIKI,phu-kien-thoi-trang,193104552,"Khẩu trang y tế 4 lớp Khánh An mẫu mới SMS kháng khuẩn cao cấp",39200,49000,9800,20
TIKI,phu-kien-thoi-trang,32429456,"Dây thun cột buộc tóc nữ - Combo 6 cái (màu ngẫu nhiên)",25000,25000,0,0
TIKI,phu-kien-thoi-trang,181692373,"Lens nâu tự nhiên có độ Mochi thương hiệu Angel Eyes đường kính 14.2 có độ từ 0 đến 6",150000,150000,0,0
TIKI,phu-kien-thoi-trang,50329467,"Cài tóc nam nữ viền tròn",13800,13800,0,0
TIKI,phu-kien-thoi-trang,101644599,"Nón kết/ mũ lưỡi trai kaki 100% cotton Unisex Nomac thêu chữ CRUISE NON0608",150000,150000,0,0
TIKI,phu-kien-thoi-trang,67254429,"KHẨU TRANG PITTA MÀU TRẮNG SIZE REGULAR (GÓI 3 CÁI)",180000,180000,0,0
TIKI,phu-kien-thoi-trang,119193041,"Vải lông nhung trắng tinh và hồng phấn 1m và 39 màu bảng màu 5075 175",14950,14950,0,0
TIKI,phu-kien-thoi-trang,72050320,"Khẩu Trang Pitta Nhật Bản Small Mode - Gói 3 cái khác màu (mẫu mới 2020)",180000,180000,0,0
TIKI,phu-kien-thoi-trang,7880127,"Khăn Choàng Lụa Tổng Hợp HN009 - Size 90cm X 180cm",200000,200000,0,0
TIKI,phu-kien-thoi-trang,2343077,"Đai kẹp giữ áo sơ mi kẹp sắt bấm",83000,83000,0,0
TIKI,phu-kien-thoi-trang,48261035,"Kính viễn thị cao cấp kính lão thị TITAN siêu dẻo sẵn độ +1.00 đến +4.00 mắt cực sáng và trong JAPA7361CP",105840,147000,41160,28
TIKI,phu-kien-thoi-trang,145461460,"[VIDEO]-Khăn choàng lụa đa năng- Khăn choàng cổ cao cấp, khăn lụa phụ kiện thời trang 70x70cm, chọn mẫu",99000,128700,29700,23
TIKI,phu-kien-thoi-trang,120461847,"Combo 10 Đôi Tất Gấu Nữ Cổ Ngắn Chất Đẹp Tặng Kèm Túi Đẹp",19889,19889,0,0
TIKI,phu-kien-thoi-trang,74362211,"khăn rằn campuchia",50000,50000,0,0
TIKI,phu-kien-thoi-trang,108771196,"Thắt lưng nam dây nịt nam chất liệu da bò thật khóa tự động hàng hiệu cao cấp NT299 - Nutushop",320000,320000,0,0
TIKI,phu-kien-thoi-trang,683253,"Kính Mát Unisex Exfash EF5980 966 (58/18/140) - Đen Khói",344000,460000,116000,25
TIKI,phu-kien-thoi-trang,74257254,"Mũ bucket thêu hình Carrot và Cầu Vồng đẹp mắt, đội được 2 mặt với 2 màu khác nhau, dành cho nam và nữ đội đi chơi, đi học, đi làm",48000,48000,0,0
TIKI,phu-kien-thoi-trang,174605436,"Khăn ống trùm đầu đa năng Khẩu trang đa năng In hình Chất liệu vải siêu co giãn 1 lớp,Chống nắng,Hiệu AIDA Made in Korea",26000,26000,0,0
TIKI,phu-kien-thoi-trang,41100353,"Kính viễn thị kính đọc sách kiểu dáng thể thao nửa viền nam tính mắt cực sáng KV667",71280,99000,27720,28
TIKI,phu-kien-thoi-trang,48068915,"Kẹp tóc hình hoa đính đá xinh xắn dành cho nữ",58000,80000,22000,28
TIKI,phu-kien-thoi-trang,167401051,"Thắt Lưng Nữ Bản Nhỏ Trẻ Trung Mặt Khóa Kim Loại Hình Chữ Nhật Chất Liệu Da PU TL018 MayHomes Dây Lưng Nữ, Dây Nịt Nữ Đa Năng Bền Chắc Dùng Cho Đầm, Jeans, Quần Âu Và Shorts",57000,65000,8000,12
TIKI,dien-tu-dien-lanh,50386402,"Remote VTC HDV2 Dùng Cho Đầu Thu Vệ Tinh VTC - Hàng Chính Hãng",69000,69000,0,0
TIKI,dien-tu-dien-lanh,96778060,"Càng dành cho máy giặt Electrolux 10932 cốt phi 30mm, chảng ba ",550000,550000,0,0
TIKI,dien-tu-dien-lanh,108298645,"Máy Rửa Chén Bát Texgio 8 Bộ TGWF68GB - Hàng Chính Hãng",11800000,11800000,0,0
TIKI,dien-tu-dien-lanh,114447971,"Giá Treo Màn Hình NB H100 22 - 35 Inch - Hàng chính hãng",365000,365000,0,0
TIKI,dien-tu-dien-lanh,50590607,"Smart Tivi Samsung HD 32 inch UA32T4300",5330000,5330000,0,0
TIKI,dien-tu-dien-lanh,1933169,"Bình nước nóng Ferroli QQME20L Chống giật 2.500W - Hàng Chính Hãng",2238000,2238000,0,0
TIKI,dien-tu-dien-lanh,181784346,"Điều hòa di động Casper PC-09TL33 - Hàng chính hãng - Giao hàng Hà Nội",5469000,5469000,0,0
TIKI,dien-tu-dien-lanh,126702233,"Remote Điều khiển từ xa tivi dành cho Samsung cơ 2020 cho các dòng tivi  từ 2015 đến 2021",56000,56000,0,0
TIKI,dien-tu-dien-lanh,95016848,"{ Bảo hành 06 tháng} Remote  điều khiển  tivi giọng nói{ sản phâm y hệt như video}",430000,430000,0,0
TIKI,dien-tu-dien-lanh,20549992,"Điều Hòa Inverter Daikin FTKC50UVMV/RKC50UVMV (17.700Btu) - Hàng Chính Hãng",19000000,19000000,0,0
TIKI,dien-tu-dien-lanh,70354053,"Bình nóng lạnh Panasonic DH-20HBMVW 20L, hàng chính hãng",2990000,2990000,0,0
TIKI,dien-tu-dien-lanh,121268142,"Máy giặt Aqua Inverter 9.0 KG AQD-A900F S - Hàng chính hãng(Giao Toàn Quốc)",7990000,7990000,0,0
TIKI,dien-tu-dien-lanh,189470899,"Google Tivi Sony 4K 75 inch XR-75X90K - Hàng Chính Hãng - Chỉ Giao Hà Nội",34790000,34790000,0,0
TIKI,dien-tu-dien-lanh,136353882,"Máy Nước Nóng Maxvic",2850000,2850000,0,0
TIKI,dien-tu-dien-lanh,109074993,"Smart Tivi FFALCON HD 32 inch 32SF1",4650000,4650000,0,0
TIKI,dien-tu-dien-lanh,103342869,"ĐIỀU KHIỂN MÁY LẠNH,ĐIỀU HÒA LG INVERTER (SP 1203)",46000,46000,0,0
TIKI,dien-tu-dien-lanh,11639814,"Tủ Lạnh Gorenje Retro ORB152GR (260L) - Hàng Nhập Khẩu",53790000,53790000,0,0
TIKI,dien-tu-dien-lanh,106421267,"Bo Mạch Quạt Điều Hòa",369000,369000,0,0
TIKI,dien-tu-dien-lanh,217285973,"Remote Điều Khiển Dành Cho Smart TV LG, Internet Tivi, Ti Vi Thông Minh LG AKB75095315",32000,32000,0,0
TIKI,dien-tu-dien-lanh,87909059,"Smart Tivi Crystal Samsung 4K 43 inch UA43AU8000",9090000,9090000,0,0
TIKI,dien-tu-dien-lanh,170490163,"Bình Nước Nóng Atlantic Nanto LITE - Hàng chính hãng",2430000,2430000,0,0
TIKI,dien-tu-dien-lanh,73103399,"ANTEN DVB T2 AVG NGOÀI TRỜI MÀU NÂU CHÍNH HÃNG",20000,20000,0,0
TIKI,dien-tu-dien-lanh,126702192,"Remote điều khiển tivi dành cho Sharp L1346 dùng cho các dòng 2T-C 4T-C LC- 32inch 40inch 42inch 4K 60inch",45000,45000,0,0
TIKI,dien-tu-dien-lanh,79386023,"Smart Tivi Neo QLED Samsung 4K 65 inch QA65QN85A",31490000,31490000,0,0
TIKI,dien-tu-dien-lanh,689579,"Máy giặt LG Inverter 8 kg FC1408S4W2",12900000,12900000,0,0
TIKI,dien-tu-dien-lanh,216467100,"Giá Treo Tivi Di Động NB TW85 nâng hạ điện tử tự động HÀNG CHÍNH HÃNG NORTHBAYOU đầy đủ CO,CQ",2750000,2750000,0,0
TIKI,dien-tu-dien-lanh,101459481,"Máy Rửa Chén Bát Texgio 8 Bộ TGWF98SB-Hàng nhập khẩu nguyên chiếc",11000000,11000000,0,0
TIKI,dien-tu-dien-lanh,173635484,"Bộ anten mini khuếch đại DVB-T2 thu truyền hình số mặt đất Hoành Kiến Đạt kèm dây 15m và dây cáp nguồn",158000,158000,0,0
TIKI,dien-tu-dien-lanh,97729346,"Bộ giá đỡ điều hòa 9.000BTU đến 12.000BTU",71500,71500,0,0
TIKI,dien-tu-dien-lanh,178058661,"Google Tivi Sony 4K 65 inch KD-65X81DK - Model 2022",17400000,17400000,0,0
TIKI,dien-tu-dien-lanh,55238996,"Điều Hòa Inverter Casper GC-09TL32 (9.000BTU) - Hàng Chính Hãng - Chỉ Giao Tại Hà Nội",6290000,6290000,0,0
TIKI,dien-tu-dien-lanh,125348984,"Tủ lạnh Casper Inverter 218 lít RT-230PB - Chỉ giao Hà Nội",5150000,5150000,0,0
TIKI,dien-tu-dien-lanh,20551120,"Máy giặt Aqua 9 Kg AQW-U91CT N",5990000,5990000,0,0
TIKI,dien-tu-dien-lanh,169772502,"Smart Tivi QLED Samsung 4K 65 inch QA65Q80B - Model 2022",20950000,20950000,0,0
TIKI,dien-tu-dien-lanh,183320591,"(Hàng Chính Hãng) Máy Rửa Chén Âm Tủ Electrolux ESL5343LO - 13 Bộ Chén Đĩa",16490000,16490000,0,0
TIKI,dien-tu-dien-lanh,174183296,"Tvbox SmartTV MECOOL Android 10 điều khiển giọng nói GoVoice Assistant - Hàng nhập khẩu",1280000,1280000,0,0
TIKI,dien-tu-dien-lanh,42611557,"Remote Điều Khiển Dùng Cho Máy Lạnh, Điều Hòa Panasonic Inverter CU/CS-S9RKH-8 (Kèm pin AAA Maxell) - Hàng nhập khẩu",67000,67000,0,0
TIKI,dien-tu-dien-lanh,126032520,"[Lắp đặt trong vòng 24h] Máy giặt cửa trên Panasonic 9Kg NA-F90S10BRV - Hàng chính hãng",6950000,6950000,0,0
TIKI,dien-tu-dien-lanh,98025542,"ĐIỀU HOÀ KHÔNG KHÍ ÂM TRẦN 3HP AKINO ID-CA28FST1FA-28000BTU-Hàng Chính Hãng- (Giao Hàng Toàn Quốc)",27000000,27000000,0,0
TIKI,dien-tu-dien-lanh,53381748,"Tủ lạnh Funiki Hòa Phát FR 166ISU 160 lít - Hàng Chính Hãng",4090000,4090000,0,0
TIKI,giay-dep-nu,44450593,"Miếng Đệm Lót Giày Êm Chân Chống Rộng Chống Đau Mỏi Chân Dành Cho Size Nam Và Nữ Full Size Từ 35 Đến 44, Chất Liệu Vải Thấm Hút Mồ Hôi ĐI Cực Êm Chân 4 Màu Lựa Chọn Đen, Kem, Ghi, Xanh",29000,29000,0,0
TIKI,giay-dep-nu,172812137,"Dép quai ngang nữ đế xuồng 10F",220000,220000,0,0
TIKI,giay-dep-nu,179509172,"Giày thể thao nữ basic đế bằng cao 4cm êm chân đi học đi làm đi chơi đơn giản màu trắng sneaker",248000,248000,0,0
TIKI,giay-dep-nu,87003974,"Dép Sục Nữ Da Bò BIGGBEN Cao Cấp SBN34",339000,450000,111000,25
TIKI,giay-dep-nu,192364649,"GIÀY SNEAKER, THỂ THAO COLE HAAN NỮ ZERØGRAND CHANGEPACE LACE UP SNEAKER W24081",2295000,4590000,2295000,50
TIKI,giay-dep-nu,68991493,"Giày Nữ Búp Bê Da Bò Thật HÀ NAM Cao Cấp BBN2028",321000,321000,0,0
TIKI,giay-dep-nu,140459365,"Giày Mũi Vuông (Gót Mềm -Da Thật Mềm Như Bún) Công Sở Văn Phòng Nữ Tiếp Viên Hàng Không Gót Vuông FFAN STORE",470000,470000,0,0
TIKI,giay-dep-nu,59564327,"Giày Nữ Búp Bê TOMOYO Da Microfiber Siêu Nhẹ Siêu Thoáng TMW21400",699000,699000,0,0
TIKI,giay-dep-nu,125099344,"Giày Lười Nữ Anh Khoa A83 C83",170000,170000,0,0
TIKI,giay-dep-nu,114740322,"GIÀY CƯỚI - GIÀY CÔ DÂU BEJO H51 3HOA,CÀNH NGỌC - WEDDING SHOES",699000,699000,0,0
TIKI,giay-dep-nu,79556240,"Giày búp bê nữ đẹp vải đi êm chân hài búp bê cao 2cm V275",69000,69000,0,0
TIKI,giay-dep-nu,71047840,"Giầy búp bê bệt siêu mềm thoáng chân chịu nước GN19",85000,85000,0,0
TIKI,giay-dep-nu,88085978,"Dép kẹp nữ, Tông nữ loại CAO CẤP thương hiệu XMI siêu sịn sò",195000,195000,0,0
TIKI,giay-dep-nu,183913161,"Giày sandal nữ 2 quai ngang đế bằng học sinh  V310",99000,99000,0,0
TIKI,giay-dep-nu,10233812,"Sneaker nữ siêu nhẹ đế cao - SMG Sporty High Flex X",750000,750000,0,0
TIKI,giay-dep-nu,253620790,"Giày cao gót nữ 9p RO522 ROSATA tại BCASHOP hở mũi, quai ngang nổi bậc với những trái tim nhiều hạt lấp lánh màu xanh",449000,449000,0,0
TIKI,giay-dep-nu,65199996,"Sandal nữ hoa cúc quai ngang mới 003",149000,149000,0,0
TIKI,phu-kien-thoi-trang,192178472,"Khăn Rằn Nam Bộ - Campuchia/ Khăn Thời Trang NOMAC Đi Phượt, Du Lịch, Trekking/ Hàng Loại 1, Vải Dày Mềm Mịn/ Kích Thước Lớn 170 x 60cm/ Combo C",85000,85000,0,0
TIKI,giay-dep-nu,261971496,"Giày Converse nữ chất vải canvas màu đen đế hồng cao su CX Street Utility-170993C",2000000,2000000,0,0
TIKI,giay-dep-nu,67539637,"Sandal cao su đúc siêu nhẹ và bên đi êm chân",129000,129000,0,0
TIKI,giay-dep-nu,142783308,"[CHẤT LƯỢNG] Dép lông đi trong nhà bít mũi Ông Già Noel cute SC006 Cỏ Boutique, dẻo mềm, êm chân, giữ ấm bàn chân",155000,165000,10000,6
TIKI,giay-dep-nu,23351162,"Giày cao gót nữ 9 phân gót nhọn da bóng",189000,189000,0,0
TIKI,giay-dep-nu,112961992,"Sandal chiến binh nữ 7 dây hot trend 2020 trẻ trung năng động 21435",166700,278300,111600,40
TIKI,phu-kien-thoi-trang,194818550,"Kẹp tóc nữ hàn quốc NASI màu ngọc cao cấp xinh xắn dễ thương kẹp tóc mái phụ kiện tóc",22000,22000,0,0
TIKI,phu-kien-thoi-trang,143377207,"Cài tóc tai mèo dễ thương",29000,29000,0,0
TIKI,phu-kien-thoi-trang,177091947,"Khăn choàng cổ nữ, chất liệu lụa cao cấp 70x70cm-CHỌN MẪU- Khăn lụa quàng cổ, khăn Turban vuông biến hóa nhiều kiểu",99000,138600,39600,29
TIKI,giay-dep-nu,200930070,"Giày Sneaker Nữ Cột Dây Cổ Vừa Tản Nhiệt Thông Hơi Đế Cao Su Non Êm Chân Kiểu Dáng Năng Động Nhiều Màu Đủ Size GTTN31",145000,145000,0,0
TIKI,giay-dep-nu,149128383,"Giày Sandal Nữ Cao Gót TiTi ĐÔ Da Bò Thật Cao Cấp DNU2092a",331000,331000,0,0
TIKI,giay-dep-nu,215745862,"Giày bốt nữ cổ ngắn 5p RO289 ROSATA tại BCASHOP mũi vuông nhẹ, phối 3 nút lạ mắt và cá tính - màu kem",489000,489000,0,0
TIKI,giay-dep-nu,125099135,"Giày lười nữ Anh Khoa D115",190000,190000,0,0
TIKI,phu-kien-thoi-trang,77157175,"Mũ lưỡi trai nữ Cà Rốt - Cầu Vồng chất liệu vải nhung tăm gân nổi mềm mại, thời trang, dễ dàng tăng giảm size đầu - Hạnh Dương",48000,48000,0,0
TIKI,phu-kien-thoi-trang,192568301,"Set 3 Kẹp tóc càng cua trong suốt loại đẹp",23000,35000,12000,34
TIKI,phu-kien-thoi-trang,59508506,"Gọng kính cận, gọng kính unisex SARIFA 2331-2460 nhiều màu",99000,450000,351000,78
TIKI,phu-kien-thoi-trang,105211527,"Khăn mùi xoa nữ / khăn tay nữ cao cấp Christian Hàn quốc - nhập khẩu chính hãng Hàn Quốc",69000,69000,0,0
TIKI,phu-kien-thoi-trang,96313459,"  Khăn Lau Kính (Khăn Đa Năng) Chuyên Dụng Lau Mắt Kính Cận, Kính Râm Mặt Kính Điện Thoại - HH000",2200,2200,0,0
TIKI,giay-dep-nu,68428366,"Giầy búp bê hở gót đi 2 kiểu tiện lợi chất nhựa chịu nước trống trượt thời trang dạo phố - đi biển vân sần mầu sắc dễ thương GN07",65000,65000,0,0
TIKI,phu-kien-thoi-trang,191648119,"Cavat nam bản 6cm giangpkc",79200,79200,0,0
TIKI,giay-dep-nu,52242929,"Dép Nữ Đế Xuồng BIGGBEN Da Bò Thật DX19",339000,400000,61000,15
TIKI,giay-dep-nu,101053589,"Giày boot nữ cổ lửng da lộn sành điệu Dành Cho Chị Em TL20193",277800,381220,103420,27
TIKI,giay-dep-nu,199764806,"Giày bốt nữ cổ thấp thời trang cao cấp 7p RO369 ROSATA tại BCASHOP mang 1 nét đẹp lộng lẫy và cá tính",599000,599000,0,0
TIKI,phu-kien-thoi-trang,125913885,"Hộp kim chỉ đa năng đầy đủ chi tiết cho việc khâu vá",21990,21990,0,0
TIKI,giay-dep-nu,42736354,"Giày đế xuồng nữ TLG 20300-8",459000,459000,0,0
TIKI,giay-dep-nu,91270908,"Dép Đế Xuồng Nữ Da Bò BIGGBEN Cao Cấp DX31",309000,350000,41000,12
TIKI,giay-dep-nu,177644514,"Dép nữ da bò thật BIGGBEN cao cấp DNQN44",299000,350000,51000,15
TIKI,phu-kien-thoi-trang,71076443,"Mũ Nam Nón kết Nam thời thượng, cá tính , theo kịp hottrend  màu chất! Đội đi phượt, đi bão, bao ngầu",35000,35000,0,0
TIKI,phu-kien-thoi-trang,147420444,"Mũ tai bèo nam nữ vành tròn 2 lớp TIKTOK, nón bucket unisex hottrend",33000,33000,0,0
TIKI,phu-kien-thoi-trang,68848543,"Nón rộng vành, mũ rộng vành gấp gọn sang trọng dn200100201",159000,159000,0,0
TIKI,phu-kien-thoi-trang,274607691,"Combo 5 dây cột tóc hình hoa mặt trời QT - Chính Hãng ( màu ngãu nhiên)",39000,58000,19000,33
TIKI,phu-kien-thoi-trang,164562602,"Kính nữ thời trang giả cận unisex phong cách Hàn Quốc mẫu hot nhất 2022 - ANCHI HOUSE",35000,35000,0,0
TIKI,giay-dep-nu,187313061,"Dép Sục Nữ Da Bò Thật BIGGBEN Cao 5 phân SBN43",289000,329000,40000,12
TIKI,phu-kien-thoi-trang,158223835,"Mắt Kính OAKLEY MARSHAL MNP - OX8091 809101",4460000,4460000,0,0
TIKI,giay-dep-nu,89256547,"Giày Lười Đế Cao Da Thật 8cm L562-141",562000,562000,0,0
TIKI,phu-kien-thoi-trang,125720571,"Bờm cài tóc nhựa nam nữ unisex BN143 và các mẫu khác",17000,17000,0,0
TIKI,phu-kien-thoi-trang,94739863,"Thắt Lưng Nam 2 Sọc Vàng Dây Da Phong Cách Hàn Quốc Khóa Tự Động",45000,90000,45000,50
TIKI,giay-dep-nu,172061924,"Dép nữ xỏ ngón Trường Hải  da bò phối vải đơn giản trẻ trung XN111",219000,299000,80000,27
TIKI,phu-kien-thoi-trang,168964948,"Tất vớ nam nữ cổ trung trơn màu GOMTAT chất liệu cotton cao cấp, có thiết kế thoáng khí, êm mềm đi mát -KLB-TRONLUNG-GANTAM",18900,28000,9100,33
TIKI,phu-kien-thoi-trang,145762858,"Thắt lưng Nam vải dù cao cấp_Khóa luồn con lăn hợp kim không gỉ chắc chắn, tiện dụng - Dây nịt Nam vải Canvas siêu bền, Dây lưng lính",139000,139000,0,0
TIKI,giay-dep-nu,8448820,"Giày Búp Bê BIGGBEN Da Bò Thật Cao Cấp BB28",289000,350000,61000,17
TIKI,phu-kien-thoi-trang,144180949,"Dây khoá áo khoác áo gió giỏ sách HKK 40cm 50cm 60cm 70cm trắng đen phẹc mơ tia",19500,19500,0,0
TIKI,phu-kien-thoi-trang,53434640,"Mũ Hấp Tóc Cá Nhân Hàn Quốc Tại Nhà Cao Cấp 10 Mức Chỉnh Nhiệt",299000,299000,0,0
TIKI,phu-kien-thoi-trang,180995985,"Kẹp tóc búi phối lưới đính nơ chất liệu vải satin",27000,70000,43000,61
TIKI,giay-dep-nu,171876748,"Giày Sneakers Nữ Sọc Caro Cá Tính TOMOYO "SIÊU NHẸ" TMW31207",800000,800000,0,0
TIKI,phu-kien-thoi-trang,54769967,"Thắt Lưng Nữ Khóa Kim Loại Hình Trái Tim Dây Nhựa Dẻo Bền Đẹp TL004 MayHomes Dây Lưng Nữ, Dây Nịt Nữ Thời Trang",49000,49000,0,0
TIKI,phu-kien-thoi-trang,45606613,"NÓN MŨ LEN BERE LÔNG THỎ THỜI TRANG HÀN QUỐC DN19111708E ",166250,175000,8750,5
TIKI,phu-kien-thoi-trang,165708278,"Nón lưới trùm tóc công nhân thực phẩm có vành, mũ vải bảo hộ màu Trắng - Xanh - Vàng - Nâu",25000,25000,0,0
TIKI,giay-dep-nu,139054406,"Giày Múa Vải, Giày Múa Balle Nhập Khẩu Cho Trẻ Em (size 23-33)- LYLYSPORTS",65000,65000,0,0
TIKI,phu-kien-thoi-trang,82376433,"Kính Gọng Kim Loại Mắt Vuông Cao Cấp Hàn Quốc Nam Nữ Cube Chống Lóa Thời Trang Thay Được Mắt Cận",137750,145000,7250,5
TIKI,phu-kien-thoi-trang,173166937,"Combo 10 Đôi Vớ Tất Cổ Ngắn Không Họa Tiết dành cho cả Nam và Nữ",45000,45000,0,0
TIKI,phu-kien-thoi-trang,125270297,"Tất nam cổ cao dệt kim xuất Nhật hàng A chuẩn",28000,28000,0,0
TIKI,phu-kien-thoi-trang,195690711,"Hình xăm không trôi MINI chủ đề động vật, emo, dễ thương, Hình xăm ma thuật, Xăm giống Inkaholic",18000,18000,0,0
TIKI,phu-kien-thoi-trang,96933956,"Kính lão lắp sẵn chuẩn độ gọng kính nhập khẩu chắc chắn bền đẹp",95000,95000,0,0
TIKI,phu-kien-thoi-trang,71092007,"Đai  chống gù lưng nam nữ HT SYS Posture Corrector [tặng 2 miếng trợ lực]",144000,144000,0,0
TIKI,phu-kien-thoi-trang,208179948,"Thắt lưng nữ da bò thật màu trắng BIGGBEN cao cấp NN13",289000,370000,81000,22
TIKI,phu-kien-thoi-trang,96927612,"Set 11 dây Buộc tóc xinh xắn kèm túi rút dễ thương",54000,54000,0,0
TIKI,phu-kien-thoi-trang,188487016,"Bờm tóc tết thắt bím tóc giả xương cá phong cách tự nhiên",85000,85000,0,0
TIKI,phu-kien-thoi-trang,132955899,"ỐNG TAY NỮ MÀU DA Loại mềm mỏng Chất liệu thun Co giãn Thoáng mát Dài 48cm",25000,25000,0,0
TIKI,phu-kien-thoi-trang,110038972,"Mũ lưỡi trai Cruise,Nón kết nhiều màu phong cách Ulzzang form unisex nam nữ",38800,38800,0,0
TIKI,phu-kien-thoi-trang,75523702,"Mũ Len Nữ Lót Lông Phong Cách Hàn Quốc Phong Cách Dễ Thương",89000,89000,0,0
TIKI,phu-kien-thoi-trang,102014129,"Dây Lưng Nữ Khóa Classic Genuine Grain Leather Aaa Jeans",249000,249000,0,0
TIKI,giay-dep-nu,114046674,"Giày Cao Gót 7cm Mũi Vuông Gắn Khoá Pixie X771",450000,450000,0,0
TIKI,giay-dep-nu,194140881,"Thẻ nhớ SDXC SanDisk Extreme Pro SDSDXXD-512G U3 V30 512GB 200MB/s New 2022 - Hàng Nhập Khẩu",2050000,2050000,0,0
TIKI,giay-dep-nu,176694691,"Thẻ nhớ 32GB/64GB MIXIE Hàng chính hãng",79000,79000,0,0
TIKI,giay-dep-nu,4755383,"Cap Bấm Hình Cartoon (Size 40.5) - Hàng Nhập Khẩu (Giao Màu Ngẫu Nhiên)",69000,69000,0,0
TIKI,giay-dep-nu,198425914,"Camera thông minh Aqara G2H pro AI Full HD 1080p - Bản Quốc Tế - Hàng Chính Hãng",1320000,1320000,0,0
TIKI,giay-dep-nu,825520,"Ống Kính Yongnuo YN AF-S 50mm F/1.8 Cho Nikon - Hàng nhập khẩu",1990000,1990000,0,0
TIKI,giay-dep-nu,6921779,"Micro thu âm đa năng Boya BY-MM1 - Hàng nhập khẩu",430000,430000,0,0
TIKI,giay-dep-nu,88482985,"Camera Wifi - Camera Ip Trong Nhà EZVIZ C6N 1080P - Đàm Thoại 2 Chiều - Xoay 360 Độ Theo Chuyển Động - Hàng nhập khẩu",383900,383900,0,0
TIKI,giay-dep-nu,88861632,"Chân máy ảnh MANFROTTO 190XPRO ALU 3-Section - Chính hãng",4899999,4899999,0,0
TIKI,giay-dep-nu,105652903,"Chân máy ảnh dòng FSL09, Hàng chính hãng",1649999,1649999,0,0
TIKI,giay-dep-nu,34575579,"Máy Ảnh Mini Chụp Hình Cho Bé Loại Cao Cấp 2019",495000,495000,0,0
TIKI,giay-dep-nu,204643382,"Khung L Plate thanh bảo vệ máy ảnh dành cho Sony A7II A7R2 A7S2",299000,299000,0,0
TIKI,giay-dep-nu,7464485,"Loa che nắng hood ET-65III ống kính Canon EF 85mm f1.8 USM ",67000,67000,0,0
TIKI,giay-dep-nu,107047614,"Camera IP Wifi VNPT Technology ONE HOME HVIP01 xoay 360 quan sát rõ ngày và đêm kèm thẻ nhớ hàng Việt Nam",840000,840000,0,0
TIKI,giay-dep-nu,143809133,"Camera nội soi 7mm dùng cho điện thoại Android",289350,289350,0,0
TIKI,giay-dep-nu,57641967,"Camera IP WIFI trong nhà YooSee 2.0 ( 3 anten, 11 led HD) + Thẻ nhớ 32G -  Hàng Nhấp Khẩu",350000,350000,0,0
TIKI,giay-dep-nu,59381719,"dây đeo máy ảnh thao tác nhanh Quick Release XJ",280000,280000,0,0
TIKI,giay-dep-nu,51699597,"NGÀM CHUYỂN AF VILTROX CANON EF-FX2 (0.71X) FOR FUJIFILM Hàng Nhập Khẩu",3999000,3999000,0,0
TIKI,giay-dep-nu,6911647,"Dây Đeo Máy Ảnh Peak Design Slide Lite (Black) - Hàng Chính Hãng",1699999,1699999,0,0
TIKI,giay-dep-nu,91189681,"Đầu đọc thẻ USB 3.0 Card Reader Hỗ trợ thẻ TF và SD UGREEN 20203- Hàng chính hãng",220000,250000,30000,12
TIKI,giay-dep-nu,171124803,"Trọn Bộ 10 Camera Đầy Đủ Phụ Kiện Hikvision 2.0MP Full HD - Hàng chính hãng",10300000,10300000,0,0
TIKI,giay-dep-nu,197154629,"Camera ngoài trời eufy Outdoor Cam Pro 2K E220 chống nước IP67 có đèn chiếu đêm - Hàng Chính Hãng",1650000,1790000,140000,8
TIKI,giay-dep-nu,22365770,"Thẻ nhớ JVJ Micro SDHC Pro 32G C10 – thẻ nhớ chuyên dụng cho camera - Hàng chính hãng",180000,180000,0,0
TIKI,giay-dep-nu,6903641,"Kính lọc Benro Master ND256 (8-Stops) hệ 100mm- Hàng Chính Hãng",1599999,1599999,0,0
TIKI,giay-dep-nu,129249761,"Camera hành trình cao cấp Navicom J247 Pro - Hàng chính hãng",4990000,4990000,0,0
TIKI,giay-dep-nu,192678522,"Khăn lau đa năng dùng cho lau màn hình điện thoại / máy tính bảng / máy tính laptop / ống kính lens máy ảnh / khăn lau kính mắt - Handtown - Hàng Chính Hãng",89000,89000,0,0
TIKI,giay-dep-nu,208129810,"Túi chống sốc máy ảnh và lens vải bố canvas cao cấp",180000,180000,0,0
TIKI,giay-dep-nu,114973774," Ống nhòm viễn vọng chống nước Barska 20-60x80 WP Level  (màu đen) - Hàng chính hãng",15125000,15125000,0,0
TIKI,giay-dep-nu,9804983,"Camera Hành Trình Sjcam SJ8 Pro 4K Wifi - Hàng Chính Hãng",3739000,3939000,200000,5
TIKI,giay-dep-nu,108968436,"Pin Kingma cho Panasonic DMW-BLC12, Hàng chính hãng",399999,399999,0,0
TIKI,giay-dep-nu,56682381,"Trọn Bộ 4 Camera IP PoE Hikvision 2.0MP Tầm Xa Hồng Ngoại 30M Chức Năng Cấp Nguồn Qua Mạng PoE - Hàng Chính Hãng",11954000,11954000,0,0
TIKI,giay-dep-nu,191509288,"Pin Flycam ZLRC SG108 Pro - Phụ kiện hỗ trợ tăng thêm thời gian bay - Hàng nhập khẩu",450000,500000,50000,10
TIKI,giay-dep-nu,108968206,"Combo pin sạc Kingma cho Panasonic DMW-BLC12, Hàng chính hãng",199999,199999,0,0
TIKI,giay-dep-nu,74347298,"Camera Ip Wifi Imou F22FP Hình Ảnh Đầy Màu Sắc Ngay Cả Vào Ban Đêm Full HD 1080P Bullet 2E Tặng Kèm Dây Nối Nguồn 20M - Hàng Chính Hãng",885000,885000,0,0
TIKI,giay-dep-nu,2547051,"Bộ Ống Nối Tăng Độ Phóng Đại Cho Máy Canon (Đen)",159000,159000,0,0
TIKI,giay-dep-nu,46822268,"Bộ Camera Hành Trình Trước Và Sau U5 Dùng Cho Ô Tô, Xe Hơi Sử Dụng Màn Hình DVD Android",1245000,1245000,0,0
TIKI,giay-dep-nu,184876859,"Camera Wifi Yoosee 3 râu 11 led - Xoay 360 độ, cảnh báo chống trộm - Hàng chính hãng",299000,299000,0,0
TIKI,giay-dep-nu,149509501,"Camera an ninh wifi 2 râu (Sóng khỏe Hình nét)",499000,499000,0,0
TIKI,giay-dep-nu,9975567,"Camera HD-TVI Trụ Hồng Ngoại 5MP HIKVISION DS-2CE16H0T-ITPF - Hàng chính hãng",728000,728000,0,0
TIKI,giay-dep-nu,181747823,"Camera WI-FI EZVIZ C3TN 2MP, Ngoài Trời, Không/Có Màu Ban Đêm, IP67 Chống Nước--Hàng Chính Hãng",709000,709000,0,0
TIKI,giay-dep-nu,173479725,"Balo máy ảnh Lowepro Flipside 400 AW III, Hàng chính hãng",3649999,3649999,0,0
TIKI,may-anh,108974355,"Pin Kingma cho Sony NP-F970, Hàng chính hãng",499999,499999,0,0
TIKI,may-anh,126022024,"Bộ Kit camera Wifi HIKVISION NK42W0H(D) (4 CAMERA + 1 Đầu ghi  + 1 Ổ cứng 1.000 GB) - Hàng chính hãng",5298000,5298000,0,0
TIKI,may-anh,274152455,"Đèn Led Quay Phim Zifon T4, Công Suất 10.5w, Nhiệt Màu 3200k - 5600k",825000,825000,0,0
TIKI,may-anh,5876281,"Kính lọc Filter Hoya HMC UV 55mm - Hàng nhập khẩu",329999,329999,0,0
TIKI,may-anh,4708417,"Kẹp Gopro (Đen) -  Hàng Nhập Khẩu",69000,69000,0,0
TIKI,may-anh,158717693,"Camera AI thông minh SC-D3, xoay (Pan&Tilt), tự động phát hiện, lọc và theo dõi người",1100000,1100000,0,0
TIKI,may-anh,20418626,"Đèn LED quay phim  YN360 RGB",2168000,2168000,0,0
TIKI,may-anh,552421,"Đầu Ghi Hình Dahua IP - DVR 16 Kênh NVR4216 - Hàng Chính Hãng",3160000,3160000,0,0
TIKI,may-anh,152546691,"Camera Vietmap VM350 - Giám sát và định vị từ xa - Ghi hình trước và trong xe hành trình ô tô - Hàng chính hãng",4790000,4790000,0,0
TIKI,may-anh,271160214,"Camera WiFi Năng Lượng Mặt Trời NetCAM SL140, Góc Quan Sát 160º, Độ phân giải 3.0MP - Hàng Chính Hãng",1069000,1069000,0,0
TIKI,may-anh,180961149,"BỘ GIẢ PIN/ PIN ẢO DUMMY BATTERY SONY DR-FZ100 VÀ ĐẾ PIN KINGMA BM-F980D -Hàng chính hãng",1094999,1094999,0,0
TIKI,may-anh,182981101,"Đèn led Tube Ulanzi VL110 RGB hàng chính hãng",1100000,1100000,0,0
TIKI,may-anh,67730372,"Kính Hiển Vi 1600X Cắm Cổng USB ( KẾT NỐI DỄ DÀNG, ĐỘ PHÂN GIẢI ẢNH CAO ) - Hàng nhập khẩu",650000,650000,0,0
TIKI,may-anh,15851220,"Hộp Chụp Sản Phẩm Vuông 40x40cm",349900,349900,0,0
TIKI,may-anh,139012656,"Đèn Softbox Led360 5500K 60W HL Lighting Chụp Ảnh Quay Video Phòng Studio, Thiết Bị Ảnh Hàng Chính Hãng",989000,989000,0,0
TIKI,may-anh,16915299,"Micro không dây cho máy ảnh, máy quay Comica CVM-WM200 (A/C) - Hàng chính hãng",6850000,6850000,0,0
TIKI,may-anh,20583823,"Sạp Pin BST-C9001 cho AA - AAA dung lượng lớn có màn hình LCD hiển thị sạc nhanh",179000,179000,0,0
TIKI,may-anh,58450646,"Tay boom đèn Inox MK MF-01 236cm có túi tải trọng.",1599000,1599000,0,0
TIKI,may-anh,109483877,"Chân máy ảnh Coman MT50, Hàng chính hãng",599999,599999,0,0
TIKI,may-anh,162154648,"Camera IP Wifi Ngoài trời 3.0MP VITACAM DZ3000 Pro, PTZ Xoay 355 - Hàng chính hãng",558000,558000,0,0
TIKI,may-anh,108651630,"Bộ 2 pin 1 sạc Kingma cho Canon NB-12L, Hàng chính hãng",999999,999999,0,0
TIKI,may-anh,80236568,"Camera wifi Yoosee 3 Râu xoay 360 trong nhà FullHD 1080 - Hàng Chính Hãng",389000,389000,0,0
TIKI,may-anh,247420614,"Camera IP Wifi Dahua Imou IPC-A22EP 2.0mpx Full HD - Hàng Chính hãng",424000,424000,0,0
TIKI,may-anh,187291480,"Ống kính Sigma 16-28mm f/2.8 DG DN for Sony - Hàng Chính hãng",21490000,21490000,0,0
TIKI,may-anh,2545859,"Mount Dành Cho Canon EOS-FX - Hàng Nhập Khẩu",259000,259000,0,0
TIKI,may-anh,24437557,"Camera công nghiệp nội soi wifi có tay cầm 31501WF",4100000,4100000,0,0
TIKI,may-anh,21196890,"ĐẦU GHI HIKVISION HD-TVI 3MP/5MP 08 KÊNH DS-7208HUHI-K1 (HÀNG CHÍNH HÃNG)",3280000,3280000,0,0
TIKI,may-anh,159633320,"Bóng thổi VSGO Imp air Blower B013E, Gray - Hàng chính hãng",349999,349999,0,0
TIKI,may-anh,37935420,"Bộ 4 cái chân đế treo tường cho camera Dome, camera hình cầu hoặc bán cầu - hàng nhập khẩu",27699,27699,0,0
TIKI,may-anh,195720578,"ĐÈN LED QUAY PHIM YONGNUO YN660LED RGB Hàng Nhập khẩu",4190000,4190000,0,0
TIKI,may-anh,3039847,"Dây Máy Ảnh Peak Design Leash (Xám) - Size Nhỏ - Hàng Chính Hãng",1299999,1299999,0,0
TIKI,may-anh,34700443,"Bộ 2 Pin Và Sạc Kép RAVPower Cho Canon LP-E6 5D IV 5DS 5DR 6DII 70D 80D 90D - Hàng Nhập Khẩu",774999,774999,0,0
TIKI,may-anh,74880889,"Remote MC-30 / MC-DC2 cho máy ảnh Nikon",75000,75000,0,0
TIKI,may-anh,124274648,"Thẻ Nhớ Điện Thoại Micro SD 8GB",65450,65450,0,0
TIKI,may-anh,24166638,"Đầu Ghi Camera HD-TVI HIKVISION DS-7104HGHI-F1 - Hàng Chính Hãng",890000,890000,0,0
TIKI,may-anh,191629444,"Dây Đeo Gắn Cằm Nón Bảo Hiểm Fullface cho  GOPRO Quay Phim, Chụp Ảnh Chất Lượng Cao Điều Chỉnh",49000,49000,0,0
TIKI,may-anh,4754755,"Tripod Smart Mini With Monopod Mefoto MK10 Benro - Hàng Nhập Khẩu",359999,359999,0,0
TIKI,may-anh,7263595,"Bàn Xoay Chụp Sản Phẩm 360 độ 25 cm",890000,890000,0,0
TIKI,may-anh,92165299,"Camera Dahua Có Mic 4 Mp DH-HAC-HFW1400TLP-A-S2 1080P - Hồng ngoại 80m - Hàng chính hãng",1272700,1272700,0,0
TIKI,may-anh,143613567,"Thẻ nhớ Lexar 64G Class10 hàng chính hãng",195000,195000,0,0
TIKI,may-anh,52689273,"CAMERA APP YOOSEE WIFI NGOÀI TRỜI 3.0 SIÊU NÉT CHỐNG NƯỚC, HỖ TRỢ ĐÈN FLASH QUAY ĐÊM CÓ MÀU",420000,420000,0,0
TIKI,may-anh,1206291,"Tủ Chống Ẩm Nikatei NC-20C",1360000,1990000,630000,32
TIKI,may-anh,47868431,"Camera Wi-Fi TP-Link Tapo C200 1080P (2MP) An Ninh Gia Đình Có Thể Điều Chỉnh Hướng - Hàng Chính Hãng",595000,595000,0,0
TIKI,may-anh,4727887,"Remote Chụp Ảnh Bluetooth Cho Điện Thoại - Hàng Nhập Khẩu",18700,18700,0,0
TIKI,may-anh,14270619,"Chân máy ảnh/ Gậy chụp hình 3 chân dùng livestream - Tripod 3110, Tripod 3120 + Remote điều khiển",63000,68000,5000,7
TIKI,may-anh,83744298,"Camera nội soi tai mũi họng - Camera Nội Soi Siêu Nhỏ, Siêu Nét, Tặng Kèm Bộ Lấy Ráy Tai",159000,159000,0,0
TIKI,may-anh,195881741,"Thẻ nhớ SDXC SanDisk Extreme U3 V30 256GB 180MB/s SDSDXVV-256G (New 2022) - Hàng Nhập Khẩu",785000,785000,0,0
TIKI,may-anh,58984014,"THẺ NHỚ SDHC UHS-I EXCERIA KIOXIA 64GB - HÀNG NHẬP KHẨU",215000,215000,0,0
TIKI,may-anh,51375703,"Camera hành trình ô tô thương hiệu HP f960x tích hợp Wifi GPS: Ngôn ngữ tiếng Anh, Màn hình 3 inch LCD, Full HD 2304*1296P, WDR, FCMD và FCWS, LDWS, Mini USD / AV port, Trọng lượng 86g",2300000,2300000,0,0
TIKI,may-anh,128871329,"Combo Camera Wi-fi EZVIZ C8C 2MP Ngoài Trời Kèm Thẻ Nhớ  32GB/64GB - Hàng Chính Hãng",1128900,1128900,0,0
TIKI,may-anh,14241256,"Sạc Pin En-El3/El3E Cho Máy Ảnh Nikon D70/D50/D90/D80/D200/D300/D700 - Hàng Nhập Khẩu",119000,119000,0,0
TIKI,may-anh,49729246,"Pin CR2 ( Pin Panasonic CR-2W ) 3V Lithium 2 Viên - Hàng Chính Hãng",210000,210000,0,0
TIKI,may-anh,5403959,"Đầu kẹp 2 in 1 cho máy tính bảng và điện thoại vào chân máy ảnh ",59000,59000,0,0
TIKI,may-anh,121327531,"Kính Hiển Vi Điện Tử Màn Hình Lớn 4.3inch",1888600,1988000,99400,5
TIKI,may-anh,855036,"Dây Cáp Kết Nối Máy Ảnh Nikon Với Máy Tính - Hàng nhập khẩu",59000,59000,0,0
TIKI,may-anh,19986875,"Lens hood cho ống kính Canon 50mm F1.8  (Loa che nắng ES-68 II)",49000,49000,0,0
TIKI,may-anh,15396824,"Đèn Flash Godox TT600 for Canon - Hàng chính hãng",1499999,1499999,0,0
TIKI,may-anh,68242940,"  CAMERA WI-FI QUAN SÁT HỒNG NGOẠI EZVIZ C6N Full HD 1080p, chính hãng thương hiệu MỸ.",450000,450000,0,0
TIKI,may-anh,44875056,"Remote Bluetooth Điều khiển Chụp hình từ xa cho Điện thoại (Mẫu Mới)",39000,39000,0,0
TIKI,may-anh,56936788,"Đế chân máy ảnh Benro T800/T880",69000,69000,0,0
TIKI,may-anh,11233096,"Camera hành trình ",240000,240000,0,0
TIKI,may-anh,22030633,"Camera IP Giám sát Trong Nhà Vitacam C1080 2.0mpx - Hàng Chính Hãng",380000,380000,0,0
TIKI,may-anh,19583159,"Tripod giá đỡ 3 chân mini để bàn cho điện thoại, gopro",75000,75000,0,0
TIKI,may-anh,124274185,"Cục Nguồn Có Móc Treo 12V 2A Chống Nước",35000,35000,0,0
TIKI,may-anh,20410431,"Đầu Kết Nối Camera Jack BNC + Đuôi F5 Chất Lượng Cao Giá Rẻ + Bộ 10 Cái",38900,38900,0,0
TIKI,may-anh,36999883,"Ống nhòm 10X50 cao cấp ( Khoảng cách nhìn tốt nhất 10 - 1000m ) - Hàng nhập khẩu",380000,380000,0,0
TIKI,may-anh,415086,"Chân Máy Ảnh Benro T880 EX (Tripod) - Hàng Chính Hãng",574000,574000,0,0
TIKI,may-anh,15079790,"Sạc pin đôi NP-FW50 cho máy ảnh Sony Alpha A5000 A5100 A6000 A6300 A6500 A6400 A55 A33 Nex",159999,159999,0,0
TIKI,may-anh,155996226,"Túi máy ảnh đeo chéo Artisan UX-1038",890555,890555,0,0
TIKI,may-anh,166413465,"Chân Benro T890 kèm kẹp điện thoại và remote chân chính hãng",689999,689999,0,0
TIKI,may-anh,4754651,"LED Yongnuo YN-1200 Pro - Hàng Nhập Khẩu",3719999,3719999,0,0
TIKI,may-anh,14261761,"Micro Thu Âm Wireliess UHF Boya BY-WM8 PRO-K2 (Bộ Thu 2 Micro) - Hàng Nhập Khẩu",3099000,3099000,0,0
TIKI,may-anh,55619164,"Pin Sạc AA Eneloop Pro 2550 mAh Made In Japan Kèm Hộp Bảo Quản - Hàng Chính Hãng ( Panasonic Phân Phối Trực Tiếp )",450000,450000,0,0
TIKI,may-anh,175821489,"Micro thu âm không dây Boya BY-XM6-S2 - Hàng chính hãng",3180000,3650000,470000,13
TIKI,may-anh,168571675,"Túi máy ảnh Peak Design Everyday Sling 6L Black Ver 2, Hàng chính hãng",3249999,3249999,0,0
TIKI,may-anh,9996258,"Kẹp ba lô gắn GoPro Hero xoay 360 độ",59000,59000,0,0
TIKI,may-anh,41819516,"Bộ Sản Phẩm Camera IP Dahua Imou A22EP 2.0mp và Thẻ Nhớ Sandisk 32Gb - Hàng Chính Hãng",498900,498900,0,0
TIKI,may-anh,101305869,"Combo hộp chống ẩm máy ảnh 3 lít (ẩm kế + hạt hút ẩm hoặc tùy chọn máy hút ẩm + mút xốp) - Hàng chính hãng",78000,78000,0,0
TIKI,may-anh,22635666,"Chân Đế Bluetooth Cho Điện Thoại, Máy Ảnh YunTeng VCT-5208RM - Hàng Nhập Khẩu - Tặng túi đựng tiện lợi qafa",229000,229000,0,0
TIKI,may-anh,160830444,"Ống nhòm du lịch, thể thao ngày và đêm 12,5 x 11 (cm)",79000,79000,0,0
TIKI,giay-dep-nu,151757207,"Giày Sandal Cao Gót Da Bò Thật BIGGBEN SDCG69",319000,350000,31000,9
TIKI,giay-dep-nu,151778357,"Giày sandal nữ xỏ ngón da bò thật BIGGBEN cao cấp SDN72",309000,400000,91000,23
TIKI,giay-dep-nu,193268704,"Giày nữ giày lười vải đế cao su mềm cao 2p",132000,149000,17000,11
TIKI,giay-dep-nu,172574646,"Giày cao gót đế 5 phân mũi nhọn công sở sang trọng",155000,155000,0,0
TIKI,giay-dep-nu,140968125,"Dép bánh mì quai ngang nữ mẫu mới Hot trend 2021 hình Boy Girl Cute Mềm Êm Cực Xinh",49500,49500,0,0
TIKI,giay-dep-nu,56360249,"Giày sandal nữ Trường Hải đế cao 2.5cm quai dép da bò thật không nổ da đế cao su không trơn thời trang cao cấp SDN082",244000,289000,45000,16
TIKI,giay-dep-nu,17628751,"Giày búp bê trơn đen da bò thật TH - BB03",264000,309000,45000,15
TIKI,giay-dep-nu,192863678,"Giày Nữ Búp Bê Pierre Cardin - PCWFWSG 172",490000,1490000,1000000,67
TIKI,giay-dep-nu,43182509,"Bộ 2 cặp lót giày bảo vệ gót chân và chống tuột gót giày (loại hạt xoài) - buybox - BBPK20",25000,50000,25000,50
TIKI,giay-dep-nu,176714650,"Dép quai kẹp Bitis nữ đế 1cm",79000,79000,0,0
TIKI,giay-dep-nu,141929095,"Giày cao gót nữ đẹp đế vuông 4 phân hàng hiệu rosata màu đen kem ro363",430000,430000,0,0
TIKI,giay-dep-nu,189179216,"Giày Sandal Nữ The Bily 01W Quai Chéo Dây Rút - Màu Xám BL01WX",359000,359000,0,0
TIKI,giay-dep-nu,103932676,"Giày lười nữ êm chân phong cách hàn quốc V281",69000,69000,0,0
TIKI,giay-dep-nu,192704744,"Dép Nhựa Thái Lan, Dép Nữ Quai Ngang nhiều màu sắc Monobo KAREN",160000,160000,0,0
TIKI,giay-dep-nu,190542901,"Dép quai kẹp xốp Bitis nữ đế 7cm",245000,245000,0,0
TIKI,giay-dep-nu,128086523,"Nút bọc đế giày cao gót, nhiều cỡ khác nhau",19000,19000,0,0
TIKI,giay-dep-nu,106870156,"Giày Búp Bê Nữ Da Bò BIGGBEN Cao Cấp BB106",309000,450000,141000,31
TIKI,giay-dep-nu,55086776,"Combo 5 cặp vớ silicone tổ ong đệm êm lòng bàn chân phía trước - BBPK67_5",70000,90000,20000,22
TIKI,giay-dep-nu,13330144,"Combo 10 miếng lót giày silicon tăng chiều cao",32000,32000,0,0
TIKI,giay-dep-nu,192937948,"Giày Thể Thao Trung Cấp Nữ Biti's DSW066300",519000,519000,0,0
TIKI,giay-dep-nu,119718791,"Giày Sandal Nữ Đế Xuồng TiTi ĐÔ Da Bò Thật Cao Cấp 5cm DNU2069a",288000,288000,0,0
TIKI,giay-dep-nu,66667498,"Dép đế xuồng nạm đá đen siêu nhẹ siêu êm S158",259000,259000,0,0
TIKI,giay-dep-nu,186630810,"Giày Búp Bê Nữ Hỡ Mũi Da Bò Thật BIGGBEN Cao 5 Phân BB126",299000,380000,81000,21
TIKI,giay-dep-nu,58125396,"Dép đế trấu nữ 2 khóa unisex màu Đen - DETA21D",245000,245000,0,0
TIKI,giay-dep-nu,177651328,"Dép Cao Gót Nữ BIGGBEN Cao 7 Phân DCG60",339000,400000,61000,15
TIKI,giay-dep-nu,67598275,"Giày Sandal Cao Gót 5cm Quai Dán Đế Gỗ Pixie 5245",450000,450000,0,0
TIKI,giay-dep-nu,107223787,"Dép Cao Gót Nữ Da Bò BIGGBEN Cao 4 Phân DCG53",319000,450000,131000,29
TIKI,giay-dep-nu,43237480,"DÉP XỐP LỖ ĐI TRONG NHÀ",32299,33999,1700,5
TIKI,giay-dep-nu,79558697,"Giầy lười nữ vải đẹp đi bộ êm chân giầy slip on vải đế mềm V276",69000,69000,0,0
TIKI,giay-dep-nu,91258729,"Dép Đế Xuồng Nữ Da Bò BIGGBEN Cao Cấp DX30",309000,400000,91000,23
TIKI,giay-dep-nu,167489656,"Dép lào Thái màu xanh lá loại 1 nhập thái dép tông lào thái huyền thoại dép xỏ ngón dép hai quai dép kẹp thái",93500,93500,0,0
TIKI,giay-dep-nu,68237846,"Dép Thái Lan siêu nhẹ nhiều màu D983 (tặng móc khóa hình trái bơ đáng yêu)",59000,59000,0,0
TIKI,giay-dep-nu,144219043,"Sandal nữ đi mưa Alina cao 3.5p thời trang mới nhất V289",54000,54000,0,0
TIKI,giay-dep-nu,204761805,"Bốt Đùi Nữ Cao Cổ Da Trơn Bóng Kéo Khóa Sau Đế Vuông Chất Đẹp Thời Trang",550000,885000,335000,38
TIKI,giay-dep-nu,186993016,"Xịt khử mùi giày dép hương chanh sả, quế cao cấp, giúp chân thông thoáng - buybox - BBPK212 - 75ML",86000,100000,14000,14
TIKI,giay-dep-nu,191428560,"Dép quai kẹp Bitis nữ đế 1 cm",79000,79000,0,0
TIKI,giay-dep-nu,175469044,"Giày chạy bộ nữ Under Armour HOVR Machina 2 SE - 3024741",2857000,4395000,1538000,35
TIKI,giay-dep-nu,168117353,"Combo 10 đôi dép xốp màu trắng, đen , xanh cho khách sạn, nhà nghỉ",95000,95000,0,0
TIKI,giay-dep-nu,94230575,"Bộ 6 Miếng Đế Lót Độn Giày- Đế lót tăng chiều cao Silicon Cực Êm Tặng kèm Chai Xịt Khử Mùi Giày Dép",75000,75000,0,0
TIKI,giay-dep-nu,162593248,"Giày Sneakers độn đế 6cm chất da pu êm nhẹ PS339",388000,388000,0,0
TIKI,may-anh,51297533,"Túi đeo máy ảnh Peak Design Everyday Sling v2 6L - Midnight - Hàng nhập khẩu",3999999,3999999,0,0
TIKI,may-anh,51295998,"Túi đeo máy ảnh Peak Design Everyday Sling v2 10L - Màu Đen - Hàng nhập khẩu",4249999,4249999,0,0
TIKI,may-anh,92807565,"Kẹp gắn ống nhòm đa năng chuyên nghiệp",149000,149000,0,0
TIKI,may-anh,175646985,"Camera Hành Động Thể Thao SJCAM Full HD 1080P Hàng Chính Hãng",1699000,2690000,991000,37
TIKI,may-anh,121331147,"sét 10mét Dây quai dệt, Bản 4cm dây đeo máy ảnh, cặp túi (hàng đẹp)",14000,14000,0,0
TIKI,may-anh,114447618,"Camera IP Wifi Ezviz C6N 1080p-Hàng Chính Hãng",480000,480000,0,0
TIKI,may-anh,173860428,"Pin for BP-511A dung lượng cao 2500mAh dành cho máy ảnh Canon 10D, 20D, 30D, 40D, 50D, 5D, 300D",319000,319000,0,0
TIKI,may-anh,184883730,"CAMERA WIFI "YOOSEE" 4 râu 14 LED 5.0 MPX CỰC SÁNG. CẢNH BÁO CHỐNG TRỘM - Hàng chính hãng",550000,550000,0,0
TIKI,may-anh,4708403,"Bộ 4 Tấm Dính Và Gài Gopro - Hàng Nhập Khẩu",49000,49000,0,0
TIKI,may-anh,9982809,"Mount chuyển đổi ngàm GoPro Hero sang chuẩn ốc chân máy ảnh tripod 1/4 cái",29000,29000,0,0
TIKI,may-anh,45075149," Tủ chống ẩm Andbon AD-30S (30 Lít) - Hàng Chính Hãng",1374999,1374999,0,0
TIKI,may-anh,53683384,"Tripod bạch tuột 3 chân MT35 xoay 360 độ siêu chắc cho máy ảnh, điện thoại - Chân đế uốn dẻo có thước đo cân bằng tích hợp sẵn giá đỡ điện thoại AnZ",211850,223000,11150,5
TIKI,may-anh,109628885,"Combo hộp chống ẩm máy ảnh10L rộng 37cm (tùy chọn hạt hút ẩm hoặc máy hút ẩm) - Hàng chính hãng",229000,229000,0,0
TIKI,may-anh,155762494,"Bộ Camera hành trình (trước và sau) ô tô Xiaomi 70mai, bản Quốc Tế cao cấp A500S - Hàng Nhập Khẩu",3198000,3198000,0,0
TIKI,may-anh,173399655,"Chân đế dome gắn tường lắp cho các loại camera Ezviz , Imou, ONVIZCAM",9500,9500,0,0
TIKI,may-anh,109346768,"Dụng cụ vệ sinh, bộ vệ sinh máy ảnh VSGO (nhiều loại), Hàng chính hãng",99999,99999,0,0
TIKI,may-anh,2533161,"Mắt Ngắm Canon JYC Eyecup EB (Đen)",49000,49000,0,0
TIKI,may-anh,8275325,"Kẹp chuẩn ốc 1/4 gắn máy ảnh lên ghi đông xe",79000,79000,0,0
TIKI,may-anh,270854138,"Hộp chống ẩm máy ảnh chuyên dụng Uteki dung tích 4.5 lít (cả ẩm kế + hạt hút ẩm)",220000,220000,0,0
TIKI,may-anh,22756323,"Gậy Tự Chụp Tay Cầm Chống Trượt cho Gopro Sjcam dài 49cm",75000,75000,0,0
TIKI,may-anh,7775408,"Bộ vệ sinh máy ảnh đa năng-DKL-6 - Hàng Nhập Khẩu",293999,293999,0,0
TIKI,may-anh,14688674,"Chân Floor Dolly Yuntng VCT 900 \ Hàng Chính Hãng",849999,849999,0,0
TIKI,may-anh,7776627,"Mắt ngắm Eyecup Canon EG",79000,79000,0,0
TIKI,may-anh,40823013,"Dây cáp kết nối máy ảnh Canon với máy tính cho Canon 5D2 5D3 6D 6D2 760D 77D 7D 800D 80D D60 70D 600D 650D 700D 750D 1100D 1200D",54000,54000,0,0
TIKI,may-anh,714317,"Chân Máy Ảnh Benro TSL08AN00 - Hàng Chính hãng",1549999,1549999,0,0
TIKI,may-anh,109018502,"Bộ 2 pin 1 sạc Kingma cho Fujifilm NP-T125, Hàng chính hãng",2249999,2249999,0,0
TIKI,may-anh,4713155,"Nguồn POWER ADAPTER Cho LED Video Light YN-600, YN300-III, YN168, YN216, YN1410, YN300air, YN160III, YN360 - Hàng Nhập Khẩu",224999,224999,0,0
TIKI,may-anh,7240827,"Chân Đèn Inox 280cm QIHE J288S",649000,649000,0,0
TIKI,may-anh,146492088,"Nguồn Camera 5V 2A Chui Nhỏ",46500,46500,0,0
TIKI,may-anh,40758541,"Pin PB-511A cho máy ảnh Canon 30D , 40D , 50D , 5D - hàng nhập khẩu",214999,214999,0,0
TIKI,may-anh,100050235,"Filter Kính lọc Hoya UV UX 40.5-82mm, Chính hãng",249999,249999,0,0
TIKI,may-anh,173039347,"Pin  Sạc Fujitsu - HR-3UTLA (4B) - AA 1000mAh - Hàng Nhập Khẩu Chính Hãng",330000,330000,0,0
TIKI,may-anh,25609849,"Camera giám sát IP HIKVISION DS-2CV2Q21FD-IW - hàng chính hãng",1060000,1060000,0,0
TIKI,may-anh,73641065,"Camera IP Wifi IPC-A22EP-IMOU Chuẩn 1080P Tặng Thẻ nhớ Adata 32gb - Chính Hãng",599000,599000,0,0
TIKI,may-anh,28079545,"Camera Hành Trình Mắt To G30 1080P Full HD",198000,198000,0,0
TIKI,may-anh,180536363,"Đầu Ghi Hình Hikvision 4 Kênh DS-7204HGHI-K1 Turbo HD 4.0 DVR Vỏ Sắt - Hàng chính hãng",865000,1200000,335000,28
TIKI,may-anh,13461376,"Dây cáp kết nối máy ảnh Canon với máy tính cho EOS M Nikon D3400",79000,79000,0,0
TIKI,may-anh,68540931,"Đèn led video Ulanzi VIJIM VL196 RGB hàng chính hãng.",1095000,1095000,0,0
TIKI,may-anh,25746302," Sạc Pin Máy Ảnh For Nikon EN-EL15",99000,99000,0,0
TIKI,may-anh,15271601,"1 Kg chống ẩm hạt xanh đậm tặng kèm 10 túi vải - Hàng chính hãng",99000,99000,0,0
TIKI,phu-kien-thoi-trang,113484947,"Kính Mát ,Mắt Kính Unisex ASARIFA RP18012 C2",800000,800000,0,0
TIKI,phu-kien-thoi-trang,193717387,"Kính Mát Nam Aoron, Kính Râm Nam Thời Trang, Mắt Kính Phân Cực Cao Cấp Chống Tia UV, Chống Chói Đi Xe Cực Tốt - AK061 - Aoron",420000,420000,0,0
TIKI,phu-kien-thoi-trang,186529112,"Kính lão nhựa gọng gập mặt màu sẫm tiên lợi khi mang theo dành cho nam và nữ",39000,39000,0,0
TIKI,phu-kien-thoi-trang,104847013,"Tất Vớ Nam Nữ Cotton Trơn Cổ Ngắn, Vớ Tất Cổ Thấp - Combo 5 đen",35000,35000,0,0
TIKI,phu-kien-thoi-trang,117746706,"Thắt lưng nam dây nịt nam chất liệu da bò thật khóa tự động hàng hiệu cao cấp NT313 - Nutushop",305000,305000,0,0
TIKI,phu-kien-thoi-trang,168964877,"Tất vớ cổ ngắn nam nữ GOMTAT chất liệu cotton cao cấp, êm mềm đi mát, thiết kế thoáng khí - GOM-KLB-TRONNGAN",18900,35000,16100,46
TIKI,phu-kien-thoi-trang,67734905,"[Một Miếng] Kính Áp Tròng Australia Cận Thị Không Màu Mediclear 3 Tháng",100000,100000,0,0
TIKI,phu-kien-thoi-trang,43835840,"THẮT LƯNG NỮ FABRIC, DÂY NỊT NỮ DN1912250",85000,99000,14000,14
TIKI,phu-kien-thoi-trang,192781763,"Khăn Quàng Cổ Thắt Nơ Chất Liệu Lụa Mỏng Màu Xanh Lá Thời Trang Xuân Hè Cho Nữ",28000,28000,0,0
TIKI,phu-kien-thoi-trang,177996385,"Vớ nữ cổ ngắn GOMTAT, tất nữ chất liệu cotton êm mềm, đi mát - NUNGAN-VSTAR-501",9900,15900,6000,38
TIKI,phu-kien-thoi-trang,25268939,"THẮT LƯNG NỮ DÂY NỊT NỮ PEARL MANG ĐẦM VÁY DN19TL11",69000,69000,0,0
TIKI,phu-kien-thoi-trang,67254139,"Khẩu Trang Pitta Nữ Màu Pastel size Small (Gói 3 cái)",180000,180000,0,0
TIKI,phu-kien-thoi-trang,117074375,"Kính Râm, Kính Mát Nam Cơn Ao Fullbox Phụ Kiện Tròng Thủy Tinh Chống Nắng Chống Lóa UV Cao cấp",370500,390000,19500,5
TIKI,phu-kien-thoi-trang,73815805,"Cài tóc thắt bính Hàn Quốc",34900,34900,0,0
TIKI,phu-kien-thoi-trang,176044206,"[SET 12 ĐÔI] Vớ Trơn Cổ Ngắn, Tất Ngắn Nam Nữ chuẩn xuất Nhật",94000,120000,26000,22
TIKI,phu-kien-thoi-trang,160894065,"Hộp 5 đôi tất đi giày tây nam cổ cao mẫu MIX02, vớ nam công sở cao cấp, chất liệu cotton hút ẩm, thoáng khí - GOM-MIX02-CB5",129000,250000,121000,48
TIKI,phu-kien-thoi-trang,175155768,"[COMBO 10 ĐÔI] Tất Nữ Cổ Ngắn chuẩn xuất Nhật, Vớ Nữ Cotton Co Giãn Cao Cấp, Mềm mịn, êm chân - CB024",88000,100000,12000,12
TIKI,phu-kien-thoi-trang,82949277,"Găng tay cảm ứng chống nước nam nữ cao cấp",130000,130000,0,0
TIKI,phu-kien-thoi-trang,186262146,"Băng đô cài tóc, Bờm cài tóc vải dập hoa nổi viền ngọc siêu xinh - Culi accessories",85000,85000,0,0
TIKI,phu-kien-thoi-trang,75512410,"Khăn quàng cổ thời trang size 70x70cm - Mã 7027",89000,89000,0,0
TIKI,phu-kien-thoi-trang,271450816,"Set 10 Đôi Tất Cổ Ngắn Nam Nữ Chất Liệu Cotton Thoáng Mát Êm Chân - CB023",89000,149000,60000,40
TIKI,phu-kien-thoi-trang,106313973,"Mũ Cover Bucket Hat",47000,47000,0,0
TIKI,phu-kien-thoi-trang,57287690,"Kính lão thị viễn thị nam nữ sẵn độ có hộp như hình",219000,219000,0,0
TIKI,phu-kien-thoi-trang,86422713,"Tóc búi xoăn ngoặm trung niên",118000,118000,0,0
TIKI,phu-kien-thoi-trang,72694486,"Set 4 Khuy cài áo hạt châu sang trọng",36000,36000,0,0
TIKI,phu-kien-thoi-trang,148841297,"Nón tai bèo nam USA loại xịn, chất liệu vải kaki xịn may 2 lớp chống nóng tốt, gắn sò to thời trang - Hạnh Dương",75000,75000,0,0
TIKI,phu-kien-thoi-trang,95141850,"Set 3 Kẹp Tóc Đính Đá Lá Kéo Lược Hàn Quốc Cao Cấp",44000,44000,0,0
TIKI,phu-kien-thoi-trang,144955163,"Kẹp búi tóc Hàn Quốc đính đá cao cấp sang trọng - cặp tóc tổ chim đính đá sang trọng ( giao màu ngẫu nhiên như hình )",72000,72000,0,0
TIKI,phu-kien-thoi-trang,41131921,"Combo 10 Đôi Tất, Vớ Gấu Cổ Ngắn Chất Cực Mịn Nhiều Màu, Đeo Thay Đổi Cả Tuần - PK033",28999,28999,0,0
TIKI,phu-kien-thoi-trang,138856398,"Mũ beret nón bere nữ len lông thỏ thời trang Hàn Quốc mới dona21111219",160550,169000,8450,5
TIKI,phu-kien-thoi-trang,23167105,"Combo 6 Kẹp Càng Cua 5 Răng - Đen",29888,29888,0,0
TIKI,phu-kien-thoi-trang,198794873,"Dây nơ buộc tóc - Dây cột tóc đẹp cho bạn thêm xinh, quà tặng thanh lịch, dễ thương - Ms N1",12000,18000,6000,33
TIKI,phu-kien-thoi-trang,25270553,"Găng tay xỏ ngón chống nắng",15000,15000,0,0
TIKI,phu-kien-thoi-trang,43827346,"THẮT LƯNG NỮ KNOT, DÂY NỊT NỮ DN1912239",72000,78000,6000,8
TIKI,phu-kien-thoi-trang,55569448,"Băng đô cài tóc bảng bự màu trơn phong cách Hàn Quốc",80000,80000,0,0
TIKI,phu-kien-thoi-trang,170675438,"Nón cao bồi nam - Mũ cao bồi phớt cói vành nhỏ cowboy đi biển dạo phố dã ngoại dona22031602",114000,120000,6000,5
TIKI,phu-kien-thoi-trang,157125295,"Tất Cổ Cao Trơn Gom Tất, Vớ Cổ Cao Nam Nữ Chất Liệu Cotton thoáng mát,êm chân - TAT-TRONCAO-VNXK",7900,15000,7100,47
TIKI,phu-kien-thoi-trang,71178900,"Ngoạm tóc giả xoăn lửng N152 FREESHIP Tóc giả ngoạm xoăn, kẹp ngoạm lửng, tóc giả nữ",69000,69000,0,0
TIKI,phu-kien-thoi-trang,67605171,"Khẩu Trang PItta Màu Sắc Trẻ em - Nhật Bản (Gói 3 cái)",180000,180000,0,0
TIKI,phu-kien-thoi-trang,51371677,"COMBO 2 Mũ Tắm Trùm Đầu CUTE Tránh Ướt Tóc Khi Tắm , Ủ Dưỡng Tóc Đa Năng - Giao Màu Ngẫu Nhiên - GD010-2",33250,35000,1750,5
TIKI,dien-tu-dien-lanh,171616994,"Điều Hòa Funiki Inverter 18000Btu HIC18TMU - Chỉ giao Hà Nội",10800000,11720000,920000,8
TIKI,dien-tu-dien-lanh,126702135,"Điều khiển tivi dành cho Samsung BN7700 dùng cho các series 6990\7300\7700\8800\8900\9800 ",550000,550000,0,0
TIKI,dien-tu-dien-lanh,186516727,"Tủ Lạnh Sanaky 140 Lít VH-148HPD - Hàng chính hãng- Giao tại Hà Nội",5550000,5550000,0,0
TIKI,dien-tu-dien-lanh,170492909,"Bình Nước Nóng Atlantic Nanto WIFI - Hàng chính hãng",3790000,3790000,0,0
TIKI,dien-tu-dien-lanh,113490577,"TV QLED 55'' 4K Android 11 Tivi TCL 55C725 - Gam Màu Rộng , HDR 10+, MEMC , Dolby Audio - HÀNG CHÍNH HÃNG",12500000,12500000,0,0
TIKI,dien-tu-dien-lanh,120462218,"Chuột bay điều khiển giọng nói G10s",99000,99000,0,0
TIKI,dien-tu-dien-lanh,91171876,"Công tắc bật tắt máy bớm nước từ xa công suất lớn 30A/220V khoảng cách 1Km 6220ZR- CHÍNH HÃNG HONEST,điều khển từ xa",125000,125000,0,0
TIKI,dien-tu-dien-lanh,94902444,"REMOTE ĐIỀU KHIỂN DÀNH CHO TIVI SONY CÓ TÌM KIẾM GIỌNG NÓI TX310p",175000,175000,0,0
TIKI,dien-tu-dien-lanh,90163723,"Máy giặt Samsung AI Inverter 10kg WW10T634DLX/SV - Chỉ giao Hà Nội",10200000,10200000,0,0
TIKI,dien-tu-dien-lanh,197574524,"Máy Rửa Chén Độc Lập Ecalite EDW-SMS6015AS - 14 Bộ - 8 Chương Trình Rửa - Tự Động Hé Cửa - Hàng Chính Hãng",8000000,15300000,7300000,48
TIKI,dien-tu-dien-lanh,126702220,"Remote Điều khiển điều hoà dành cho Gree các dòng GWC GWH 1 chiều 2 chiều Inverter",95950,101000,5050,5
TIKI,dien-tu-dien-lanh,126702145,"Điều khiển cho điều hòa dành cho LG 1 chiều (ngắn) ",57000,60000,3000,5
TIKI,dien-tu-dien-lanh,10640238,"Máy Giặt Cửa Trên Inverter Aqua AQW-D90CT-BK (9kg) - Hàng Chính Hãng",7690000,7690000,0,0
TIKI,dien-tu-dien-lanh,459580,"Máy Nước Nóng Ferroli QQ EVO 30L TE (2500W)",2450000,2450000,0,0
TIKI,dien-tu-dien-lanh,197150207,"Máy rửa bát TEXGIO TGFPCM795B Dung tích 14 bộ Rút ngắn thời gian rửa Có thể chọn giàn rửa Sấy khô chén đĩa Rửa sạch sâu - Hàng Chính Hãng",13000000,13000000,0,0
TIKI,dien-tu-dien-lanh,54400391,"Tủ Lạnh Inverter Samsung RB30N4010BU/SV (310L) - Hàng Chính Hãng - Chỉ Giao tại Hà Nội",10900000,10900000,0,0
TIKI,dien-tu-dien-lanh,195480645,"Smart Tivi LG 4K 70 inch 70UQ8000PSC - Model 2022",14590000,14590000,0,0
TIKI,dien-tu-dien-lanh,113761486,"Quạt dành cho  tủ lạnh Nidec 8x8 cm 2 dây 12V",120000,120000,0,0
TIKI,dien-tu-dien-lanh,32925581,"Tủ Lạnh Inverter Electrolux EBE4500B-G (421L) - Hàng Chính Hãng (Vàng)",13590000,13590000,0,0
TIKI,dien-tu-dien-lanh,192725846,"Máy rửa bát hiện đại BAUER SBW21EU13F - Hàng chính hãng",20680000,20680000,0,0
TIKI,dien-tu-dien-lanh,16861594,"Điều khiển dùng cho quạt cây Panasonic",76000,76000,0,0
TIKI,dien-tu-dien-lanh,32977521,"Máy đun nước nóng Hải Âu NHA30",8960000,8960000,0,0
TIKI,dien-tu-dien-lanh,114993684,"Tủ lạnh Panasonic Inverter 234 lít NR-TV261APSV - Chỉ giao tại Hà Nội",7250000,7250000,0,0
TIKI,dien-tu-dien-lanh,460183,"Tủ Đông Sanaky VH-2899W1 (220L) - Hàng Chính Hãng",7600000,7600000,0,0
TIKI,dien-tu-dien-lanh,96013656,"Công tắc cửa dành cho máy giặt Electrolux 3 chân inverter đuôi 43 44",275000,275000,0,0
TIKI,dien-tu-dien-lanh,195959418,"Tủ lạnh Toshiba Inverter 249 lít GR-RT325WE-PMV(06)-MG - Hàng chính hãng [Giao hàng toàn quốc]",7490000,9990000,2500000,25
TIKI,dien-tu-dien-lanh,13674032,"Máy nước nóng trực tiếp Ferroli Slim Divo SSN 4500W - Hàng Chính Hãng",1864800,1864800,0,0
TIKI,dien-tu-dien-lanh,53243578,"Tủ đông Hòa Phát HCF 666S1Đ2 352 lít - Hàng Chính Hãng",7870000,7870000,0,0
TIKI,dien-tu-dien-lanh,126702015,"Remote Điều khiển từ xa điều hòa dành cho LG-Dùng cho các dòng J V10 V13 V18 9000BTU 12000BTU 18000BTU 1 chiều 2 chiều Inverter",54150,57000,2850,5
TIKI,dien-tu-dien-lanh,1502125,"Tủ lạnh Sharp Inverter 165 lít SJ-X196E-DSS",4729000,4729000,0,0
TIKI,dien-tu-dien-lanh,53450133,"Tủ đông Hòa Phát HCF 656S2N2 271 lít - Hàng Chính Hãng",7650000,7650000,0,0
TIKI,dien-tu-dien-lanh,17882661,"Điều khiển đầu KTS Hùng Việt cho các model thường-hàng chính hãng",29000,29000,0,0
TIKI,dien-tu-dien-lanh,119822216,"Remote Điều khiển tivi dành cho Samsung giọng nói BN59-01298G năm 2015,2016,2017,2018",165000,165000,0,0
TIKI,dien-tu-dien-lanh,19480120,"Anten GPS/SMA GPS-001",69000,69000,0,0
TIKI,dien-tu-dien-lanh,113048674,"Điều khiển điều hòa đa năng K-100ES",59800,59800,0,0
TIKI,dien-tu-dien-lanh,102108848,"Thanh magie trong máy nước nóng năng lượng mặt trời",125000,125000,0,0
TIKI,dien-tu-dien-lanh,53611301,"Điều khiển thay thế điều khiển FPT Play box 2018",113000,113000,0,0
TIKI,dien-tu-dien-lanh,188829115,"Ron cửa cho tủ lạnh Panasonic model NR BC369Q",273000,273000,0,0
TIKI,dien-tu-dien-lanh,186740265,"Tủ lạnh Samsung Inverter 302 Lít RT29K503JB1/SV -Hàng chính hãng- Giao tại Hà Nội",9500000,9500000,0,0
TIKI,dien-tu-dien-lanh,114963528,"Remote dành cho máy lạnh TOSHIBA",68000,68000,0,0
TIKI,balo-va-vali,196411445,"Balo nữ đi học nắp cài thời trang Hàn Quốc ulzzang dễ thương đáng yêu giá rẻ 2231",245000,245000,0,0
TIKI,balo-va-vali,68767350,"Balo Thời Trang Đi học ",95000,95000,0,0
TIKI,balo-va-vali,184505941,"Túi du lịch Bamozo, Túi trống thời trang cao cấp chống nước, có ngăn đựng giày",199000,310000,111000,36
TIKI,balo-va-vali,124245017,"(CHÍNH HÃNG) Cặp học sinh siêu nhẹ,cặp đi học siêu nhẹ cho bé trai bé gái",99000,99000,0,0
TIKI,balo-va-vali,120114593,"SIZE 29 VALI VALI KHUNG NHÔM KHOÁ SẬP GÓC VUÔNG",1550000,1550000,0,0
TIKI,balo-va-vali,185944482,"Túi trống thể thao,Túi du lịch, Túi tập gym nam nữ có ngăn đựng giày riêng biệt",135000,135000,0,0
TIKI,balo-va-vali,195948504,"Vali Kéo Du Lịch TN Màu xanh Nauy Có Nắp - 20 Inch",274000,359000,85000,24
TIKI,balo-va-vali,191824376,"Balo Laptop Du Lịch Thời Trang Uniex STARGO NUEVO Dành Cho Laptop 15.6 Inch",467000,550000,83000,15
TIKI,balo-va-vali,1310585,"Túi Chống Sốc Macbook LaptopTCS - Đen (13)",149000,149000,0,0
TIKI,balo-va-vali,50227434,"Ba lô nam thông minh đa chức năng thời trang cao cấp phong cách châu âu",1080000,1200000,120000,10
TIKI,balo-va-vali,165712298,"4 túi tắm kỳ ghét mới nhất Hàn Quốc",62000,62000,0,0
TIKI,balo-va-vali,108154858,"Balo thời trang nam nữ phong cách hàn quốc giá rẻ ,balo đi học laptop , balo ulzzang Marit",74300,74300,0,0
TIKI,balo-va-vali,33133977,"Balo Laptop Du Lịch Thời Trang Cao Cấp SAKOS SPIRIT Dành Cho Laptop 15.6 Inch (15.6")",2399000,2730000,331000,12
TIKI,balo-va-vali,169331134,"Balo nam nữ vải canvas cao cấp phong cách mới",449000,498000,49000,10
TIKI,balo-va-vali,115572816,"Vali kéo du lịch SUNNY BUBULE size 24 - nhựa PP chống vỡ tuyệt đối, khóa hải quan TSA",1190000,1800000,610000,34
TIKI,balo-va-vali,88792306,"vali khung nhôm dáng mới 1501 size 24",1390000,1390000,0,0
TIKI,balo-va-vali,66789837,"Túi du lịch xách tay cao cấp BIG001 thời trang hàn quốc Tặng khóa nam",232650,317955,85305,27
TIKI,balo-va-vali,29316075,"TÚI CHỐNG SỐC MACBOOK LAPTOP CÓ QUAI XÁCH QUAI ĐEO",302400,302400,0,0
TIKI,balo-va-vali,195695602,"Túi Du Lịch Cầm Tay Đeo Vai E&S Ngắn Đơn Giản Nhẹ Nhàng , Chống Thấm Nước , Dành Du Lịch Công Tác Thể Thao Túi Hành Lý Có Sức Chứa Lớn  BL013",323000,380000,57000,15
TIKI,balo-va-vali,68130202,"BALO ULZZANG ĐI HỌC UNISEX CÁ TÍNH CẶP NỮ NAM THỜI TRANG TEEN DỄ THƯƠNG 5614",119000,119000,0,0
TIKI,balo-va-vali,183481747,"Ba lô thời trang du lịch cao cấp",295000,295000,0,0
TIKI,balo-va-vali,20148147,"Bao da, túi da, cặp da chống sốc cho macbook, laptop chất da lộn kèm ví đựng phụ kiện",332500,350000,17500,5
TIKI,balo-va-vali,35933402,"Túi trống du lịch, thể thao tập gym có ngăn để giày HN2",135000,135000,0,0
TIKI,balo-va-vali,162395777,"Balo laptop công nghệ mới có khóa chống trộm phong cách hiện đại KZ8005-01 Laptop 15.6 inch đến 17 inch",403200,560000,156800,28
TIKI,balo-va-vali,195569947,"Quai xách tay cầm vali 22.5cm, đã bao gồm ốc vít, dùng cho vali lock&lock, Kakashi, Lojel, American Tourister, sakos, samsonite, Delsey, lusetti,sony",50000,50000,0,0
TIKI,balo-va-vali,75646273,"Balo Nữ Nam Loại To Thời Trang Ba Lô Đi Học Đi Du Lịch học sinh sinh viên  Nhiều ngăn đa năng",91234,124687,33453,27
TIKI,balo-va-vali,166093160,"Balo nam đựng laptop 17 inch, balo du lịch size lớn Xbags Leader thời trang sành điệu",576000,576000,0,0
TIKI,balo-va-vali,570490,"Túi Kéo Du Lịch Macat Innova 4 - Đỏ",480000,585000,105000,18
TIKI,balo-va-vali,48224308,"Túi xách du lịch thể thao nam công suất lớn chất lượng cao tích hợp sẵn công nghệ 4.0",855000,950000,95000,10
TIKI,balo-va-vali,89219827,"Balo nữ dễ thương đẹp đi học giá rẻ thời trang cá tính cute LUKAMO BL129",171000,171000,0,0
TIKI,balo-va-vali,177586936,"Balo Nữ Thời Trang JUNO Chần Bông Cách Điệu BL128",839000,839000,0,0
TIKI,balo-va-vali,127046224,"Túi đeo chéo dáng dọc Wiwu chống sốc dành cho ipad, surface, macbook, laptop 12.9 inch, 13 inch",664050,699000,34950,5
TIKI,balo-va-vali,33576979,"Balo Nam Thời Trang Cao Cấp PRAZA - BLTK178",159000,159000,0,0
TIKI,balo-va-vali,40768621,"Balo đựng Macbook, Laptop 16 inch phối màu chống gù lưng",299000,299000,0,0
TIKI,balo-va-vali,9412621,"Combo Balo Thời Trang Hàn Quốc PRAZA - BL167 (Xanh Lá phối Đen) Và Túi Đeo Chéo PRAZA - DC095 (Đen)",233000,233000,0,0
TIKI,voucher-dich-vu,141372541,"[KHÓA HỌC ONLINE TƯƠNG TÁC]Học Etabs-Safe Cơ bản và Nâng cao (Tương tác trực tiếp với giảng viên qua Zoom)",2000000,2000000,0,0
TIKI,balo-va-vali,184085133,"BFQ2ST500KTL: giảm 8% cho đơn từ 500K Vali khóa sập Hàn Quốc Tresette 3026",2000000,2510000,510000,20
TIKI,voucher-dich-vu,101235553,"Chụp ảnh cưới tại Hồng Linh Studio-Voucher gói chụp ảnh cưới tại Hà Nội (SILVER)",8680000,8680000,0,0
TIKI,voucher-dich-vu,190233713,"Phiếu Quà Tặng Hoa Yêu Thương 1000K",1000000,1000000,0,0
TIKI,balo-va-vali,126897292,"bao da túi chống sốc cho ipad laptop macbook kiêm giá đỡ tản nhiệt kèm ví đựng sạc chuột",332500,350000,17500,5
TIKI,voucher-dich-vu,190238869,"Hoa Yêu Thương -  Evoucher Giỏ Hoa Tươi - Tình Yêu Đầu",650000,650000,0,0
TIKI,balo-va-vali,111868783,"Balo học sinh Arctic Hunter chất liệu chống nước, có sạc USB - B00218",499000,850000,351000,41
TIKI,voucher-dich-vu,189182285,"Sách nói: Khói Trời Lộng Lẫy",99000,99000,0,0
TIKI,voucher-dich-vu,79855795,"Khóa học Quy trình bán hàng - Agilearn",480000,480000,0,0
TIKI,voucher-dich-vu,190125499,"Sách nói: Hệ Miễn Dịch: Khám Phá Cơ Chế Tự Phòng Chữa Bệnh Của Cơ Thể Người",99000,99000,0,0
TIKI,voucher-dich-vu,9975853,"Thanh Thanh Spa - Tắm Trắng Body & Facial Bằng Pha Lê Tuyết Kết Hợp Máy Phi Thuyền (Miễn Tip)",450000,450000,0,0
TIKI,voucher-dich-vu,132346331,"[E-BOOK] i-Learn Smart Start Level 4 Sách mềm sách bài tập",15000,15000,0,0
TIKI,voucher-dich-vu,57510920,"Phần mềm hóa đơn điện tử Viettel Sinvoice- Gói 50000 hóa đơn điện tử Viettel - HÀNG CHÍNH HÃNG 100%",16950000,16950000,0,0
TIKI,voucher-dich-vu,21761428,"Tick Edu - Thoát Khỏi Ác Mộng Ép Doanh Số Với Công Thức Bán Hàng 3S Đỉnh Cao",799000,799000,0,0
TIKI,voucher-dich-vu,270275948,"Khóa học 3 tháng tập chạy 42km giải Tiền Phong Marathon TPM",3000000,3000000,0,0
TIKI,balo-va-vali,166031083,"Balo chống sốc laptop 17 inch, balo du lịch cỡ lớn Xbags Leader nhiều ngăn chống nước ",449000,576000,127000,22
TIKI,voucher-dich-vu,6462623,"Cạo Vôi + Đánh Bóng Răng Với Công Nghệ Hiện Đại",150000,150000,0,0
TIKI,voucher-dich-vu,253264776,"[HCM] Gói 14 Ngày Tập Luyện Tại Life Fitness & Yoga",299000,299000,0,0
TIKI,voucher-dich-vu,36462502,"Tẩy Trắng Răng Công Nghệ Plasma Laser - Nha khoa Gia Hân",1250000,1250000,0,0
TIKI,balo-va-vali,32057202,"Bộ chiết mỹ phẩm mini Hàn Quốc 7 Món Tiện Lợi",23000,24990,1990,8
TIKI,voucher-dich-vu,21761421,"Tick Edu - Kiến thức về kinh nguyệt không phải ai cũng biết",799000,799000,0,0
TIKI,voucher-dich-vu,21775477,"Tick Edu - Massage Uyên Ương",599000,599000,0,0
TIKI,voucher-dich-vu,207236836,"Sách nói Những Lối Về Ấu Thơ",99000,99000,0,0
TIKI,voucher-dich-vu,207236603,"Sách nói Bí Quyết Kinh Doanh Của Người Do Thái",99000,99000,0,0
TIKI,voucher-dich-vu,207230607,"Sách nói: Nghệ Thuật Quản Lý Thời Gian",99000,99000,0,0
TIKI,voucher-dich-vu,68540784,"Khóa học NGỮ VĂN LỚP 10 cô Diệu Thu - 09 tháng",700000,700000,0,0
TIKI,voucher-dich-vu,4730931,"Việt Hàn Spa - Điều Trị Rạn Da Sau Sinh Bằng Spectra Laser, Hiệu Quả Ngay Lần Đầu Tiên",455000,455000,0,0
TIKI,voucher-dich-vu,13591435,"Voucher trắng sáng căng bóng da tại QUỲNH CHI SPA",600000,600000,0,0
TIKI,voucher-dich-vu,21775693,"Tick Edu - Quản Trị Mạng Marketting",799000,799000,0,0
TIKI,voucher-dich-vu,21787115,"Tick Edu - Trầm Cảm Sau Sinh",699000,699000,0,0
TIKI,voucher-dich-vu,68534865,"Khóa học ĐẠI SỐ 7 - CƠ BẢN + NÂNG CAO thầy Quốc Sơn - 09 tháng",700000,700000,0,0
TIKI,voucher-dich-vu,91305213,"Sách nói: Tìm Bình Yên Trong Gia Đình ",99000,99000,0,0
TIKI,voucher-dich-vu,195881036,"[Evoucher - NSG] DU LỊCH SINGAPORE - MALAYSIA",7990000,7990000,0,0
TIKI,voucher-dich-vu,21787104,"Tick Edu - Photoshop Chỉnh Hình Ảnh Chuyên Nghiệp Cho Nhà Nhiếp Ảnh",699000,699000,0,0
TIKI,voucher-dich-vu,139718208,"[KHÓA HỌC ONLINE TƯƠNG TÁC] Học Revit Structure (CB+NC) chuẩn Nhật Bản - Đại học Xây Dựng",2450000,2450000,0,0
TIKI,voucher-dich-vu,21727072,"DỊCH VỤ PHUN MÔI COLLAGEN",1800000,1800000,0,0
TIKI,voucher-dich-vu,207345059,"Sách nói Content Marketing Trong Kỷ Nguyên 4.0",99000,99000,0,0
TIKI,voucher-dich-vu,249685106,"Tour 6N5Đ Nhật Bản - Tokyo – Yamanashi – Nagoya – Kyoto – Osaka",30630000,30630000,0,0
TIKI,voucher-dich-vu,271779709,"TOUR HỒ TRÀM - TROPICANA PARK 1 NGÀY - XE LIMOUSINE",990000,990000,0,0
TIKI,voucher-dich-vu,68503817,"Khóa học TIẾNG VIỆT LỚP 2 cô Thanh Thủy - 09 tháng",700000,700000,0,0
TIKI,voucher-dich-vu,212565330,"Gói DRAERP Phân phối (DISTRIBUTION DRAERP) - LOẠI HÌNH DOANH NGHIỆP",2250000,2250000,0,0
TIKI,voucher-dich-vu,270275974,"Khóa học 3 tháng tập chạy 21km Techcombank Hồ Chí Minh Marathon",2800000,2800000,0,0
TIKI,voucher-dich-vu,161255655,"Sinh Trắc Vân Tay Gen Talents – Dịch Vụ Tư Vấn Sinh Trắc Vân Tay Gia Đình – Gói Phân Tích Demo – Tặng Sách Người Đua Diều (Tái Bản)",600000,600000,0,0
TIKI,voucher-dich-vu,21775419,"Tick Edu - Phòng Và Trị Bệnh Cơ Xương Khớp, Cột Sống Bằng Tư Thế Đúng",599000,599000,0,0
TIKI,voucher-dich-vu,21761417,"Tick Edu - Tiền hôn nhân và tuyệt chiêu tìm bạn đời phù hợp",399000,399000,0,0
TIKI,dong-ho-va-trang-suc,178780299,"Kềm bấm lỗ dây da đồng hồ, thắt lưng, giày, dép, cặp, túi...",48000,48000,0,0
TIKI,dong-ho-va-trang-suc,44713817,"Dây chuyền nữ mặt bướm xi mạ vàng 18k cao cấp ",199000,199000,0,0
TIKI,dong-ho-va-trang-suc,129347634,"Đồng Hồ Nam Casio GM-5600B-3DR",7152000,7152000,0,0
TIKI,dong-ho-va-trang-suc,161034020,"Dây chuyền nữ inox kiểu mì",78000,78000,0,0
TIKI,dong-ho-va-trang-suc,70192757,"vòng ngọc cẩm thạch bảng vuông",250000,250000,0,0
TIKI,dong-ho-va-trang-suc,183701107,"Đồng Hồ Nam Dây Nhựa Casio Standard MWA-100H-7AVDF Chính Hãng - MWA-100H-7A Gờ Kim Loại",1340250,1787000,446750,25
TIKI,dong-ho-va-trang-suc,177896419,"Cường lực 3D Cạnh Cong Full mặt kính cho Huawei Watch GT3 46mm / 42mm",39000,39000,0,0
TIKI,dong-ho-va-trang-suc,20847283,"Vòng Tay Chỉ Đỏ - Vòng Tay Ngũ Sắc Charm Con Heo Kim Tiền Bạc Si Vàng",390000,390000,0,0
TIKI,dong-ho-va-trang-suc,45404380,"Vòng Tay Đá Mã Não Liền Khối - Ngọc Quý Gemstones",269000,530000,261000,49
TIKI,dong-ho-va-trang-suc,169191223,"Đồng Hồ Nam Dây Nhựa Casio G-Shock GA-2100-1A3DR Chính Hãng - GA-2100-1A3 Carbon Core",2860500,3814000,953500,25
TIKI,dong-ho-va-trang-suc,100465134,"BỘ TRANG SỨC BẠC TA CAO CẤP MÃ BTS0039526",108900,108900,0,0
TIKI,dong-ho-va-trang-suc,16922319,"Nhẫn Nam Đá Cẩm Thạch Sơn Thủy AAA Ngọc Quý Gemstones",1419000,1774000,355000,20
TIKI,dong-ho-va-trang-suc,920494,"Đồng Hồ Nữ Dây Da Julius JA-787A (24 x 19 mm) - Xanh Navy",589000,589000,0,0
TIKI,dong-ho-va-trang-suc,35734248,"Nhẫn Nam Khắc Thần Chú Om Mani Padme Hum Titan Không Rỉ TT 1805",89000,89000,0,0
TIKI,dong-ho-va-trang-suc,162361390,"Đồng Hồ Nam Dây Nhựa Casio Standard W-219H-2A2 Chính Hãng - W-219H-2A2VDF",670500,894000,223500,25
TIKI,dong-ho-va-trang-suc,88820650,"Vòng tam hợp quý nhân hợi mão mùi chất liệu mắt hổ vàng - size 8 10 12ly cho người mệnh thổ, mệnh kim - có khai quang điểm nhãn may mắn tài lộc - bảo hành 12 tháng - PHONG THỦY ANH VŨ",299000,299000,0,0
TIKI,dong-ho-va-trang-suc,51707939,"Combo 2 vòng tay đá mã não mảnh - Ngọc Qúy Gemstones",189000,189000,0,0
TIKI,dong-ho-va-trang-suc,26682634,"Nhẫn Mỹ Bản Tròn Hoa Văn Mẫu 02",125000,125000,0,0
TIKI,dong-ho-va-trang-suc,53990634,"Đồng hồ nam chính hãng Lobinni No.3603",2412000,3828571,1416571,37
TIKI,dong-ho-va-trang-suc,46710492,"Vòng tay đá mã não xanh rêu bản hẹ mệnh mộc hỏa - Ni",469000,920000,451000,49
TIKI,dong-ho-va-trang-suc,178027639,"Dây da đồng hồ da bò thật BO-16 khóa bướm size 12 14 16 18 19 20 21 22 24mm",99000,99000,0,0
TIKI,dong-ho-va-trang-suc,107090949,"Vòng cổ choker titan nữ phong cách Hàn Quốc, Trang sức Bé Heo BHDC253",35000,65000,30000,46
TIKI,dong-ho-va-trang-suc,107761837,"Đồng Hồ Nam LOBINNI No.16038-1 Chính Hãng Fullbox BH 24T Chịu Nước 50m Kính Chống Xước Dây Da Cao Cấp (Máy Cơ Tự Động)",6950000,12785714,5835714,46
TIKI,dong-ho-va-trang-suc,71520677,"Đồng hồ nam dây nhựa Casio G-Shock chính hãng GBX-100-1DR",5441000,5441000,0,0
TIKI,dong-ho-va-trang-suc,7068357,"Dây chuyền nam mạ vàng 18K cao cấp Gentleman MK210",179550,189000,9450,5
TIKI,dong-ho-va-trang-suc,83580073,"Vòng Tay Nam Mô A Di Đà Phật",51000,59000,8000,14
TIKI,dong-ho-va-trang-suc,150227852,"Dây Đồng Hồ Da Da Bò Thật - Dây Da Thay Thế Dành Cho Đồng Hồ Orient Tissot DW Fossil Casio Samsung Huawei - Tặng Kèm Hộp Gỗ và Phụ Kiện Thay Dây",395000,395000,0,0
TIKI,dong-ho-va-trang-suc,98983749,"Dây chuyền nữ mặt đá tròn chất liệu bạc Ý MS85c",151000,151000,0,0
TIKI,dong-ho-va-trang-suc,19448191,"Đồng Hồ Nữ Citizen Đính Kim Cương Dây Thép Không Gỉ EX1120-53X - Mặt Hồng (Sapphire)",36750000,36750000,0,0
TIKI,dong-ho-va-trang-suc,89879388,"Dây chuyền nữ bằng bạc mặt tròn xinh MS105g",160000,160000,0,0
TIKI,dong-ho-va-trang-suc,93018164,"VÒNG TAY HUYẾT ÁP KHẮC THẦN CHÚ",490000,490000,0,0
TIKI,dong-ho-va-trang-suc,17884235,"Đồng hồ nam chính hãng LOBINNI L3604-1",2592000,2880000,288000,10
TIKI,dong-ho-va-trang-suc,43821400,"Đồng hồ thể thao nam điện tử dây thép không gỉ Skmei 1260",230000,230000,0,0
TIKI,tui-vi-nu,172191324,"Túi đeo chéo phong cách Hàn Quốc Đồ Da Thành Long TLG 208097 1(đen)",30000,30000,0,0
TIKI,tui-vi-nu,36266064,"Túi đeo chéo vải canvas, túi vải nữ TV08, phong cách Hàn Quốc, thời trang trẻ",50000,50000,0,0
TIKI,dong-ho-va-trang-suc,36022944,"Dây chuyền bạc thật- Vòng cổ bạc mặt Đá đính pha lê",111000,111000,0,0
TIKI,tui-vi-nu,265177848,"Túi xách nữ đeo chéo xách tay kẹp nách túi chơi đi làm bag đi tiệc Full Hộp DEVIN",300000,300000,0,0
TIKI,tui-vi-nu,45468600,"Túi Xách Nữ - Thời Trang Công Sở",305000,305000,0,0
TIKI,dong-ho-va-trang-suc,116142155,"Vòng đeo tay, lắc tay phong thủy quấn 3 vòng đá mắt hổ vàng đồng tâm",300000,300000,0,0
TIKI,dong-ho-va-trang-suc,108757167,"Đồng hồ nam dây nhựa Casio Standard chính hãng AE-1200WH-1AVDF",900000,1140000,240000,21
TIKI,tui-vi-nu,172191774,"Túi đeo chéo trước ngực phong cách vải bố 208031",34300,62000,27700,45
TIKI,tui-vi-nu,174469112,"Túi Xách Đeo Chéo Nữ Đeo Vai Kẹp Nách MICOCAH Kiểu Dáng Công Sở Thời Trang Da Cao Cấp Cực Đẹp MC46",389000,389000,0,0
TIKI,tui-vi-nu,116594673,"Túi xách nữ - Túi dây pha xích phong cách Hàn Quốc cá tính TD12 - Mincloset",83000,83000,0,0
TIKI,tui-vi-nu,128857481,"TÚI XÁCH NỮ CAO CẤP DA THẬT ELLY – ET118",1379400,2299000,919600,40
TIKI,tui-vi-nu,177477874,"MLB - Túi đeo vai chữ nhật Monogram Jacquard Hobo 3ABQS012N",2590000,2590000,0,0
TIKI,dong-ho-va-trang-suc,64022115,"Khóa bướm chống gãy dây da đồng hồ SAM Leather SAMKB001 - Khoá bấm dây da tự động cao cấp inox 316 không gỉ",195000,195000,0,0
TIKI,tui-vi-nu,104304339,"Túi tote vải đeo chéo, túi canvas bag đi học 2021",112000,112000,0,0
TIKI,tui-vi-nu,136939957,"Túi thổ cẩm đeo vuông",42000,42000,0,0
TIKI,tui-vi-nu,131337323,"Có Khóa Kéo Túi vải bố, Túi vải Canvas trơn Màu Trắng - Màu Be",39000,39000,0,0
TIKI,tui-vi-nu,74026612,"Túi Đeo Chéo Nữ Cao Cấp - SADDLE BAG - HGcork Corkor CK246 - Vật liệu da cork thực vật thuần chay - Sản phẩm Handmade, Sản xuất tại Bồ Đào Nha",2659050,2799000,139950,5
TIKI,dong-ho-va-trang-suc,110979025,"Đồng hồ nam SUNRISE 1190SA full hộp, kính sapphire chống xước chống nước tốt",985000,985000,0,0
TIKI,tui-vi-nu,209414066,"Túi kiêm ví đeo chéo đựng điện thoại dáng dọc trần trám siêu chất Cobala1688",142000,142000,0,0
TIKI,tui-vi-nu,42129001,"TÚI ĐEO VAI NỮ DỄ THƯƠNG - H0028",45000,75000,30000,40
TIKI,tui-vi-nu,115495737,"Túi Xách nữ  Túi Cói Merci Đi Biển, Đi Du lịch, Đi chơi Siêu HOT HIT",77000,77000,0,0
TIKI,tui-vi-nu,87100226,"Balo thời trang, balo đi học, đựng laptop Túi Tote Mèo Cony balo nữ vải",69900,69900,0,0
TIKI,dong-ho-va-trang-suc,13807835," Dây chuyền nam mạ vàng 24k mã 014",320000,320000,0,0
TIKI,tui-vi-nu,56735214,"Ví nữ da bò Marrant BHM4202 Ví gập ba, dập nổi họa tiết 3D, ví đựng thẻ card. Hàng chính hãng",398520,398520,0,0
TIKI,tui-vi-nu,106588168,"Bóp Dài Cầm Tay DEVON Da Thật Saffiano Khóa Kéo Sang Trọng Unisex Dành Cho Nam Nữ DOLANTO",350000,350000,0,0
TIKI,tui-vi-nu,167607312,"Bóp ví nữ dài cầm tay V0124 Kẻ vân chỉ nhiều ngăn tiện lợi, phong cách thời trang, cá tính",70000,140000,70000,50
TIKI,tui-vi-nu,247809152,"Túi tote có khóa, đựng được giấy A4, dành cho laptop, macbook 13 inch, 15 inch",245000,400000,155000,39
TIKI,tui-vi-nu,149449620,"CEEKAY- Túi đeo chéo cao cấp Fullbox",450000,450000,0,0
TIKI,tui-vi-nu,45350251,"Túi xách nữ thời trang công sở siêu xinh TSC258",55000,55000,0,0
TIKI,tui-vi-nu,170771059,"Túi xách nữ vải dù Oxford thời trang cao cấp đeo chéo đa năng nhiều ngăn chứa đồ chống thấm nước size 29cm",215000,215000,0,0
TIKI,dong-ho-va-trang-suc,10315677,"Mặt dây chuyền băng ngọc thủy tảo vuông xanh lá Ngọc Quý Gemstones",1299000,1856000,557000,30
TIKI,tui-vi-nu,11212216,"Túi Tròn Thổ Cẩm Tua Rua NEVENKA N9106",148000,148000,0,0
TIKI,tui-vi-nu,13670372,"Túi vải bố trơn | túi tote trơn | túi canvas trơn",24900,24900,0,0
TIKI,tui-vi-nu,53537582,"Túi xách nữ khóa chữ nhật dây đeo chéo (đeo vai)",69000,69000,0,0
TIKI,tui-vi-nu,151757252,"Túi đeo chéo nữ thời trang cao cấp phong cách Hàn Quốc",99000,99000,0,0
TIKI,tui-vi-nu,58325944,"Túi đeo chéo, túi xách trong suốt",57420,82940,25520,31
TIKI,tui-vi-nu,136940063,"Túi/ ví thổ cẩm combo 3 món",40000,40000,0,0
TIKI,tui-vi-nu,190589365,"Ví Da Mini Cầm Tay 10 Ngăn Họa Tiết thỏ cà rốt Ngộ Nghĩnh Bóp Nữ Da PU Cute Hot Trend( giao ngẫu nhiên)",50000,50000,0,0
TIKI,tui-vi-nu,192579893,"Túi xách nữ thời trang công sở cao cấp phong cách mới",387000,430000,43000,10
TIKI,tui-vi-nu,147941971,"Túi Xách Nữ Kẹp Nách Đeo Chéo Chính Hãng MICOCAH Dáng Công Sở Thời Trang Da Cao Cấp Cực Đẹp Giá Rẻ MC63 - TUKADO",389000,389000,0,0
TIKI,tui-vi-nu,170916262,"Túi Vỏ Bao Đựng Bọc Thẻ Căn Cước Công Dân, Bằng Lái Xe, Thẻ Ngân Hàng, Thẻ Sinh Viên, Thẻ Nhân Viên",1499,1499,0,0
TIKI,tui-vi-nu,89217785,"Túi Xách Nữ    Túi Đeo Chéo Khóa Trái Tim Siêu Đẹp Phong Cách Trẻ Trung",65000,65000,0,0
TIKI,tui-vi-nu,45066961,"túi xách nữ da cá sấu",2000000,2000000,0,0
TIKI,tui-vi-nu,197822738,"Túi Tote thời trang Big size phối dây trắng Hibi Sports A012, chất liệu Canvas cao cấp phù hợp đi chơi, đi tập",299000,420000,121000,29
TIKI,tui-vi-nu,174445639,"Ví Nữ Ngắn Mini Cầm Tay Chính Hãng TAILIAN Thời Trang Nhiều Ngăn Đựng Tiền Vân Da Rắn Cao Cấp  TL34",119000,119000,0,0
TIKI,tui-vi-nu,73486209,"Túi xách túi đeo vai nữ mini quoai ngọc da bóng cực xinh cho mẹ và bé",38000,38000,0,0
TIKI,tui-vi-nu,70937670,"Túi cói thắt nơ",99000,99000,0,0
TIKI,voucher-dich-vu,75319261,"Goimon.net - Hotpot House - 1 Trong 6 Set Lẩu Nhiều Hương Vị Lựa Chọn Dành Cho 2-3 Người",308000,308000,0,0
TIKI,voucher-dich-vu,11797980,"Gói Khám Sức Khỏe Tiền Mang Thai Cho Nam - Phòng Khám Careplus",1500000,1500000,0,0
TIKI,voucher-dich-vu,80063321,"Khóa học Kỹ năng quản lý hiệu quả - Agilearn",1245000,1245000,0,0
TIKI,voucher-dich-vu,155742739,"Sách nói: Tâm Lý Học Đám Đông",99000,99000,0,0
TIKI,voucher-dich-vu,155742754,"Sách nói: Học Khôn Ngoan Mà Không Gian Nan",99000,99000,0,0
TIKI,voucher-dich-vu,209389851,"Phiếu Quà Tặng Beloved & Beyond 500K",500000,500000,0,0
TIKI,voucher-dich-vu,34325063,"Bọc Răng Sứ Cercon Tại Nha Khoa Moli",4490000,4490000,0,0
TIKI,voucher-dich-vu,244132974,"[E-Voucher] Tour Cần Thơ Cà Mau An Giang 3 ngày 2 đêm",3050000,3050000,0,0
TIKI,voucher-dich-vu,34362532,"[HCM] Tour 6N5Đ Hà Nội - Ninh Bình - Hạ Long - Sapa, Gồm Vé Máy Bay Khứ Hồi, Khởi Hành Hàng Tuần",9600000,9600000,0,0
TIKI,voucher-dich-vu,182832440,"Sách nói: Một Nửa Của 13 Là 8",99000,99000,0,0
TIKI,voucher-dich-vu,973188,"Khóa Học Online Luyện TOEIC Nâng Cao 800+",319000,319000,0,0
TIKI,voucher-dich-vu,271663649,"Xe bus Đà Nẵng – Hội An (một chiều)/ Shuttle Bus Da Nang to Hoi An (one way)",150000,150000,0,0
TIKI,voucher-dich-vu,21787103,"Tick Edu - Dựng Phim Truyền Thông Chuyên Nghiệp Với Adobe Premiere",699000,699000,0,0
TIKI,voucher-dich-vu,137229860,"[E-BOOK] New Amanda & Friends 2 File nghe Audio",10000,10000,0,0
TIKI,voucher-dich-vu,185858956,"Tranh 3D Koifish cho hồ cá cảnh, các kích thước, theo yêu cầu",57000,57000,0,0
TIKI,voucher-dich-vu,29284677,"MintWIFI-SIM 4G Du lịch 36 nước Châu Âu tốc độ cao dung lượng 5GB cho 30 ngày sử dụng",779000,779000,0,0
TIKI,voucher-dich-vu,10085218,"Liệu Trình Hifu Tạo Hình VLine Nâng Cơ, Xóa Nhăn, Trẻ Hóa Da Tại Thanh Thanh Spa (Miễn Tip)",1499000,1499000,0,0
TIKI,voucher-dich-vu,221818509,"[E-Voucher] Vietourist - Tour Du Lịch Tây Ninh: Núi Bà Đen - Thánh Địa Đạo Cao Đài",790000,790000,0,0
TIKI,voucher-dich-vu,105836034,"ELLY - Phiếu Quà Tặng 300.000đ",300000,300000,0,0
TIKI,voucher-dich-vu,71188902,"Khóa học CHUYÊN ĐỀ: HÓA HỌC VÔ CƠ - thầy Lê Minh Phấn - 09 tháng",1000000,1000000,0,0
TIKI,voucher-dich-vu,252135736,"Gói 2N1Đ - Du Thuyền 5 Sao Ambassador  Đẳng Cấp Nhất Vịnh Hạ Long - Nghỉ Dưỡng Trọn Gói Dành Cho 02 Người Lớn & 01 Trẻ Em Dưới 5 Tuổi (Miễn Phí Setup Sinh Nhật, Honey Moon, Kỷ Niệm Cưới)",2590000,2590000,0,0
TIKI,voucher-dich-vu,11306320,"Combo Nail: Nhặt Da Tay Kết Hợp Sơn Gel TRINITY Tại MOH Beauty",179000,179000,0,0
TIKI,voucher-dich-vu,269964216,"[EVoucher Vietravel Hà Nội] Combo 3N2D KS Eden Ocean View Hotel Đà Nẵng 4 Sao: VMB khứ hồi Hà Nội - Đà Nẵng + Phòng Tiêu Chuẩn + Ăn sáng",3990000,3990000,0,0
TIKI,voucher-dich-vu,34476220,"Khóa học Bí quyết xây dựng mối quan hệ trong kinh doanh",400000,400000,0,0
TIKI,voucher-dich-vu,205582354,"Phiếu Quà Tặng Lẩu Đài Loan Băng Chuyền Shang Chi 200K",200000,200000,0,0
TIKI,voucher-dich-vu,222659074,"[EVoucher Vietravel] Đà Nẵng - Huế - Đầm Lập An - La Vang - Động Phong Nha & Thiên Đường - KDL Bà Nà - Cầu Vàng -Sơn Trà - Hội An - Đà Nẵng",7990000,7990000,0,0
TIKI,voucher-dich-vu,132184336,"[E-BOOK] CYLET Practice Tests Pre A1 Starters File nghe Audio",10000,10000,0,0
TIKI,voucher-dich-vu,131506242,"Video bài giảng trực tuyến Kỹ năng tổ chức hội nghị, hội họp và đi công tác",50000,50000,0,0
TIKI,voucher-dich-vu,155923812,"HCM [E-voucher] Giảm 30K Giặt Hấp Vest, Blazer, Váy, Đầm, Áo Quần khác - giao nhận tận nơi tại ứng dụng HERAMO",30000,30000,0,0
TIKI,voucher-dich-vu,198463635,"Tour Du lịch Miền Bắc 4N3D (LT8): Nội Bài - Hà Nội - Vịnh Hạ Long - Sapa - Fansipan, Khởi hành Hằng ngày",3949000,3949000,0,0
TIKI,voucher-dich-vu,11183866,"Combo Cắt Da Tay + Sơn Gel + Vẽ Tự Nhiên Tại Vietgangz Nails",229000,229000,0,0
TIKI,voucher-dich-vu,204267279,"T1. ĐỊA TRUNG HẢI, BÃI SAO VÀ NGẮM HOÀNG HÔN VERSAILLES - PHÚ QUỐC ( Tour riêng )",690000,690000,0,0
TIKI,voucher-dich-vu,184512442,"Sách nói: Luật Của Warren Buffett",99000,99000,0,0
TIKI,voucher-dich-vu,190238877,"Hoa Yêu Thương - Evoucher Bình Hoa Tươi - Nắng Hồng ",550000,550000,0,0
TIKI,voucher-dich-vu,170630440,"Khóa Học Video Online Xoa Bóp Giảm Đau Khớp Gối Do Thoái Hóa Khớp, Khô Khớp - Trung Tâm Chăm Sóc Sức Khỏe VMC",900000,900000,0,0
TIKI,voucher-dich-vu,19694062,"Khám Phụ Khoa Nữ Có Gia Đình - HPV Cobas - Phòng Khám Careplus",1900000,1900000,0,0
TIKI,voucher-dich-vu,204339072,"T3. TOUR CANO 3 ĐẢO LẶN NGẮM SAN HÔ TỰ NHIÊN -PHÚ QUỐC",600000,600000,0,0
TIKI,voucher-dich-vu,2065131,"Dịch Vụ Trị Mụn Bằng Mỹ Phẩm Dermaligical Của Mỹ",195000,195000,0,0
TIKI,voucher-dich-vu,253232326,"À La Carte Hạ Long Bay Hotel & Residence 5* - Gồm Bữa Sáng, Nghỉ Dưỡng Đẳng Cấp Bên Bờ Biển, Hồ Bơi Vô Cực View Vịnh, Mới Khai Trương",1499000,1499000,0,0
TIKI,voucher-dich-vu,214766631,"Kịch IDECAF: CƯỚI VỢ CHO AI",270000,270000,0,0
TIKI,balo-va-vali,46148377,"Ba lô tay kéo cho người lớn du lịch đi làm có ngăn laptop size 18 màu đen TT047",920000,920000,0,0
TIKI,balo-va-vali,17487958,"Bao Da Bảo Vệ MacBook Thời Trang – Suede Skin",330000,330000,0,0
TIKI,balo-va-vali,187156916,"Túi máy tính xách tay dành cho Aple, Dell, Asus…15.6 inch – BEE GEE 0124",275000,556000,281000,51
TIKI,balo-va-vali,132003904,"Balo nữ đi học MRMI chứa laptop các loại G233 - BaloGigo",205000,205000,0,0
TIKI,balo-va-vali,48189924,"Túi xách du lịch thể thao nam công suất lớn phong cách hiện đại đã tích hợp công nghệ 4.0",513000,570000,57000,10
TIKI,balo-va-vali,89751462,"Balo nữ không thấm nước cao cấp phong cách hàn quốc",423000,470000,47000,10
TIKI,balo-va-vali,195129187,"Vali Kéo Thời Trang NiceVilla Size 20 & 24 Inch",331500,390000,58500,15
TIKI,balo-va-vali,124274625,"Dây Đai Cột Vali Du Lịch Có Khóa Số",27550,29000,1450,5
TIKI,balo-va-vali,190337353,"Balo Laptop 15.6 inch dung lượng lớn GuBag, dành cho nam nữ dân công sở, đựng laptop chống sốc, chống nước cao cấp",609000,699000,90000,13
TIKI,balo-va-vali,177831998,"Balo laptop nam thông minh đa năng cao cấp phong cách mới",441000,490000,49000,10
TIKI,balo-va-vali,135111833,"Balo nữ thời trang đi chơi đi học phong cách Hàn Quốc BK27",62900,62900,0,0
TIKI,balo-va-vali,194500990,"Balo đi học nam nữ vải dù chống thấm nước đựng laptop 15.6 inch thời trang đi học đi du lịch 1009",305000,305000,0,0
TIKI,balo-va-vali,96187147,"Balo laptop công nghệ cao cấp chống va đập chống trộm chống nước chống rạch",477000,530000,53000,10
TIKI,balo-va-vali,162024222,"BALO HOLOGRAM HOT TREND - HÀNG CAO ",220000,220000,0,0
TIKI,balo-va-vali,185518070,"Túi chống sốc laptop lót lông mềm mại, chống xước laptop phù hợp size 13 inch, 14 inch, 15.6 inch",129000,189000,60000,32
TIKI,balo-va-vali,94589952,"TÚI XÁCH CHỐNG SỐC TOMTOC (USA) SLIM HANDBAG MACBOOK PRO/AIR 13” - Hàng Chính Hãng",739000,739000,0,0
TIKI,balo-va-vali,177975635,"Túi xách du lịch thể thao nam nữ công suất lớn phong cách mới BEE GEE T1006",297000,600000,303000,51
TIKI,balo-va-vali,193125933,"Túi Chống Sốc Laptop 14 inch 15.6 inch Cao Cấp Chống Thấm Nước, Thời Trang, Nhiều Màu Sắc Cá Tính, Vải Trơn Mịn Sịn",130000,130000,0,0
TIKI,balo-va-vali,182739306,"Túi chống va đập Tomtoc Portfolio Holder Hardshell cho Ipad Pro 12.9inch & Tablet/Notebook - Thiết kế cứng cáp, chống va đập, hàng chính hãng",1074000,1249000,175000,14
TIKI,balo-va-vali,185970826,"Balo du lịch đa chức năng cao cấp phong cách cá tính mới",747000,830000,83000,10
TIKI,balo-va-vali,171574040,"Vali kéo du lịch cao cấp bảo hành chính hãng Size 24inch- KS 219 - Hồng nhạt",579000,799000,220000,28
TIKI,balo-va-vali,63473809,"Bao da, túi da, cặp da chống sốc cho macbook, laptop chất da lộn kèm ví đựng phụ kiện - Xám - Macbook Air 13.3 inch đời 2019 - 2020",332500,350000,17500,5
TIKI,balo-va-vali,68303244,"Túi đựng laptop họa tiết lá rùa size 13 inch, 14inch , 15,6inch",240000,240000,0,0
TIKI,balo-va-vali,194816086,"Dây nhựa đeo khẩu trang,mắt kính màu sắc Rainbow",25545,25545,0,0
TIKI,balo-va-vali,171777067,"Vali Du Lịch Cao Cấp Size 24inch - Bảo Hành 5 Năm  KS-T01 - Cam",548000,748000,200000,27
TIKI,balo-va-vali,74939479,"Túi Cần Kéo Du Lịch Thời Trang Cao Cấp SAKOS GIGANT - Hàng chính hãng",1133000,1320000,187000,14
TIKI,balo-va-vali,187009931,"Vali kéo i'mmaX Z1100 nhựa PC/ABS - Bảo hành 3 năm",490000,765000,275000,36
TIKI,balo-va-vali,20234663,"Vali Kéo Vải Du Lịch SAKOS WINNER 7 - Size L (28inch)/ Ký Gửi (Đại) - Khóa TSA - Chống Thấm, Trượt Nước",2446000,2880000,434000,15
TIKI,balo-va-vali,52241790,"Túi xách da chống sốc cho máy tính, macbook, laptop màu hồng cute - Tặng kèm gấu bông và ví đựng phụ kiện",370500,390000,19500,5
TIKI,balo-va-vali,112191397,"Balo nam thời trang đa năng cao cấp phong cách mới",513000,570000,57000,10
TIKI,balo-va-vali,2538137,"Túi Kéo Du Lịch Macat TB38",336600,374000,37400,10
TIKI,balo-va-vali,42084985,"Túi du lịch thời trang YUUMY YMTR03",395000,820000,425000,52
TIKI,balo-va-vali,165991643,"Vali sọc dọc thời trang size 20",410000,410000,0,0
TIKI,balo-va-vali,32980009,"Vali Rover Emi",1249000,1249000,0,0
TIKI,balo-va-vali,186639841,"Balo du lịch cao cấp đa chức năng phong cách mới",450000,499000,49000,10
TIKI,balo-va-vali,108676264,"BALO NỮ - BALO HỌC SINH - BAlO VẢI CHỐNG TRỘM CHỐNG NƯỚC THÊU HOA VÀ CHỮ (HÀNG LOẠI 1)",159000,159000,0,0
TIKI,balo-va-vali,50460635,"Combo 3 Túi Trong Suốt - Đựng Mỹ Phẩm, Đồ Trang Điểm Tiện Lợi",50999,50999,0,0
TIKI,balo-va-vali,76296634,"Balo chống nước đen nam nữ Unisex thời trang balo đa năng đi học laptop sinh viên Cặp Ulzzang",47090,47090,0,0
TIKI,balo-va-vali,20238711,"Vali Kéo Vải Du Lịch SAKOS STARLINE 4.5 - Size XS (18inch)/ Xách Tay (Cabin) - Khóa TSA - Chống Thấm, Trượt Nước",1634000,1925000,291000,15
TIKI,balo-va-vali,176151010,"Túi laptop Kipton L  AMERICAN TOURISTER - MỸ Trọng lượng nhẹ Chất liệu vải chống thấm nước Phù hợp với laptop 15",558000,800000,242000,30
TIKI,balo-va-vali,125100618,"Bộ 6 túi du lịch chống thấm Bags in Bag (xanh lá)",79000,79000,0,0
TIKI,balo-va-vali,179531113,"Balo da tự nhiên đa năng cao cấp phong cách mới",495000,550000,55000,10
TIKI,balo-va-vali,30027193,"Combo Balo Unisex Campus Cá Tính & Túi Đeo Ipad PRAZA - BLS0177DC095",229000,299000,70000,23
TIKI,balo-va-vali,108154769,"Balo thời trang, balo đi học, đựng laptop Balo thời trang, đi học, đựng laptop - BALO NẮP QTK 2 Khoá balo nữ vải",79000,79000,0,0
TIKI,balo-va-vali,50487887,"Balo thời trang DA cao cấp, thết kế trẻ trung, tặng kèm quai đeo móc khóa bông dễ thương TKL13",149000,179000,30000,17
TIKI,balo-va-vali,7463189,"Túi xách laptop Sakos Astro 15",1056000,1056000,0,0
TIKI,balo-va-vali,50476901,"Túi xách du lịch thể thao nam công suất lớn phong cách châu âu hiện đại đã tích hợp công nghệ 4.0",495000,550000,55000,10
TIKI,tui-vi-nu,189897281,"Đeo chéo nữ Thời Trang công sở cao cấp – DCNU1001",198000,400000,202000,51
TIKI,tui-vi-nu,190589367,"Bóp Ví Cầm Tay Ví Dài Khóa Kéo Nữ Nhiều ngăn Hình Khủng Long Siêu Cute Cho Bạn Gái ( giao ngẫu nhiên)",62000,62000,0,0
TIKI,tui-vi-nu,67666778,"Túi đeo chéo đeo bụng hiện đại thời trang siêu đẹp Tặng móc khóa nam cao cấp",124740,170478,45738,27
TIKI,balo-va-vali,191465787,"Ba lô du lịch thể thao nam công suất lớn phong cách hiện đại – BLLN1001",911000,1840000,929000,50
TIKI,balo-va-vali,143867924,"Balo nữ đi học thời trang Ulzzang Hàn Quốc, cặp sách đẹp hàng cao cấp dễ thương, túi xách học sinh chống nước",197000,197000,0,0
TIKI,balo-va-vali,836292,"Vali Sakos Champion 4.5 SLX055DNF (52 x 34 cm) - Xanh",1671000,1969000,298000,15
TIKI,balo-va-vali,57651838,"TÚI XÁCH DA CHỐNG SỐC, CẶP ĐỰNG MÁY TÍNH, MACBOOK, LAPTOP MÀU HỒNG CUTE SIÊU CHỐNG NƯỚC - TẶNG KÈM GẤU BÔNG",188000,188000,0,0
TIKI,balo-va-vali,34575595,"Túi du lịch cỡ lớn BIG-OXFORD sang trọng V3 Shalla",232650,317955,85305,27
TIKI,tui-vi-nu,11886861,"Túi mây tre đan trơn mấn góc - Nhỏ 18cm",199000,219000,20000,9
TIKI,balo-va-vali,127046673,"Túi chống sốc đeo chéo dáng dọc Wiwu cho ipad, surface, macbook, laptop 12.9 inch, 13 inch",470250,495000,24750,5
TIKI,tui-vi-nu,181096611,"Túi xách nữ MONOGRAM CANVAS ELLY – EL205",1044450,1899000,854550,45
TIKI,balo-va-vali,188056810,"Cặp da công sở,Túi xách công sở nam Cao Cấp KQDAISHU-Chất liệu Da PU cực bền,Cặp Đựng Laptop 14 inh,Vệ sinh dễ dàng 8012-3",695000,695000,0,0
TIKI,balo-va-vali,173056664,"Túi Đựng Chống Sốc Macbook, Laptop, iPad Kiêm Tản Nhiệt Sleeve Đa Năng - Đủ Size 11 inch - 17 inch",259000,259000,0,0
TIKI,tui-vi-nu,55409165,"Túi xách đeo vai nữ thời trang, sang trọng 0962",165000,165000,0,0
TIKI,balo-va-vali,129147557,"Balo Laptop 16 Inch Thời Trang Nhỏ Gọn Cao Cấp Kim Long Kl039 - Thời Trang Ti Ti",396750,529000,132250,25
TIKI,balo-va-vali,131337897,"Balo Túi dây rút ngoài trời Túi đựng đồ lặt vặt, đựng quần áo không thấm nước đi biển",19000,19000,0,0
TIKI,tui-vi-nu,26191856,"Túi đeo chéo mini cho nữ chất liệu vài poly",59667,81545,21878,27
TIKI,balo-va-vali,63473817,"Bao da, túi da, cặp da chống sốc cho macbook, laptop chất da lộn kèm ví đựng phụ kiện - Vàng Cát - Macbook Pro 13.3 inch đời 2019 - 2020",332500,350000,17500,5
TIKI,tui-vi-nu,184859332,"Túi xách nữ thời trang cao cấp thời trang – BEE GEE TN1006",178000,360000,182000,51
TIKI,balo-va-vali,12430770,"Túi Kéo Du Lịch Xách Tay Lavar CT3",782800,824000,41200,5
TIKI,tui-vi-nu,72701832,"móc khóa móc phụ kiện túi xách 1 cặp",29000,29000,0,0
TIKI,tui-vi-nu,184069057,"HAVAIANAS - Túi đeo chéo mini hình thang hiện đại Bucket 4146864",450000,450000,0,0
TIKI,balo-va-vali,73274831,"Túi bọc Vali nhựa dẻo dày dặn trong suốt - Bao bọc Vali nhựa PVC trong suốt chống nước. không viền - 20 inch",44550,60885,16335,27
TIKI,balo-va-vali,104411080,"Túi chống sốc Tomtoc Premium Leather For Macbook Pro/Air M1 13/15/16Inch Gray - Hàng chính hãng",1149000,1149000,0,0
TIKI,tui-vi-nu,180225512,"Túi Ví Nữ Cầm Tay Thời Trang Mini Cao Cấp Sang Trọng Lịch Sự Đựng Chìa Khóa, Son Môi - M1",65000,80000,15000,19
TIKI,balo-va-vali,183907533,"Túi xách du lịch thể thao nam nữ công suất lớn phong cách mới BEE GEE T1015",416000,840000,424000,50
TIKI,balo-va-vali,80975450,"Balo Laptop Nam Nữ Thời Trang Cao Cấp Galaxy Store 17.3" GBL03A - Hàng Chính Hãng",494000,1000000,506000,51
TIKI,tui-vi-nu,149179446,"TÚI ĐEO CHÉO THỜI TRANG NỮ DÂY ĐEO DA PHỤ KIỆN THỜI TRANG",520800,520800,0,0
TIKI,tui-vi-nu,187805326,"Túi xách nữ dễ thương NASI T1042 túi vải bố canvas cầm tay đẹp đeo vai thời trang hàn quốc",79000,79000,0,0
TIKI,balo-va-vali,17969884,"Bộ 6 Túi Du Lịch Laundry Pouch",87000,87000,0,0
TIKI,balo-va-vali,72885997,"Vali du lịch kéo tay TN 24 inch",315000,459000,144000,31
TIKI,balo-va-vali,43951347," Balo Laptop Cao Cấp Mikkor The Ives Backpack - Navy",649000,649000,0,0
TIKI,balo-va-vali,109385101,"Cặp Học Sinh Nữ Version Hàn Quốc Ulzzang Balo Học Sinh Nữ Dễ Thương Dành Cho Học Sinh Tiểu Học Trung Học Mã FS833",99000,99000,0,0
TIKI,balo-va-vali,91492310,"Ba Lô Rằn Ri Hàng Chuẩn Dành Để Đi Rừng Hay Đi Phượt",159000,159000,0,0
TIKI,tui-vi-nu,2020651,"Ví Nữ Da Đà Điểu 1 Khóa Huy Hoàng HT3423 (19 x 10.5 cm) - Đen",1499000,1499000,0,0
TIKI,balo-va-vali,174292322,"Túi Trống Du Lịch Thể Thao Nam Tròn Có Ngăn Đựng Giày Riêng Biệt Chống Thấm Nước Tuyệt Đối TRONG-06",203000,203000,0,0
TIKI,tui-vi-nu,198129408,"Túi Cói Đi Biển Vintage, Giỏ Xách Cỏ Bàng Vẽ Hoa Cúc Cao Cấp, Chuẩn Đẹp TXCBVHCLTK18",339000,339000,0,0
TIKI,tui-vi-nu,260407494,"Dây kéo YKK Thái 2 chiều (không kèm đầu khóa) răng 5",70000,70000,0,0
TIKI,balo-va-vali,179912859,"Balo Kmore The Carter",550000,550000,0,0
TIKI,tui-vi-nu,36285599,"TÚI ĐEO CHÉO ĐỰNG ĐIỆN THOẠI HÌNH GẤU",110000,122000,12000,10
TIKI,tui-vi-nu,180226070,"Túi Ví Nữ Cầm Tay Thời Trang Mini Cao Cấp Sang Trọng Lịch Sự Đựng Chìa Khóa, Son Môi - M2",75000,85000,10000,12
TIKI,tui-vi-nu,125100755,"Bộ 2 Ví đựng hộ chiếu giấy tờ và thẻ 12 ngăn (hồng , xanh nhạt)",69000,69000,0,0
TIKI,balo-va-vali,178096213,"Balo Laptop công sở nam nữ cao cấp, đựng máy tính, laptop, macbook 15.6 inch chống sốc, chống nước – BEE GEE BLLT9009",515000,1040000,525000,50
TIKI,tui-vi-nu,13215443,"Túi nữ cao cấp da thật ELLY- ET92",1949350,2999000,1049650,35
TIKI,balo-va-vali,58025051,"Balo Nam Thời Trang Du Lịch Cỡ Lớn Vải Bố Canvas Bền Chắc Phong Cách mới Dành Cho Đi Học, Dã Ngoại, Đi Phượt, Đựng Laptop (14-17")",423000,470000,47000,10
TIKI,tui-vi-nu,108696893,"Ví ngắn cầm tay Prettyzys/Pritti 2021 thiết kế in hoa đơn giản (PTZ95)",210000,210000,0,0
TIKI,tui-vi-nu,187828611,"Túi đeo chéo nữ vải dù trần trám 4 ngăn chống nước, phong cách Hàn Quốc Size 22cm",129000,129000,0,0
TIKI,tui-vi-nu,192031857,"Ví Nữ Mini Cầm Tay Chính Hãng MICOCAH Bóp Nữ Mini Phối Vân Da Rắn Nhỏ Gọn Nhiều Ngăn Tiện Dụng Da Cao Cấp Cực Đẹp Giá Rẻ MC49 - Micocah Mall",169000,169000,0,0
TIKI,balo-va-vali,118007288,"túi xách du lịch thể thao nam kiêm balo du lịch cao cấp phong cách mới(15,6")",1080000,1200000,120000,10
TIKI,tui-vi-nu,201697057,"Túi xách nữ tuổi trung niên mần sui- túi đi tiệc trung niên đính đá form da mềm sang trọng(túi tặng mẹ,bà)",299000,299000,0,0
TIKI,tui-vi-nu,42240058,"Túi đựng điện thoại đeo chéo thời trang dọc nắp Trơn ép chữ N7 Shalla",83160,120120,36960,31
TIKI,tui-vi-nu,53501336,"Túi đeo chéo nữ Hàn Quốc",68000,68000,0,0
TIKI,tui-vi-nu,35857223,"Túi Xách Nữ Đeo Chéo Phong Cách Ngọc Trinh BT19",55000,55000,0,0
TIKI,balo-va-vali,1310759,"Túi Chống Sốc Macbook LaptopTCS - Hồng (15)",199000,199000,0,0
TIKI,tui-vi-nu,175542103,"Túi da bò",999000,999000,0,0
TIKI,balo-va-vali,147965857,"Bao Passport – Vỏ Bọc Hộ Chiếu,  Dẻo Trong Suốt, Tiện Dụng, An Toàn Khi Đi Du Lịch, Nhỏ Gọn, Dễ Dàng Sử Dụng - Takyhome5310",19000,19000,0,0
TIKI,balo-va-vali,7228633,"Dây Đai An toàn Vali - Màu ngẫu nhiên",13698,18720,5022,27
TIKI,tui-vi-nu,143282150,"HJ6201-02-03-04 - Túi xách nữ Huy Hoàng da cá sấu hộp vuông nhiều màu",10499000,10499000,0,0
TIKI,balo-va-vali,167468297,"Cặp đi học nữ, cặp đi học giá rẻ, Balo học sinh cấp 2, cấp 3, cặp đẹp giá rẻ Balo 4 Món - Combo Balo 4 Món Cô Bé Táo",87900,87900,0,0
TIKI,balo-va-vali,73521796,"Cặp Đa Năng Thời Trang Cao Cấp SAKOS FLASH 10 15.6 Inch",891000,990000,99000,10
TIKI,balo-va-vali,164268729,"TÚI DU LỊCH NAM SIZE LỚN HÀNG MỚI TÚI XÁCH NAM CAO CẤP CÓ NGĂN ĐỂ GIÀY RIÊNG BIỆT FREE SHIP",173804,237532,63728,27
TIKI,tui-vi-nu,209414568,"Ví nữ dài 2 ngăn 2 khóa tiện dụng cực chất Q",113000,113000,0,0
TIKI,tui-vi-nu,109089147,"Ví nữ mini họa tiết mèo dễ thương, ví vải chống nước cao cấp, tặng kèm dây đeo năng động",200000,200000,0,0
TIKI,tui-vi-nu,188057302,"Túi đeo chéo họa tết vải dù chống thấm nước cao cấp size 20cm TUI-14",99000,99000,0,0
TIKI,tui-vi-nu,147197355,"Túi Hậu Môn Nhân Tạo 2 Mảnh- Hollister (Trong, Sử Dụng Kẹp), 18102 / 18103 / 18104 -VT0737",454000,454000,0,0
TIKI,tui-vi-nu,58394274,"Túi Xách Nữ Thời Trang Cao Cấp Phong Cách Hàn Quốc N0210",395000,395000,0,0
TIKI,balo-va-vali,20238949,"Vali Kéo Vải Du Lịch SAKOS  STARLINE 5 - Size S (20inch)/ Xách Tay (Cabin) - Khóa TSA - Chống Thấm, Trượt Nước",2055000,2055000,0,0
TIKI,tui-vi-nu,106657155,"Túi clucth cầm tay, clutch Quảng Châu, ví dài, ví da, ví da cao cấp, ví nữ, clutch dự tiệc, túi công sở",286000,286000,0,0
TIKI,tui-vi-nu,55057031,"Túi tote vải canvas đi học,đi chơi phon cách Hàn Quốc siêu hot",54900,54900,0,0
TIKI,tui-vi-nu,157199182,"Túi vải bố cao cấp LMCATION",37050,39000,1950,5
TIKI,tui-vi-nu,54053319,"Túi đeo chéo Nữ đựng điện thoại - C02A",150000,150000,0,0
TIKI,tui-vi-nu,53769045,"Túi đeo chéo nam nữ thời trang Hàn quốc BEE GEE 085 chống thấm nước",54000,110000,56000,51
TIKI,tui-vi-nu,72032325,"Túi xách nữ thời trang cao cấp ELLY- EL139",899400,1499000,599600,40
TIKI,balo-va-vali,45468785,"Balo Du Lịch Thời Trang Uniex STARGO SELINA",355000,355000,0,0
TIKI,balo-va-vali,170382330,"Túi bao da PU đựng Macbook Laptop chống nước chống sốc kèm bao da nhỏ đựng phụ kiện",220580,269000,48420,18
TIKI,balo-va-vali,69443042,"Túi xách chống sốc cho máy tính, macbook, laptop chống nước, siêu nhiều ngăn màu tím - TÍM - 14 INCH",370500,390000,19500,5
TIKI,balo-va-vali,32610298,"Set 5 món Ba Lô Nữ Thời Trang balo laptop Smile Cloudy (hồng phấn)",78999,78999,0,0
TIKI,balo-va-vali,189473456,"Áo trùm vali immax vải không dệt",55000,100000,45000,45
TIKI,balo-va-vali,967590,"Combo Balo Và Túi Đeo Chéo Nam HARAS HRTK138083 - Đen",190000,190000,0,0
TIKI,balo-va-vali,150123818,"Ba lô nam nữ leo núi dung tích lớn 45L chống thấm nước",225000,225000,0,0
TIKI,balo-va-vali,84440323,"Balo du lịch cao cấp phong cách mới 15,6",423000,470000,47000,10
TIKI,balo-va-vali,10679608,"Túi xách tập gym du lịch Pink Hồng",131000,131000,0,0
TIKI,balo-va-vali,44432598,"Thẻ ghi nhớ vali ba lô hành lý chìa khóa name tag 8,5*5cm",10000,10000,0,0
TIKI,balo-va-vali,115572899,"Vali kéo du lịch thời trang SUNNY BUBULE - EL (2 size 10 màu)",990000,1500000,510000,34
TIKI,balo-va-vali,14994922,"Túi bọc bảo vệ vali - Áo vỏ bọc vali H13",169000,232000,63000,27
TIKI,balo-va-vali,196336068,"Balo caro nữ đi học màu sắc pastel thời trang ulzzang Hàn Quốc đáng yêu dễ thương CR3003",305000,305000,0,0
TIKI,balo-va-vali,21275929,"Túi xách da, cặp xách da chống sốc cho macbook, laptop, surface cao cấp",350550,369000,18450,5
TIKI,balo-va-vali,56760919,"Balo thời thời trang nữ mini MQ09",99000,99000,0,0
TIKI,balo-va-vali,69443040,"Túi xách chống sốc cho máy tính, macbook, laptop chống nước, siêu nhiều ngăn màu tím - TÍM - 13 INCH",370500,390000,19500,5
TIKI,tui-thoi-trang-nam,244316262,"Ví nam đựng tiền đựng chìa khóa đựng thẻ đa năng 100% da bò thật cao cấp phong cách mới",333000,370000,37000,10
TIKI,balo-va-vali,191816851,"Balo Magna 02 AMERICAN TOURISTER - MỸ : Dây đeo vai trợ lực, công nghệ Tractum Suspension Bao gồm áo trùm bảo vệ balo chống nước, chống bụi Đệm lưng thoải mái, thoáng mát Ngăn chứa bình nước ở bên hông",1328000,1900000,572000,30
TIKI,balo-va-vali,147942502,"Balo Nữ Mini Thời Trang FOREVER YOUNG Đi Học Đi Chơi Phong Cách Châu Âu Đeo Vai Đeo Chéo Đa Năng BL02 - Tukado",229000,229000,0,0
TIKI,balo-va-vali,197193540,"Balo nam thời trang đa chức năng cao cấp phong cách mới",477000,530000,53000,10
TIKI,tui-thoi-trang-nam,126039327,"Bóp Đựng Thẻ ATM Nhỏ Gọn SUPPLE, Da Bò SMALL PEBBLE Mềm Mại - Bền Bỉ, Chống Xước - Chống Nhăn Tốt, Thiết Kế Hiện Đại, Ngăn Súp Lê Rộng, Đựng Được Nhiều Thẻ Ngân Hàng, Card Danh Thiếp, Căn Cước Công Dân, Dáng Đứng - Gập 2 – Hàng Chính Hãng SAIGIO",683000,699000,16000,2
TIKI,tui-thoi-trang-nam,105660567,"Túi đeo chéo nam nữ mini đựng điện thoại phong cách thời trang Hàn Quốc - Túi xách chống nước đi du lịch, đi chơi",69000,69000,0,0
TIKI,balo-va-vali,103875366,"Túi Chống Sốc Dành Cho Laptop, Macbook 13 inch - Alpha Vertical Double Layer",532000,560000,28000,5
TIKI,tui-thoi-trang-nam,113760273,"Ví nam da bò cao cấp phong cách mới",387000,430000,43000,10
TIKI,tui-thoi-trang-nam,197879894,"Bóp Đứng Nam Nhỏ Gọn, Chất Liệu Da Bò PULL-UP Mềm Mại, Mỏng Nhẹ, Phong Cách Hiện Đại - Cá Tính, Size Trung, Dáng Đứng - Gập 2, Nhiều Ngăn Để Tiền Và Giấy Tờ Tiện Dụng",982000,999000,17000,2
TIKI,tui-thoi-trang-nam,260811579,"Túi da cao cấp Macsim mã MSN18N",1280000,1280000,0,0
TIKI,balo-va-vali,4210881,"Balo laptop Simplecarry B2B05",590000,590000,0,0
TIKI,tui-thoi-trang-nam,48256263,"Ví Nam Da Bò KEIO NIPPON Cao Cấp Kiểu Ngang | Bóp Da Bò Nam Ngang Cánh Lật",249000,249000,0,0
TIKI,tui-thoi-trang-nam,125290044,"Ví nam, bóp nam da bò Saffiano Bụi Leather V141 - Bảo hành 12 tháng",225000,435000,210000,48
TIKI,balo-va-vali,194041830,"Vali NiceVilla Nhựa Dẻo PP Chống Sốc Chống Va Đập Size 20inch & 24inch & 28inch",637500,750000,112500,15
TIKI,tui-thoi-trang-nam,117401394,"Ví Đựng Thẻ ATM Mini, Da Bò Mềm Mại GENTLE, Da Thật 100%, Thiết Kế Hiện Đại, Nhiều Ngăn Tiện Dụng, Đựng Thẻ Ngân Hàng, Danh Thiếp, Căn Cước, Hình Lưu Niệm, Dáng Đứng - Gập 2 - Hàng Chính Hãng SAIGIO",629000,649000,20000,3
TIKI,balo-va-vali,10108067,"Balo Laptop RIVACASE 7560 - 15.6 inch",845000,989000,144000,15
TIKI,tui-thoi-trang-nam,191820415,"Túi Đeo Chéo Nam Thể Thao US ARMY, Túi Đeo Bao Tử  Đeo Bụng Lính Mỹ Phong Cách Chất Vải Kaki Cao Cấp Chồng Nước Nhẹ - HÀNG CHÍNH HÃNG",98000,259000,161000,62
TIKI,tui-thoi-trang-nam,710785,"Túi Đeo Chéo Nam HARAS HRTK083 (26 x 16.5 cm) - Đen",100000,100000,0,0
TIKI,balo-va-vali,139211174,"Thẻ đeo hành lý treo vali nhiều hình",10718,15481,4763,31
TIKI,balo-va-vali,24855409,"Balo vải nữ cao cấp Classic Diamond",347000,385000,38000,10
TIKI,balo-va-vali,42410043,"Balo đựng Laptop đa năng chất liệu cao cấp chống thấm nước, thiết kế nhiều ngăn tiện dụng TK0031 - XÁM",110000,150000,40000,27
TIKI,tui-thoi-trang-nam,262043415,"Túi da cao cấp Macsim mã MSN101",1540000,1540000,0,0
TIKI,tui-thoi-trang-nam,115500712,"Ví nam AD01, bóp nam da thật, ví da nam ví đứng nhiều ngăn đựng tiền đựng thẻ tiện dụng chất",145000,145000,0,0
TIKI,tui-thoi-trang-nam,125290044,"Ví nam, bóp nam da bò Saffiano Bụi Leather V141 - Bảo hành 12 tháng",219000,435000,216000,50
TIKI,tui-thoi-trang-nam,106699231,"Túi Đeo Chéo Nam Cao Cấp Chất Liệu Vải Dù Chống Thấm Nước,Túi Đeo Vai Phong Cách Thời Trang Hàn Quốc Dành Cho Người Đi Làm, Học Sinh, Sinh Viên,Người Đi Chơi, Đi Du Lịch",295000,295000,0,0
TIKI,balo-va-vali,710954,"Balo Laptop HARAS HRTK098 15.6 - Xám",200000,200000,0,0
TIKI,tui-thoi-trang-nam,77741254,"Túi Đeo Hông Thời Trang Nam Nữ Cá Tính Túi Bao Tử Vải Dù Cao Cấp Đeo Chéo Nam Nữ Nhỏ Gọn Tiện Dụng TU17",38610,52767,14157,27
TIKI,tui-thoi-trang-nam,174022359,"Ví Bóp Vải Canvas JOHZEON Kiểu Dáng Hàn Quốc Nhiều Ngăn Bền Bỉ Tiện Lợi DV100",68000,80000,12000,15
TIKI,tui-thoi-trang-nam,188997932,"Túi Đeo Chéo Nhiều Ngăn Chứa Cho Nam Nữ Cao Cấp Đi Chơi Chống Nước, Túi Đựng Điện Thoại Ipad, Túi Đeo Vai Thời Trang Sang Trọng Thời Thượng",135000,135000,0,0
TIKI,voucher-dich-vu,54999656,"NEWSTAR TRAVEL - Tour Trong Ngày Miệt Vườn Mỹ Tho - Bến Tre",850000,850000,0,0
TIKI,tui-thoi-trang-nam,141474172,"Túi đeo chéo, đeo vai nhiều ngăn vải Oxford cao cấp chống thấm nước, bền bỉ unisex nam nữ phong cách thời trang, cá tính",85000,180000,95000,53
TIKI,tui-thoi-trang-nam,142813028,"Túi nam đeo chéo đi học, đi làm 2 màu DN275",169000,220000,51000,23
TIKI,balo-va-vali,195107241,"Túi đeo chéo Tomtoc Premium Theher ShoulderBag cho Macbook và Laptop 13"14" - Hàng Chính Hãng",1459000,1459000,0,0
TIKI,balo-va-vali,157253925,"Balo Da Cao Cấp In SAIGON SWAGGER Eclipse Leather Backpack",850000,850000,0,0
TIKI,voucher-dich-vu,136942959,"[E-BOOK] Summer Camp starter Pre A1 Starters Sách giáo viên điện tử",15000,15000,0,0
TIKI,tui-thoi-trang-nam,169277360,"ví nam AD12, bóp nam da bò saffiano cao cấp, ví da nam ví ngang thiết kế nhiều ngăn nhỏ gọn thời trang, bảo hành da 6 tháng - Adonis Store",185000,289000,104000,36
TIKI,tui-thoi-trang-nam,71023609,"Ví Da Nam, Bóp Da Nam Đựng Tiền Nhiều Ngăn Tiện Lợi - Mẫu Mới Dòng Cao Cấp Bogesi - Ví Nam Ngang - Kích Thước 10 x 1.5  x 12 cm",79000,79000,0,0
TIKI,tui-thoi-trang-nam,185991219,"Túi đeo chéo nam đa năng cao cấp phong cách mới",333000,370000,37000,10
TIKI,tui-thoi-trang-nam,76152029,"Ví Nam, Nữ Cầm Tay Cao Cấp VinBuy – Bóp Nam, Nữ Kiểu Dáng Sang Trọng Cao Cấp Dành Cho Doanh Nhân – Hàng Chính Hãng VinBuy",121000,250000,129000,52
TIKI,voucher-dich-vu,122502105,"[APP] i-Learn Smart Start English for Science 2 - Ứng dụng phần mềm tương tác sách học sinh",25000,25000,0,0
TIKI,balo-va-vali,16928451,"Túi chống sốc cho macbook, laptop 13 inch thương hiệu Anki - Xanh",188100,198000,9900,5
TIKI,balo-va-vali,19638199,"Balo Laptop Du Lịch Thời Trang Cao Cấp SAKOS EPSILON Dành Cho Laptop 14 Inch (14")",1090000,1090000,0,0
TIKI,tui-thoi-trang-nam,124966188,"Ví nam, bóp nam da bò sáp Mexico Bụi Leather V102 - Bảo hành 12 tháng",200000,370000,170000,46
TIKI,tui-thoi-trang-nam,115712587,"Túi Đeo Chéo Nam Cao Cấp Phong Cách Châu Âu Với Thiết Kế Kinh Điển Không Bao Giờ Lỗi Mốt, Chất Liệu Vải Oxford Chống Nhăn, Chống Nước, Chống Bám Bụi Bẩn,Túi Đeo Vai Phong Cách Thể Thao Đường Phố",219000,219000,0,0
TIKI,voucher-dich-vu,204880794,"Sách nói: Sử Ta Chuyện Xưa Kể Lại - Tập 2",99000,99000,0,0
TIKI,balo-va-vali,3006993,"Túi Xách Du Lịch Cao Cấp Praza TX082 (Đen)",168000,168000,0,0
TIKI,voucher-dich-vu,21761407,"Tick Edu - Tăng trưởng doanh số bán hàng nhờ chiến lược khuyến mãi",399000,399000,0,0
TIKI,tui-thoi-trang-nam,169279392,"ví nam AD14, ví sen mini cao cấp, bóp nam da bò thật nguyên tấm , ví da nam nhỏ gọn thiết kế đơn giản tiện dụng, bảo hành da 06 tháng - Adonis Store",159000,269000,110000,41
TIKI,voucher-dich-vu,21775455,"Tick Edu - Nghệ Thuật Chăm Sóc Khách Hàng Xuất Sắc",799000,799000,0,0
TIKI,voucher-dich-vu,174860036,"[E-BOOK] i-Learn Smart Start Special Edition 2 Giáo án gợi ý",15000,15000,0,0
TIKI,tui-thoi-trang-nam,82372883,"Túi đeo chéo nam cao cấp phong cách mới",297000,330000,33000,10
TIKI,voucher-dich-vu,76693576,"OKRX - Khóa học Quản trị mục tiêu hiện đại với OKR - Kỹ năng Quản lý - Agilearn | Giải pháp Đào tạo Số hàng đầu cho Doanh nghiệp tại Việt Nam",1270000,1270000,0,0
TIKI,tui-thoi-trang-nam,124966188,"Ví nam, bóp nam da bò sáp Mexico Bụi Leather V102 - Bảo hành 12 tháng",200000,370000,170000,46
TIKI,tui-thoi-trang-nam,153912766,"Túi Đeo Chéo Nam Nữ U968 US ARMY, Túi Đeo Hông Tiện Dụng Chống Nước Vải Canvas Cao Cấp Phong Cách Lính -HÀNG CHÍNH HÃNG",80000,199000,119000,60
TIKI,voucher-dich-vu,270765390,"TTC Premium Hotel Cần Thơ 4* - Ngay Bến Ninh Kiều, Có Buffet Sáng, Hồ Bơi, Khách Sạn Vị Trí Thuận Tiện Tham Quan và nhiều ưu đãi hấp dẫn",1098000,1098000,0,0
TIKI,tui-thoi-trang-nam,77746659,"Túi đeo chéo nam vải canvas cao cấp phong cách mới",359000,398000,39000,10
TIKI,tui-thoi-trang-nam,127551391,"Túi đeo chéo Black Rice vải canvas bền bỉ phong cách thòi trang unisex nam nữ Hàn",105000,210000,105000,50
TIKI,balo-va-vali,4891137,"Túi xách du lịch Sakos Sakos M Traveller",802000,935000,133000,14
TIKI,voucher-dich-vu,249673480,"Tour 5N4Đ Đài Loan - Đài Bắc - Đài Trung - Cao Hùng, Khởi Hành Tháng 5, 6 ,7",12568000,12568000,0,0
TIKI,tui-thoi-trang-nam,72769110,"Ví Da Bò Nam KEIO NIPPON Cao Cấp Nhập Khẩu Italia, Khóa Kéo, Kích Thước 12x9,5cm DBNKK12",229000,229000,0,0
TIKI,voucher-dich-vu,95175053,"Sách nói: Nhà Tiên Tri Vanga Và Vũ Trụ Huyền Bí",99000,99000,0,0
TIKI,tui-thoi-trang-nam,194859087,"ví nam Cef03, bóp nam cefiro logo tộc trưởng da bò cao cấp, ví da nam ví đứng thiết kế nhiều ngăn đựng tiền đựng thẻ, bảo hành da 6 tháng - Adonis",169000,269000,100000,37
TIKI,tui-thoi-trang-nam,81112510,"Túi đeo hông, đeo bụng nam, nữ chạy bộ thể thao",32670,47190,14520,31
TIKI,voucher-dich-vu,187792643,"Dubai | Abu Dhabi (4N4Đ)",28890000,28890000,0,0
TIKI,tui-thoi-trang-nam,110182282,"Túi Đeo Chéo Nam Phong Cách Lính U448 US ARMY Vải Dệt Cao Cấp -Hàng Chính Hãng",111000,290000,179000,62
TIKI,balo-va-vali,188995358,"Balo Laptop Công Sở Thời Trang Cao Cấp, Cặp Đựng Laptop Nhiều Ngăn, Đa Công Dụng, Dùng Đi Làm Đi Chơi & Du Lịch",185000,185000,0,0
TIKI,voucher-dich-vu,161026807,"Sinh Trắc Vân Tay Gen Talents – Dịch Vụ Tư Vấn Sinh Trắc Vân Tay Gia Đình – Gói Phân Tích Demo – Tặng Sách Điều Kỳ Diệu Của Tiệm Tạp Hóa NAMIYA (Tái Bản)",600000,600000,0,0
TIKI,voucher-dich-vu,246856334,"[E-Voucher] Sách nói Fonos; Xây Dựng Câu Chuyện Thương Hiệu",99000,99000,0,0
TIKI,tui-thoi-trang-nam,72724925,"Ví Nam Vân Cá Sấu KEIO NIPPON Da Bò Nhập Khẩu Italia, Kích thước 12x9.5 cm, Khóa Kéo DBVCS12",249000,249000,0,0
TIKI,balo-va-vali,45074506,"Túi Xách Du Lịch Hành Lý Cao Cấp Cỡ Lớn",179000,179000,0,0
TIKI,tui-thoi-trang-nam,115663661,"Ví nam AD04, bóp nam da thật, ví da nam ví đứng 18 ngăn đựng tiền đựng thẻ, chất",299000,419000,120000,29
TIKI,tui-thoi-trang-nam,131337754,"Túi đeo chéo phiên bản Hàn Quốc đeo chéo một vai đeo ngực, cưỡi ngựa leo núi ngoài trời",32670,44649,11979,27
TIKI,tui-thoi-trang-nam,68522324,"Cặp công sở đa năng TRITA TCA10 nhiều màu",359000,660000,301000,46
TIKI,voucher-dich-vu,243043191,"Voucher Tẩy Tế Bào Chết (Mặt) - Chang Nails",10000,16000,6000,38
TIKI,voucher-dich-vu,77661763,"Tài Liệu Marketing - Gói Standard - Bài Thi Vietnam Young Lions 2020 - Video Case - Hạng Mục Marketers- Chuẩn quốc tế - Học mọi nơi  - VYLVC11 - Khóa học online [Độc Quyền AIM ACADEMY]",150000,150000,0,0
TIKI,voucher-dich-vu,248636494,"Fusion Suites Hotel 4* Vũng Tàu - Buffet Sáng, Miễn Phí Spa, 09 Hồ Bơi Vô Cực, Gần Biển Bãi Trước, Nhiều Tiện Ích",2250000,2250000,0,0
TIKI,balo-va-vali,114431615,"Balo laptop thời trang nam nữ Sakos Frontier - Thương hiệu Sakos USA",547000,639000,92000,14
TIKI,voucher-dich-vu,55643091,"Khóa Học Tiếng Anh Giao Tiếp Với 100% Giaó Viên Bản Ngữ - Hawaii Education",12560000,12560000,0,0
TIKI,balo-va-vali,72226689,"Balo nữ combo 4 món đi học thời trang sinh viên học sinh ( không kèm túi rút)",84400,84400,0,0
TIKI,voucher-dich-vu,98823444,"Jeonbok - Phiếu Quà Tặng 50K",50000,50000,0,0
TIKI,tui-thoi-trang-nam,155330335,"Ví da nam, bóp da nam mini Bụi Leather V115 - Da bò Nappa cao cấp - Bảo hành 12 tháng",180000,278000,98000,35
TIKI,voucher-dich-vu,21775422,"Tick Edu - Bí Quyết Xây Dựng Mối Quan Hệ Trong Kinh Doanh",699000,699000,0,0
TIKI,balo-va-vali,187636738,"Balo Laptop 15.6 Inch Mr Vui 865 vải trượt nước, chống bám bụi - Hàng Chính Hãng",399000,475000,76000,16
TIKI,voucher-dich-vu,117029040,"Evoucher - VMonkey (Trọn đời, 1 năm) Phần mềm Học tiếng Việt theo Chương trình GDPT Mới cho trẻ Mầm non & Tiểu học",369000,369000,0,0
TIKI,tui-thoi-trang-nam,188997932,"Túi Đeo Chéo Nhiều Ngăn Chứa Cho Nam Nữ Cao Cấp Đi Chơi Chống Nước, Túi Đựng Điện Thoại Ipad, Túi Đeo Vai Thời Trang Sang Trọng Thời Thượng",135000,135000,0,0
TIKI,tui-thoi-trang-nam,56852299,"Ví Nam Da Bò 4U Dáng Đứng Thời Trang FB241",169000,190000,21000,11
TIKI,tui-thoi-trang-nam,71178009,"Túi Đeo Chéo Canvas Messenger Ipad Oxford Cao Cấp Màu Đen Có Dây Kéo Và Ngăn Phụ Trong Ngoài Thời Trang Cá Tính",89000,99000,10000,10
TIKI,voucher-dich-vu,77691294," Tài Liệu Marketing - Gói World Class - Bài Thi Young Spikes 2019 - 3 Hạng Mục Digital, Integrated, PR - Chuẩn quốc tế - Học mọi nơi - VYLWC32- Khóa học online - [Độc Quyền AIM ACADEMY]",500000,500000,0,0
TIKI,tui-thoi-trang-nam,250111755,"Túi Đeo Chéo Nam 4U Da Tổng Hợp Cao Cấp D267",149000,175000,26000,15
TIKI,voucher-dich-vu,213587555,"[E-Voucher] Gói học online theo môn - Lớp 4 (12 tháng) - Phần mềm học tập dành cho trẻ tiểu học",120000,120000,0,0
TIKI,voucher-dich-vu,105836073,"ELLY - Phiếu Quà Tặng 500.000đ",500000,500000,0,0
TIKI,voucher-dich-vu,174856854,"[E-BOOK] i-Learn Smart Start Special Edition 1 Kế hoạch giảng dạy",15000,15000,0,0
TIKI,voucher-dich-vu,19258022,"Combo Chăm Sóc Da Mụn Ở Vùng Mặt Và Trị Mụn Ở Vùng Lưng Tại Mẹ & Em Spa ",499000,499000,0,0
TIKI,voucher-dich-vu,160946427,"Sinh Trắc Vân Tay Gen Talents – Dịch Vụ Tư Vấn Sinh Trắc Vân Tay Gia Đình – Gói Phân Tích Demo – Tặng Sách Trở Về Từ Cõi Sáng",600000,600000,0,0
TIKI,voucher-dich-vu,55028888,"Gói Khám Tổng Quát Sức Khoẻ Răng Miệng ",350000,350000,0,0
TIKI,voucher-dich-vu,21775478,"Tick Edu - Kungfu Bán Hàng Triệu Đô",999000,999000,0,0
TIKI,tui-thoi-trang-nam,146618296,"Bóp Da Đựng Thẻ ATM Nhỏ Gọn, Chất Da Pull-Up Mềm Mại, Trẻ Trung - Cá Tính, Thiết Kế Hiện Đại, Nhiều Ngăn Tiện Dụng, Đựng Thẻ Ngân Hàng, Card Danh Thiếp, Căn Cước Công Dân, Hình Lưu Niệm, Dáng Đứng - Gập 2 - Hàng Chính Hãng SAIGIO",779000,799000,20000,3
TIKI,voucher-dich-vu,213587562,"[E-Voucher] Gói học online theo môn - Lớp 5 (12 tháng) - Phần mềm học tập dành cho trẻ tiểu học",120000,120000,0,0
TIKI,voucher-dich-vu,76693893,"PMX - Khóa học Quản trị dự án - Kỹ năng Quản lý - Agilearn | Giải pháp Đào tạo Số hàng đầu cho Doanh nghiệp tại Việt Nam",780000,780000,0,0
TIKI,balo-va-vali,20148150,"Bao da, túi da, cặp da chống sốc cho macbook, laptop chất da lộn kèm ví đựng phụ kiện - Xám - Macbook Air 13.3 inch đời 2017 về trước",332500,350000,17500,5
TIKI,voucher-dich-vu,122642436,"[E-BOOK] CYLET Practice Tests Pre A2 Flyers Sách mềm sách học sinh",15000,15000,0,0
TIKI,voucher-dich-vu,34324987,"Điều Trị Tủy Răng Sữa Tại Nha Khoa Moli",149000,149000,0,0
TIKI,voucher-dich-vu,127202600,"KHÓA HỌC HƯỚNG DẪN TỪNG BƯỚC TỪ VIẾT ĐẾN BÁN SẢN PHẨM THÔNG TIN",799000,799000,0,0
TIKI,voucher-dich-vu,141349351,"[KHÓA HỌC ONLINE TƯƠNG TÁC] Học Revit Architecture (Cơ Bản+Nâng Cao)-(Tương tác trực tiếp với giảng viên qua Zoom)",2450000,2450000,0,0
TIKI,voucher-dich-vu,21787118,"Tick Edu - Thai Giáo - Phát Triển Trí Tuệ Và Cảm Xúc Cho Con Từ Trong Bụng Mẹ",699000,699000,0,0
TIKI,voucher-dich-vu,204432567,"Tictop - Phần Mềm Quản Lý Công Việc phiên bản EFFICIENT / TICTOP-EFFICIENT",225000,225000,0,0
TIKI,voucher-dich-vu,77682749,"Tài Liệu Marketing - Gói World Class - Bài Thi Young Lions 2017 + 2018 + 2019 - Hạng Mục Digital, Marketers, Film & Integrated, PR - Chuẩn quốc tế - Học mọi nơi - VYLWC31- Khóa học online - [Độc Quyền AIM ACADEMY]",750000,750000,0,0
TIKI,voucher-dich-vu,162512656,"Phiếu Quà Tặng Ngân ĐÌnh Restaurant 100K",100000,100000,0,0
TIKI,voucher-dich-vu,159397242,"VOUCHER SỬA CHỮA HÀNG HIỆU CHUYÊN SÂU GIẢM 499.000VNĐ CHO ĐƠN HÀNG TỪ 2.500.000VNĐ",100000,100000,0,0
TIKI,voucher-dich-vu,262637801,"Evoucher - Phiếu Quà Tặng Matsuri Japanese Restaurant 1000K",1000000,1000000,0,0
TIKI,voucher-dich-vu,76693953,"Khóa học Hoàn thành mọi việc với Kanban - Kỹ năng Quản lý Cá nhân - Agilearn | Giải pháp Đào tạo Số hàng đầu cho Doanh nghiệp tại Việt Nam",690000,690000,0,0
TIKI,voucher-dich-vu,189179492,"Tư vấn, hỗ trợ đăng ký kinh doanh",5500000,5500000,0,0
TIKI,voucher-dich-vu,242222882,"[Bến Thành] Vũ - Trang - Thái Đinh - Indie Night - Bước qua mùa cô đơn",1000000,1000000,0,0
TIKI,voucher-dich-vu,117293137,"Khóa học Toán Tiếng Anh Hệ Cambridge: Stage 6 - Lớp 5 - [TOT.EDU.VN]",1999000,1999000,0,0
TIKI,tui-thoi-trang-nam,253171976,"Ví nam 100% da thật thông minh siêu mỏng thời trang cao cấp phong cách cá tính",351000,390000,39000,10
TIKI,voucher-dich-vu,205538845,"Vé Núi Thần Tài - Gói Tích Lộc (Vé Vào Cổng +Vui Chơi + Ăn Trưa)",340000,340000,0,0
TIKI,voucher-dich-vu,188621513,"[EVoucher Vietravel] Hà Nội - Sapa- Ninh Bình- Bái Đính- Hạ Long - Đảo Titốp - Yên Tử",11990000,11990000,0,0
TIKI,voucher-dich-vu,101826839,"Iseul Spa - Voucher Triệt Lông",299000,299000,0,0
TIKI,balo-va-vali,186207050,"Balo nữ thời trang công sở cao cấp phong cách mới",432000,479000,47000,10
TIKI,voucher-dich-vu,50068515,"Massage Giảm Mỡ Bụng - Giá Sốc Cho Mẹ Sau Sinh, Vòng 2 Quá Khổ",250000,250000,0,0
TIKI,voucher-dich-vu,120422809,"[E-BOOK] i-Learn Smart Start English for Science 1 Sách mềm sách học sinh",15000,15000,0,0
TIKI,voucher-dich-vu,248676307,"Bamboo Village Beach Resort & Spa 4* Mũi Né - Ngay Trung Tâm, Buffet Sáng, Hồ Bơi, Bãi Biển Riêng, Không Gian Xanh",3000000,3000000,0,0
TIKI,tui-thoi-trang-nam,193289594,"Túi Đeo Chéo Nam Nữ Cao Cấp Vải Nylon Nhiều Ngăn Chống Thấm Nước, Túi Đeo Vai Phong Cách Thời Trang Hàn Quốc, Túi Đựng Điện Thoại Đa Năng",130000,130000,0,0
TIKI,voucher-dich-vu,8158657,"Combo 1: Cắt + Uốn / Nhuộm + Phục Hồi Colagen Dành Cho Nam Tại Top Hair Salon",399000,399000,0,0
TIKI,tui-thoi-trang-nam,79691242,"Ví Thẻ Tín Dụng, Bóp Đựng Thẻ Tín Dụng, Bóp Hộp Kim Loại Đựng Thẻ Tín Dụng Tự Động, Ví Nam Denim Có Hộp Đựng Thẻ TOPEE VNH26",278000,278000,0,0
TIKI,voucher-dich-vu,204340607,"T9. TOUR BẮC ĐẢO KÉO CÁ LẶN NGẮM SAN HÔ 01 NGÀY LÀM NGƯ DÂN - PHÚ QUỐC",950000,950000,0,0
TIKI,tui-thoi-trang-nam,260811602,"Túi da cao cấp Macsim mã MSTH10",2600000,2600000,0,0
TIKI,voucher-dich-vu,141956188,"CHUỖI HỘI THẢO TIẾNG ANH ONLINE CHO NGƯỜI ĐI LÀM - TOÀN QUỐC",1998000,1998000,0,0
TIKI,voucher-dich-vu,68721020,"VietGrow Edu - Khóa Học Trực Tuyến Quản Lý Thời Gian - Giảng Viên Trần Bằng Việt [E-learning]",599000,599000,0,0
TIKI,voucher-dich-vu,68719297,"VietGrow Edu - Khóa Học Trực Tuyến Kỹ Năng Hợp Tác - Giảng Viên Phạm Hoàng Thái Dương [E-learning]",499000,499000,0,0
TIKI,tui-thoi-trang-nam,161954337,"Ví nam JOHZEON kiểu dáng hàn quốc nhiều ngăn có ngăn khoá kéo",72500,72500,0,0
TIKI,voucher-dich-vu,137250421,"[E-BOOK] New Amanda & Friends 3 Bộ tranh hình",15000,15000,0,0
TIKI,voucher-dich-vu,100931478,"Iseul Spa - Voucher Tái Sinh Da Kim Cương Đa Tầng ( Combo 2 lần )",1500000,1500000,0,0
TIKI,tui-thoi-trang-nam,116726545,"Túi Đeo Chéo Grepaco Nam Nữ Unisex Vải Bố Canvas Tote Chống Nước Dạng Dây Đeo Vai Xách Đa Năng Đựng Điện Thoại Tiền Đi Học Du Lịch Thể Thao Size Mini Phong Cách Thời Trang Hàn Quốc",92000,99000,7000,7
TIKI,tui-thoi-trang-nam,134040370,"Túi đeo chéo nam nữ thời trang BEE GEE 0127 để điện thoại ipad chống thấm nước đẹp chất lượng tốt",68000,138000,70000,51
TIKI,voucher-dich-vu,122868490,"[E-BOOK] i-Learn Smart World 8 File nghe Audio",10000,10000,0,0
TIKI,voucher-dich-vu,117569346,"Khóa học Cải thiện NÃO BỘ và NGỦ NGON bằng xoa bóp, bấm huyệt - VMC",600000,600000,0,0
TIKI,voucher-dich-vu,188846705,"Tour trọn gói 3N2Đ: Ninh Chữ  - Bình Lập [E-Voucher Siêu Sale]",4250000,4250000,0,0
TIKI,voucher-dich-vu,95044323,"Sách nói: OKRs - Hiểu Đúng, Làm Đúng - Cách Để Áp Dụng Thành Công OKRs Ngay Từ Đầu",99000,99000,0,0
TIKI,voucher-dich-vu,68856944,"VietGrow Edu - Khóa Học Thực Hành Kỹ Năng Lãnh Đạo - Giảng Viên Võ Thái Lâm [E-learning]",1980000,1980000,0,0
TIKI,voucher-dich-vu,160901190,"Sinh Trắc Vân Tay Gen Talents – Dịch Vụ Tư Vấn Sinh Trắc Vân Tay Gia Đình – Gói Phân Tích Demo – Tặng Sách Nhà Giả Kim",600000,600000,0,0
TIKI,voucher-dich-vu,252258349,"[Voucher 12 tháng] Bộ công cụ Học - Thi - Hướng nghiệp lớp 9, VitanEdu",600000,600000,0,0
TIKI,voucher-dich-vu,262651801,"Phú Quốc [E-Voucher] Tour 4 đảo Phú Quốc & Cáp treo Hòn Thơm -  CÀNG MUA CÀNG GIẢM",860000,860000,0,0
TIKI,voucher-dich-vu,129947401,"[APP] i-Learn Smart Start Level 4 - Ứng dụng phần mềm tương tác sách học sinh",25000,25000,0,0
TIKI,voucher-dich-vu,249931074,"Bánh đồng tiền mix hạt Bảo An",85000,85000,0,0
TIKI,voucher-dich-vu,179952300,"[Giftpop] Phiếu Quà Tặng TOUS les JOURS 200K",200000,200000,0,0
TIKI,voucher-dich-vu,140170384,"[KHÓA HỌC ONLINE TƯƠNG TÁC] Khóa Học Navisworks Manage-Đại học Xây Dựng (Tương tác trực tiếp với giảng viên qua Zoom)",1000000,1000000,0,0
TIKI,voucher-dich-vu,272072269,"[E-Voucher] KHÁM PHÁ HÒA PHÚ THÀNH - ĐÀ NẴNG",799000,799000,0,0
TIKI,voucher-dich-vu,206677711,"Sách nói: Bản Ngã - Thấu Hiểu Và Tan Biến",99000,99000,0,0
TIKI,voucher-dich-vu,20102345,"M Fitnsee Club - Trải Nghiệm 01 Buổi Bơi Chuẩn 5 Sao Không Giới Hạn Thời Gian Bơi",195000,195000,0,0
TIKI,tui-thoi-trang-nam,127553838,"Túi đeo chéo Basic chống nước, tích hợp dây sạc USB unisex nam nữ phong cách thời trang",125000,250000,125000,50
TIKI,voucher-dich-vu,72724970,"NHA TRANG - Tour đi bộ dưới đáy biển 1 ngày, có ăn trưa",1150000,1150000,0,0
TIKI,voucher-dich-vu,188700999,"[EVoucher Vietravel] Combo 4N3Đ KS The Light Hà Nội 4 Sao: VMB khứ hồi Hồ Chí Minh - Hà Nội + Phòng Tiêu Chuẩn + Ăn sáng",3690000,3690000,0,0
TIKI,voucher-dich-vu,91545630,"Chữ ký số  FAST-CA gói 01 năm tặng 1 năm",1435000,1435000,0,0
TIKI,voucher-dich-vu,112694411,"Quà Tặng Sách Nói: Hành Trình Về Phương Đông - Kèm Dịch Vụ Sinh Trắc Vân Tay – Phân Tích Tính Cách Hành Vi Cơ Bản",40000,40000,0,0
TIKI,voucher-dich-vu,141953827," TUYỆT KỸ GIAO TIẾP TIẾNG ANH CÔNG SỞ - ELEVATOR SPEECH",98000,98000,0,0
TIKI,voucher-dich-vu,246856239,"[E-Voucher] Sách nói Fonos: Quản Lý Nhân Sự Trong Thời Đại Số",99000,99000,0,0
TIKI,tui-thoi-trang-nam,130439350,"Ví nam mini AD08, bóp nam nhỏ gọn, ví da nam thủ công làm từ da bò  nguyên tấm, bóp da dáng ngang siêu đẹp nhiều ngăn tiện lợi",179000,279000,100000,36
TIKI,voucher-dich-vu,72210877,"KHÓA HỌC HCM - KHUNG NĂNG LỰC - NÂNG CAO",9999000,9999000,0,0
TIKI,balo-va-vali,11732082,"Balo Thời Trang Du Lịch Dã Ngoại 10L TNTT0255 (40 x 23 x 10cm)",48510,66297,17787,27
TIKI,balo-va-vali,143915339,"Balo nữ đi học thời trang Ulzzang Hàn Quốc, cặp sách đẹp hàng cao cấp dễ thương, túi xách sinh viên học sinh chống nước",159000,159000,0,0
TIKI,balo-va-vali,146988921,"Túi Chống Sốc Wiwu Pilot Laptop Sleeve 13.3 Inch Dành Cho Laptop, Ultrabook Chất Liệu Vải Sợi Cao Cấp - Hàng Chính Hãng",450000,450000,0,0
TIKI,balo-va-vali,159439100,"Balo da nam công sở đựng laptop LATA BAL48",690000,690000,0,0
TIKI,balo-va-vali,197649776,"túi xách du lịch thể thao nam kiêm balo du lịch cao cấp phong cách mới(15,6")",1215000,1350000,135000,10
TIKI,balo-va-vali,179980786,"Túi chống va đập chính hãng TOMTOC (USA) Portfolio Holder Hardshell cho iPad Pro/Tablet/Notebook",981000,1090000,109000,10
TIKI,balo-va-vali,34240189,"Balo laptop 15.6 inch Mikkor Kalino Backpack Navy",649000,649000,0,0
TIKI,balo-va-vali,177920273,"Ba lô nam da tự nhiên cao cấp phong cách mới",441000,490000,49000,10
TIKI,balo-va-vali,157254142,"Balo SAIGON SWAGGER Core Backpack-Ngăn Chống Sốc Lap 16inch",570000,570000,0,0
TIKI,balo-va-vali,192850601,"Balo nữ B1034 NASI balo mini vải cói cao cấp mẫu mới thời trang ba lô nữ nhỏ xinh xắn đi chơi đi học phong cách hàn quốc",129000,129000,0,0
TIKI,balo-va-vali,63476140,"Bao da, túi da, cặp da chống sốc cho macbook, laptop chất da lộn kèm ví đựng phụ kiện",332500,350000,17500,5
TIKI,balo-va-vali,111868942,"Balo du lịch Arctic Hunter chất liệu Oxford chống nước, có cổng USB - B00120",465000,720000,255000,35
TIKI,balo-va-vali,171788019,"Vali du lịch kéo Kingsun cao cấp Size 24inch KS-033 - Bạc",538000,738000,200000,27
TIKI,balo-va-vali,7098971,"Balo Nam Thời Trang Dạ Quang Ohazo! Tặng Cáp Sạc USB + Khóa Số Chống Trộm",179000,179000,0,0
TIKI,balo-va-vali,19741042,"Balo Laptop Du Lịch Thời Trang Cao Cấp SAKOS ZEN Dành Cho Laptop 14 Inch (14")",979000,979000,0,0
TIKI,balo-va-vali,188427849,"Balo nữ thời trang cao cấp phong cách mới",423000,470000,47000,10
TIKI,balo-va-vali,104838748,"Balo Targus Urban Essential Backpack - Black (TBB594GL-70)",1200000,1200000,0,0
TIKI,balo-va-vali,174632433,"Balo đựng Laptop 15.6 inch thương hiệu TARGUS dòng Safire Backpack cao cấp",590000,590000,0,0
TIKI,balo-va-vali,120114684,"VALI SIZE 28 DÁNG HỘP MẪU MỚI NHẤT",1200000,1200000,0,0
TIKI,balo-va-vali,165191259,"TÚI KÉO KIÊM VALI KÉO DU LỊCH THỜI TRANG TIỆN DỤNG",469000,469000,0,0
TIKI,balo-va-vali,212987321,"Túi du lịch có ngăn gài vali, túi xách du lịch Polyeste cao cấp chống nước, có ngăn để giày riêng biệt, túi đựng đồ tập gym chuyên dụng",147000,185000,38000,21
TIKI,balo-va-vali,22815594,"TÚI XÁCH DA ĐỰNG LAPTOP, CẶP XÁCH DA LAPTOP, TÚI ĐEO CHỐNG SỐC CHO MACBOOK, LAPTOP, SURFACE CHỐNG NƯỚC TUYỆT ĐỐI",418000,440000,22000,5
TIKI,balo-va-vali,147943281,"Balo Nữ Mini Thời Trang FORVER YOUNG Da Mềm Nhiều Ngăn Tiện Dụng FY04 - Tukado",239000,239000,0,0
TIKI,balo-va-vali,32979946,"Vali Rover One - Xanh Đại Dương - 20"",1429000,1429000,0,0
TIKI,balo-va-vali,249875935,"Balo du lịch đa chức năng hàng siêu cao cấp phong cách cá tính mới",1530000,1700000,170000,10
TIKI,balo-va-vali,168352716,"Túi Chống Sốc Đựng Laptop & Macbook 13inch Chống Thấm Nước",468000,468000,0,0
TIKI,balo-va-vali,195569938,"Quai xách, tay cầm vali 19.7cm, đã bao gồm ốc vít, vali lock&lock, Kakashi, Lojel, American Tourister, sakos, samsonite, Delsey, lusetti",50000,50000,0,0
TIKI,balo-va-vali,248544248,"Balo du lịch vải chống thấm phượt/ leo núi/ trekking dung tích lớn 70l - T0366",399000,399000,0,0
TIKI,balo-va-vali,35042297,"Áo trùm vali TRIP Vải không dệt màu đen",100000,100000,0,0
TIKI,balo-va-vali,34456608,"Balo Laptop Du Lịch Thời Trang Cao Cấp SAKOS MAXIM Dành Cho Laptop 15.6 Inch (15.6")",4340000,4770000,430000,9
TIKI,balo-va-vali,188407179,"Túi xách du lịch thể thao nam cao cấp phong cách mới",405000,450000,45000,10
TIKI,balo-va-vali,168358938,"CẶP DA CÔNG SỞ ĐỰNG LAPTOP CAO CẤP 9902-3",630000,630000,0,0
TIKI,balo-va-vali,121330153,"Combo Bộ 10 khóa nhựa cao cấp dây đai 25 mm cố định túi đựng hành lí và balo túi xách",10000,10000,0,0
TIKI,balo-va-vali,166033942,"Balo nam nữ cỡ lớn, balo đựng laptop",449000,576000,127000,22
TIKI,balo-va-vali,31614331," Túi đựng mỹ phẩm du lịch Hàn Quốc có móc treo",25000,25000,0,0
TIKI,balo-va-vali,20554999,"Cặp xách Laptop 15.6 inch chống sốc cao cấp",349000,349000,0,0
TIKI,balo-va-vali,58374882,"Vali Kéo Vải Du Lịch SAKOS NEO PILOTTE 5 - Size S (20inch)/ Xách Tay (Cabin) - Khóa TSA - Chống Thấm, Trượt Nước",4299000,4800000,501000,10
TIKI,balo-va-vali,21307965,"BAO DA, TÚI DA, CẶP DA CHỐNG SỐC CHO MACBOOK, LAPTOP, SURFACE KÈM VÍ ĐỰNG PHỤ KIỆN",332500,350000,17500,5
TIKI,balo-va-vali,11222808,"Túi Đựng Laptop Trang Cao Cấp G8046",250000,250000,0,0
TIKI,balo-va-vali,171438572,"Túi Đựng Giày Cao Cấp, Túi Du Lịch Hàn Quốc, chống thấm ngăn mùi, xếp gọn đa năng trong vali túi Bag in Bag",79000,79000,0,0
TIKI,tui-vi-nu,160314695,"Ví Nữ Dài Cầm Tay Chính Hãng TAILIAN Thời Trang Đựng Tiền Da Cao Cấp Cực Đẹp Giá Rẻ TL08 - Micocah Mall",119000,119000,0,0
TIKI,tui-vi-nu,96312905,"Túi Xách Nữ Đẹp Đeo Vai Form Lớn Đan Len Đi Học & Công Sở Phong Cách Thời Trang Âu Mỹ - Mã XT013",175000,175000,0,0
TIKI,tui-vi-nu,77200181,"[VOUCHER 30K] Ví cầm tay nữ thời trang LATA VN51",269000,350000,81000,23
TIKI,tui-vi-nu,108254287,"Ví Dài Nam Nữ, Ví Cầm Tay Da mềm Cao Cấp",190000,190000,0,0
TIKI,tui-vi-nu,67211257,"Túi đeo chéo nữ để điện thoại TCHE1 phong cách trẻ trung, năng động tặng kèm 2 nút bảo vệ đầu sạc điện thoại",58410,79827,21417,27
TIKI,tui-vi-nu,71930976,"Túi đeo chéo/Túi bao tử nữ thời trang cao cấp, thiết kế độc, lạ, cá tính hot trend 2020-2021",85000,85000,0,0
TIKI,tui-vi-nu,184071608,"Túi xách nữ 1992 s t u d i o / LILY BAG /  màu đen kẹp nách",199000,199000,0,0
TIKI,tui-vi-nu,209414471,"Túi đựng điện thoại kiêm ví đeo chéo hoa cúc TXNHC149",142000,142000,0,0
TIKI,tui-vi-nu,112049090,"Túi đeo chéo thời trang nữ mini đi chơi dự tiệc cao cấp, Túi xách nữ đẹp HT21",55000,55000,0,0
TIKI,tui-vi-nu,186204178,"Túi Xách Nữ Thời Trang Cao Cấp Elly EL128",979300,1399000,419700,30
TIKI,tui-vi-nu,73613463,"Túi Vải Đeo Chéo Gấu Bông Hàn Quốc",31680,43296,11616,27
TIKI,tui-vi-nu,180720785,"Túi Xách Thời Trang Nữ Da Thật Cao Cấp Gence TX09",1600000,1600000,0,0
TIKI,tui-vi-nu,147942526,"Túi Xách Nữ Đeo Chéo MICOCAH Dáng Công Sở Thời Trang Vân Quả Trám Sang Trọng Thanh Lịch Da Cao Cấp Cực Đẹp MC61 - Tukado",429000,429000,0,0
TIKI,tui-vi-nu,160314132,"Ví Nữ Dài Cầm Tay Chính Hãng FOREVER YOUNG Thanh Lịch Sang Trọng Nhiều Ngăn Tiện Dụng FY10 - Micocah Mall",159000,159000,0,0
TIKI,tui-vi-nu,52758151,"Túi TOTE Thiết Kế Thời Trang Hàn Quốc",89000,89000,0,0
TIKI,tui-vi-nu,79411724,"Túi đeo đựng điện thoại thời trang - màu ngẫu nhiên ( tặng móc khoa đa năng )",34155,46678,12523,27
TIKI,tui-vi-nu,157253905,"Móc Khóa Dọc In Báo SAIGON SWAGGER Journal Card Keychain",150000,150000,0,0
TIKI,tui-vi-nu,152015159,"Túi Tote Túi Vải Canvas",99000,99000,0,0
TIKI,tui-vi-nu,168794802,"1kg Túi PA hút chân không 10zem/15zem 2 mặt trơn",78000,78000,0,0
TIKI,tui-vi-nu,52658437,"Túi xách đeo vai nữ combo 2 thời trang KDR20",89100,121770,32670,27
TIKI,tui-vi-nu,32860122,"Túi Đeo Chéo Thời Trang Họa Tiết Sọc",271000,271000,0,0
TIKI,tui-vi-nu,51288506,"Túi xách nữ công sở bản to",245000,245000,0,0
TIKI,tui-vi-nu,199520547,"Túi xách nữ silicon lụa phong cách Hàn Quốc",149000,149000,0,0
TIKI,tui-vi-nu,186636029,"Túi Cói, Túi Xách Cỏ Bàng Vẽ Hoa Mỹ Nghệ Cao Cấp, Chuẩn Đẹp-TXCBVHGLTK05",329000,329000,0,0
TIKI,tui-vi-nu,54029584,"Ví cầm tay nữ 2 ngăn kéo sang trọng , thiết kế nhiều ngăn tiện dụng TK0048",76000,100000,24000,24
TIKI,tui-vi-nu,90432070," TÚI CÓI ĐI BIỂN MERCI SANG CHẢNH PHONG CÁCH HÀN QUỐC",39971,39971,0,0
TIKI,tui-vi-nu,252721792,"Túi Clutch dự tiệc sang chảnh quý phái tôn dáng nổi bật VDT02",250000,250000,0,0
TIKI,tui-vi-nu,165627374,"Túi đeo chéo nữ mini đựng điện thoại phong cách Hàn Quốc",99000,99000,0,0
TIKI,voucher-dich-vu,214893546,"Gói học Speech Analyzer thời hạn 3 tháng từ ELSA SPEAK - Công cụ luyện nói tiếng Anh toàn diện ",660000,660000,0,0
TIKI,tui-vi-nu,174518731,"Ví đựng hộ chiếu Passport giấy tờ xe, thẻ thời trang chất liệu da bò cao cấp 40596",150000,150000,0,0
TIKI,tui-vi-nu,31711116,"Túi đeo chéo đựng điện thoại thời trang + tặng vòng đeo tay",90000,90000,0,0
TIKI,voucher-dich-vu,1559415,"Phiếu Quà Tặng 100.000đ",100000,100000,0,0
TIKI,voucher-dich-vu,1559589,"Phiếu Quà Tặng 1.000.000đ",1000000,1000000,0,0
TIKI,voucher-dich-vu,1559585,"Phiếu Quà Tặng 500.000đ",500000,500000,0,0
TIKI,tui-vi-nu,106867104,"Combo Túi Đựng Thẻ Trong Suốt Nhựa Dẻo Đa Năng",13860,18942,5082,27
TIKI,tui-vi-nu,177579514,"Ví nữ dài cầm tay chính hãng TAILIAN thời trang đựng tiền da cao cấp nhiều ngăn tiện dụng TL39",139000,139000,0,0
TIKI,tui-vi-nu,209414547,"Ví nữ dài cầm tay hai ngăn phối màu VND100 tam thể hai khóa",112000,112000,0,0
TIKI,voucher-dich-vu,1559593,"Phiếu Quà Tặng 2.000.000đ",2000000,2000000,0,0
TIKI,tui-vi-nu,248990332,"Dây kéo 2 chiều răng 5 (không kèm đầu khóa)",62000,62000,0,0
TIKI,voucher-dich-vu,273818359,"Bảo hiểm du lịch toàn cầu MIC, chuyến đi từ 1 - 3 ngày, gói Thượng hạng",102200,146000,43800,30
TIKI,tui-vi-nu,176681270,"Túi xách nữ bản to _ Túi nữ thời trang công sở đựng vừa A4",125000,125000,0,0
TIKI,voucher-dich-vu,214620199,"Gói học Speech Analyzer thời hạn 1 tháng từ ELSA SPEAK - Công cụ luyện nói tiếng Anh toàn diện",320000,320000,0,0
TIKI,voucher-dich-vu,24382188,"Phiếu Quà Tặng 4.000.000đ",4000000,4000000,0,0
TIKI,voucher-dich-vu,272744625,"Bảo hiểm TNDS xe ô tô 7 chỗ ngồi, không kinh doanh, giấy chứng nhận điện tử - Bảo hiểm Quân đội MIC",873400,873400,0,0
TIKI,voucher-dich-vu,1559601,"Phiếu Quà Tặng 5.000.000đ",5000000,5000000,0,0
TIKI,voucher-dich-vu,2648565,"Phiếu Quà Tặng 3.000.000đ",3000000,3000000,0,0
TIKI,tui-vi-nu,194414981,"Túi Xách Lục Bình Thêu Hoa Sang Trọng Chuẩn Đẹp, Giỏ Cói Đi Biển, Túi Du Lịch TXLBTHDSLLTK02",419000,419000,0,0
TIKI,voucher-dich-vu,273737742,"Bảo hiểm Du lịch toàn cầu MIC, chuyến đi 16 - 18 ngày, gói Thượng hạng",315700,451000,135300,30
TIKI,voucher-dich-vu,273818656,"Bảo hiểm du lịch toàn cầu MIC, chuyến đi từ 28 - 31 ngày, gói Thượng hạng",436800,624000,187200,30
TIKI,tui-vi-nu,151901545,"Túi Tote Vải Canvas Nữ Có Khóa Ulzzang Hot Trend Kita Unisex - Mẫu MÈO CUTE - Ảnh thật",69000,69000,0,0
TIKI,tui-vi-nu,195511701,"MLB - Túi bucket đeo chéo Basic Big Logo 3ABMS072N",3290000,3290000,0,0
TIKI,voucher-dich-vu,273818490,"Bảo hiểm du lịch toàn cầu MIC, chuyến đi từ 19 - 22 ngày, gói Thượng hạng",362600,518000,155400,30
TIKI,voucher-dich-vu,1559581,"Phiếu Quà Tặng 200.000đ",200000,200000,0,0
TIKI,voucher-dich-vu,202763559,"Lấy Cao Răng (Cạo vôi răng) Và Đánh Bóng Công Nghệ Siêu Âm Mới - Nha khoa BeDental (5 chi nhánh)",99000,99000,0,0
TIKI,voucher-dich-vu,7321979,"Phiếu Quà Tặng 300.000đ",300000,300000,0,0
TIKI,tui-vi-nu,174468742,"Ví Nữ Ngắn Mini Cầm Tay TAILIAN Dáng Gập Nhỏ Gọn Nhiều Ngăn Tiện Dụng Da Đẹp Giá Rẻ TL01",99000,99000,0,0
TIKI,voucher-dich-vu,214893569,"Gói học Speech Analyzer thời hạn 1 năm từ ELSA SPEAK - Công cụ luyện nói tiếng Anh toàn diện ",1720000,1720000,0,0
TIKI,voucher-dich-vu,973036,"Khóa Học Online Luyện TOEIC 450+ (Cho Người Mất Gốc)",299000,299000,0,0
TIKI,voucher-dich-vu,24376736,"Phiếu Quà Tặng 1.500.000đ",1500000,1500000,0,0
TIKI,voucher-dich-vu,273818388,"Bảo hiểm du lịch toàn cầu MIC, chuyến đi từ 4 - 6 ngày, gói Thượng hạng",128800,184000,55200,30
TIKI,voucher-dich-vu,273818595,"Bảo hiểm du lịch toàn cầu MIC, chuyến đi từ 23 - 27 ngày, gói Thượng hạng",396200,566000,169800,30
TIKI,voucher-dich-vu,244183622,"[3 tháng] Voiz FM - Voucher nghe Sách Nói",239000,249000,10000,4
TIKI,voucher-dich-vu,80617753,"Gói Hội viên Ứng dụng sách nói Fonos: Gói 1 tháng",99000,99000,0,0
TIKI,voucher-dich-vu,196288504,"Toàn Quốc [E- Voucher] 1 Vé Vui chơi cho bé tại tại Playtime trên Toàn Quốc - Áp dụng các ngày kể cả Lễ không phụ thu",109000,109000,0,0
TIKI,voucher-dich-vu,17929617,"Voucher Gói Học ELSA Pro Trọn Đời Từ ELSA SPEAK - Học phát âm tiếng Anh chuẩn bản xứ",1845000,1845000,0,0
TIKI,voucher-dich-vu,179786211,"[EVoucher Vietravel] Thái Lan: Pattaya - Bangkok (Thành cổ Muang Boran, tặng Show Colosseum và Buffet tại BaiYoke Sky)",7990000,7990000,0,0
TIKI,voucher-dich-vu,2145217,"Voucher Buffet Chay Buổi Trưa tại Bông Sen Hotel Nhà Hàng Cỏ Nội với Hơn 40 Món Ăn Đặc Sắc",189000,189000,0,0
TIKI,voucher-dich-vu,116881979,"Monkey Junior (Trọn đời, 4 năm, 2 năm,1 năm) - Phần mềm tiếng Anh và đa ngôn ngữ",499000,499000,0,0
TIKI,voucher-dich-vu,1559411,"Phiếu Quà Tặng 50.000đ",50000,50000,0,0
TIKI,tui-vi-nu,31622709,"Túi đeo chéo 2 ngăn đựng điện thoại",150000,150000,0,0
TIKI,voucher-dich-vu,173761446,"Phát âm tiếng Anh chuẩn bản xứ cùng ELSA SPEAK - Gói học ELSA Pro thời hạn 1 tháng",145000,145000,0,0
TIKI,voucher-dich-vu,167141168,"[APP] Ứng dụng Từ điển EVLD",139000,139000,0,0
TIKI,voucher-dich-vu,17929217,"Phát âm tiếng Anh chuẩn bản xứ cùng ELSA SPEAK - Gói học ELSA Pro thời hạn 1 năm",985000,985000,0,0
TIKI,voucher-dich-vu,129734215,"[E-BOOK] Achievers Grade 6 Sách mềm sách học sinh",15000,15000,0,0
TIKI,voucher-dich-vu,117033031,"Voucher Gói Học ELSA Pro 3 tháng từ ELSA SPEAK - Phần mềm học nói tiếng Anh chuẩn bản xứ",329000,329000,0,0
TIKI,voucher-dich-vu,7322123,"Phiếu Quà Tặng 10.000.000đ",10000000,10000000,0,0
TIKI,voucher-dich-vu,273538721,"Bảo hiểm TNDS xe ô tô kèm BH tự nguyện cho người ngồi trên xe - Bảo hiểm Quân đội MIC",730700,730700,0,0
TIKI,voucher-dich-vu,80901684,"Gói Hội viên Ứng dụng sách nói Fonos: Gói 1 năm ",899000,899000,0,0
TIKI,voucher-dich-vu,9817034,"Voucher Dịch Vụ Cạo Vôi, Đánh Bóng Răng - Nha Khoa Hạnh Nguyên",100000,100000,0,0
TIKI,voucher-dich-vu,10806109,"Voucher Liệu Trình 75 Phút Massage Body Đá Nóng Thải Độc (Bao Gồm Xông Hơi) tại Rita Homespa",149000,149000,0,0
TIKI,voucher-dich-vu,152568784,"Sách nói: Việt Nam Sử Lược",99000,99000,0,0
TIKI,voucher-dich-vu,135043785,"Voucher Golf Valley Hotel 4* Đà Lạt - Gần Chợ & Hồ Xuân Hương, Gồm Buffet Sáng, Khách Sạn Vị Trí Thuận Tiện",1499000,1499000,0,0
TIKI,voucher-dich-vu,129734261,"[E-BOOK] Achievers Grade 6 Sách mềm sách bài tập",15000,15000,0,0
TIKI,voucher-dich-vu,7816222,"Voucher 14 Bước Trắng Sáng Da, Sạch Mụn, Mịn Màng Điều Trị Mụn Cao Cấp (90 Phút) Tại Ellis Spa",149000,149000,0,0
TIKI,voucher-dich-vu,273720644,"Bảo hiểm du lịch toàn cầu MIC, chuyến đi 7 - 10 ngày, gói Thượng hạng",170800,244000,73200,30
TIKI,voucher-dich-vu,191378552,"Gói Hội viên Ứng dụng sách nói Fonos: Gói Quý (3 tháng)",249000,249000,0,0
TIKI,voucher-dich-vu,7322047,"Phiếu Quà Tặng 400.000đ",400000,400000,0,0
TIKI,voucher-dich-vu,81084052,"CODE THI THỬ GMETRIX MOS- tinhocmos",250000,290000,40000,14
TIKI,voucher-dich-vu,59321599,"Gói đọc sách điện tử Waka 03 tháng",150000,150000,0,0
TIKI,voucher-dich-vu,3234697,"Voucher Buffet Trưa Tại Nhà Hàng Gánh Bông Sen - Độc Đáo Hương Vị Ba Miền",249000,249000,0,0
TIKI,voucher-dich-vu,17929617,"Voucher Gói Học ELSA Pro Trọn Đời Từ ELSA SPEAK - Học phát âm tiếng Anh chuẩn bản xứ",1845000,1845000,0,0
TIKI,voucher-dich-vu,9672465,"Phiếu Quà Tặng 800.000đ",800000,800000,0,0
TIKI,voucher-dich-vu,272036817,"Tour Tà Đùng 3N2Đ Caravan Buôn Ma Thuộc",3960000,3960000,0,0
TIKI,voucher-dich-vu,76359037,"Hoàng Yến - Phiếu Quà Tặng 100K",100000,100000,0,0
TIKI,voucher-dich-vu,7230533,"Voucher Spa Làm Đẹp tại Chuẩn Massage - Massage Body Tổng Hợp 75 Phút",280000,280000,0,0
TIKI,dong-ho-va-trang-suc,73835897,"Đồng Hồ Nữ Julius JA-787 Hàn Quốc Dây Thép",690000,690000,0,0
TIKI,dong-ho-va-trang-suc,198128122,"Nhẫn Bạc Nữ, Nhẫn Bạc Nữ Đính Đá Hoa Pha Lê Xanh Tinh Tế - N2395 - Bảo Ngọc Jewelry",360000,360000,0,0
TIKI,dong-ho-va-trang-suc,66609998,"Đồng hồ Casio Nam G Shock GMW-B5000CS-1DR",26299000,26299000,0,0
TIKI,dong-ho-va-trang-suc,13948044,"Mặt Dây Chuyền Hư Không Tạng Bồ Tát Đá Mắt Hổ",150000,150000,0,0
TIKI,dong-ho-va-trang-suc,51284951,"Đồng hồ HALEI Thời Trang Nam Mặt Vuông Có Lịch Số La Mã",299000,315000,16000,5
TIKI,dong-ho-va-trang-suc,142144708,"ĐỒNG HỒ ĐEO TAY THÔNG MINH ĐO NHỊP TIM BƯỚC CHÂN VẬN ĐỘNG THỂ THAO TIỆN DỤNG HÀNG CAO CẤP",228000,228000,0,0
TIKI,dong-ho-va-trang-suc,47028347,"Đồng hồ nữ Hàn Quốc DOU3407 - Tặng vòng đeo tay Titan",259000,259000,0,0
TIKI,dong-ho-va-trang-suc,54630782,"Vòng đeo tay Vintage, Handmade, Ngũ sắc Nữ, dây vải Canvas, đính Pha lê màu",29000,33000,4000,12
TIKI,dong-ho-va-trang-suc,144368438,"(1 Chiếc) NHẪN ĐÔI TÌNH NHÂN INOX I LOVE YOU",21850,21850,0,0
TIKI,dong-ho-va-trang-suc,32215374,"nhẫn nam Quân Đội Mỹ - không đen -không rỷ-mặt đá tự nhiên",789999,789999,0,0
TIKI,dong-ho-va-trang-suc,20708322,"Vòng Tay Phong Thủy Nam Đá Mắt Hổ Xanh Đen Phối Charm Tỳ Hưu Bạc (10mm) Mệnh Thủy, Mộc Ngọc Quý Gemstones",639000,912000,273000,30
TIKI,dong-ho-va-trang-suc,178029683,"(Dây nâu) Dây da đồng hồ nam nữ DA BÒ THẬT MỊN 4 lớp, siêu mềm KHÓA CÀI thép không gỉ 316L",49000,49000,0,0
TIKI,dong-ho-va-trang-suc,55101774,"Bông Tai Nữ | Bông Tai Nữ Bạc S925 Trái Tim Yêu Thương B2526 - Bảo Ngọc Jewelry",215000,215000,0,0
TIKI,dong-ho-va-trang-suc,96598009,"Bông Tai Nam Châm Đính Đá Ko Cần Bấm Lỗ Tai Titan Ko Đen TT 3382 - 1 Cặp",50000,50000,0,0
TIKI,dong-ho-va-trang-suc,73822408,"Bông tai hoa sát tai ngọc trai đính đá",89000,89000,0,0
TIKI,dong-ho-va-trang-suc,32141864,"Vòng tay phong thủy đá obsidian mệnh thủy , kim - Ngọc Quý Gemstones",200000,390000,190000,49
TIKI,dong-ho-va-trang-suc,140318013,"Dây chuyền Thiên Tâm đài sen may mắn (trắng) MDC177T",129000,129000,0,0
TIKI,dong-ho-va-trang-suc,151548636,"Vòng Tam Hợp Hợi Mão Mùi Gỗ Huyết Long - Vòng Tay Phong Thủy Huyết Rồng - May Mắn Tài Lộc - Size 10 12ly",219000,219000,0,0
TIKI,dong-ho-va-trang-suc,155289032,"Vòng Cổ Bạc Nữ Vầng Trăng Đá Hồng, Vòng Cổ Bạc S925 ( KHÔNG RỈ - BẠC THẬT) - DB2637 - Bảo Ngọc Jewelry",285000,285000,0,0
TIKI,dong-ho-va-trang-suc,114050213,"Đồng hồ cặp đôi nam nữ Halei kim xanh mặt trắng dây da nâu chính hãng Tony Watch 68",236550,249000,12450,5
TIKI,dong-ho-va-trang-suc,66236490,"Đồng hồ Casio Nam G Shock GST-B100B-1A4DR",12695000,12695000,0,0
TIKI,dong-ho-va-trang-suc,50200888,"Vòng Lắc Tay Nam Rồng Mạ Vàng 18K Cao Cấp + TẶNG LÁ BỒ ĐỀ MAY MẮN TÀI LỘC ĐỂ VÍ ĐIỆN THOẠI",285000,285000,0,0
TIKI,dong-ho-va-trang-suc,49008665,"DÂY CHUYỀN BẠC MẶT HOA VÒM TRÒN ĐÍNH ĐÁ",89000,89000,0,0
TIKI,dong-ho-va-trang-suc,91440691,"Đồng Hồ Nữ Casio Standard LTP-V007D-7BUDF Chính Hãng | Casio Standar LTP-V007D-7B Dây Thép",738750,985000,246250,25
TIKI,dong-ho-va-trang-suc,50387285,"Dây Chuyền Vòng Cổ Nam Rồng Vàng Cực Chất + TẶNG LÁ BỒ ĐỀ MAY MẮN TÀI LỘC ĐỂ VÍ ĐIỆN THOẠI",299000,315000,16000,5
TIKI,dong-ho-va-trang-suc,10850990,"Nhẫn nữ Pannmila : bạc thật - đính kim cương pha lê Nano Ý",130000,130000,0,0
TIKI,dong-ho-va-trang-suc,93659737,"Dây Chuyền Tropicana Phối Charm Swarovski Pha Lê Sao Biển 2 Màu",565000,565000,0,0
TIKI,dong-ho-va-trang-suc,21370995,"VÒNG ĐIỀU HÒA HUYẾT ÁP NHẬT BẢN - ND35",316000,355000,39000,11
TIKI,dong-ho-va-trang-suc,93608985,"Mặt dây chuyền hoa sen phong thủy đá ngọc cẩm thạch",250000,250000,0,0
TIKI,dong-ho-va-trang-suc,159298167,"Dây Đồng Hồ Da Bò Cao Cấp, Kiểu Dáng Cổ Điển - Chỉ Trắng, Mặt Lót Chống Thấm Mồ Hôi, Tích Hợp Lớp Gia Cố Chống Giãn Đặc Biệt, Phụ Kiện Khóa và Chốt Bằng Thép Không Gỉ 316L - Hàng Chính Hãng SAIGIO",983000,989000,6000,1
TIKI,dong-ho-va-trang-suc,174182001,"Vòng (Lắc) Tay Ngọc Trai Thật Cao Cấp Ngọc Trai CN2",500000,500000,0,0
TIKI,dong-ho-va-trang-suc,52578213,"Bông tai nữ chạm mạ 18k cao cấp E920",65000,65000,0,0
TIKI,dong-ho-va-trang-suc,8061505,"Đồng Hồ Nam Citizen Dây Thép Không Gỉ NH8350-59L - Mặt Xanh",5785000,5785000,0,0
TIKI,dong-ho-va-trang-suc,129453808,"Nhẫn xoàn, đính đá Zircon, Kiểu dáng Ruby, Phong cách Âu Mỹ, Chất liệu Hợp kim tráng Platin Mẫu Luxi Green M002, Kèm túi đựng Cung Hỷ chất liệu Nhung gấm",185000,208000,23000,11
TIKI,dong-ho-va-trang-suc,69687567,"Dây Chuyền Nam Bạc Hiểu Minh DBN057 Bạc Ta 10 chỉ",1250000,1300000,50000,4
TIKI,dong-ho-va-trang-suc,73574817,"Khuyên Tai Ngọc Trai Cao Cấp B2548 - Bảo Ngọc Jewelry",414000,414000,0,0
TIKI,dong-ho-va-trang-suc,134628062,"Đồng hồ nam dây nhựa Casio Standard chính hãng Anh Khuê F-94WA-8DG (33mm)",380000,380000,0,0
TIKI,dong-ho-va-trang-suc,134677518,"Dây đeo cho Samsung Watch 6/ 6 Classic/ 5/ 5 Pro/ Watch 4/ Watch 4 Classic (DSG)",140000,140000,0,0
TIKI,dong-ho-va-trang-suc,89879353,"Bông tai khuyên tròn chất liệu bạc 925 MS52g",86000,86000,0,0
TIKI,dong-ho-va-trang-suc,272373786,"Chuỗi Ngọc Trai Trắng Cổ Điển, Chuỗi Ngọc Trai Thiên Nhiên (Ngọc Thật 100%), Vòng Cổ Ngọc Trai Tự Nhiên Nước Ngọt - DB1336 - Bảo Ngọc Jewelry",1083000,1500000,417000,28
TIKI,voucher-dich-vu,202763559,"Lấy Cao Răng (Cạo vôi răng) Và Đánh Bóng Công Nghệ Siêu Âm Mới - Nha khoa BeDental (5 chi nhánh)",99000,99000,0,0
TIKI,voucher-dich-vu,214620199,"Gói học Speech Analyzer thời hạn 1 tháng từ ELSA SPEAK - Công cụ luyện nói tiếng Anh toàn diện",320000,320000,0,0
TIKI,voucher-dich-vu,214893569,"Gói học Speech Analyzer thời hạn 1 năm từ ELSA SPEAK - Công cụ luyện nói tiếng Anh toàn diện ",1720000,1720000,0,0
TIKI,voucher-dich-vu,214893546,"Gói học Speech Analyzer thời hạn 3 tháng từ ELSA SPEAK - Công cụ luyện nói tiếng Anh toàn diện ",660000,660000,0,0
TIKI,voucher-dich-vu,167141168,"[APP] Ứng dụng Từ điển EVLD",139000,139000,0,0
TIKI,voucher-dich-vu,191820002,"Toàn Quốc [E-Voucher] 01 Vé xem phim 2D CGV cho 1 người tại Hệ thống CGV toàn quốc - Áp dụng tất cả các ngày kể cả Lễ",109000,109000,0,0
TIKI,voucher-dich-vu,144238613,"Chinh Phục Đề Thi TOEIC (Giải Chi Tiết)",210000,210000,0,0
TIKI,voucher-dich-vu,17474957,"Voucher Gói học ELSA Pro thời hạn 3 tháng từ ELSA SPEAK - Học phát âm tiếng Anh chuẩn bản xứ",335000,335000,0,0
TIKI,voucher-dich-vu,129734281,"[E-BOOK] Achievers Grade 6 Sách giáo viên điện tử",15000,15000,0,0
TIKI,voucher-dich-vu,273538721,"Bảo hiểm TNDS xe ô tô kèm BH tự nguyện cho người ngồi trên xe - Bảo hiểm Quân đội MIC",730700,730700,0,0
TIKI,voucher-dich-vu,17929617,"Voucher Gói Học ELSA Pro Trọn Đời Từ ELSA SPEAK - Học phát âm tiếng Anh chuẩn bản xứ",1845000,1845000,0,0
TIKI,voucher-dich-vu,167141168,"[APP] Ứng dụng Từ điển EVLD",139000,139000,0,0
TIKI,voucher-dich-vu,273720644,"Bảo hiểm du lịch toàn cầu MIC, chuyến đi 7 - 10 ngày, gói Thượng hạng",170800,244000,73200,30
TIKI,voucher-dich-vu,273737742,"Bảo hiểm Du lịch toàn cầu MIC, chuyến đi 16 - 18 ngày, gói Thượng hạng",315700,451000,135300,30
TIKI,voucher-dich-vu,273818388,"Bảo hiểm du lịch toàn cầu MIC, chuyến đi từ 4 - 6 ngày, gói Thượng hạng",128800,184000,55200,30
TIKI,voucher-dich-vu,58340009,"Voucher Buffet Tối (từ T2-T6) tại Nhà Hàng Gánh Bông Sen, Tinh Hoa Ẩm Thực Sài Thành",359000,359000,0,0
TIKI,voucher-dich-vu,147419833,"Combo 6 Sách Oxford Business Result",816000,816000,0,0
TIKI,voucher-dich-vu,973184,"Khóa Học Online Luyện TOEIC Chuyên Sâu 0-700+",349000,349000,0,0
TIKI,voucher-dich-vu,57386083,"Combo Cắt, Gội, Sấy Tạo Kiểu Tại Labella Hair Salon",99000,99000,0,0
TIKI,voucher-dich-vu,129740099,"[E-BOOK] Achievers Grade 6 File nghe audio Bài học",10000,10000,0,0
TIKI,voucher-dich-vu,273818656,"Bảo hiểm du lịch toàn cầu MIC, chuyến đi từ 28 - 31 ngày, gói Thượng hạng",436800,624000,187200,30
TIKI,voucher-dich-vu,272744625,"Bảo hiểm TNDS xe ô tô 7 chỗ ngồi, không kinh doanh, giấy chứng nhận điện tử - Bảo hiểm Quân đội MIC",873400,873400,0,0
TIKI,voucher-dich-vu,273624354,"Bảo hiểm Du lịch toàn cầu MIC, chuyến đi 11 - 15 ngày, gói Thượng hạng",227500,325000,97500,30
TIKI,voucher-dich-vu,273818595,"Bảo hiểm du lịch toàn cầu MIC, chuyến đi từ 23 - 27 ngày, gói Thượng hạng",396200,566000,169800,30
TIKI,voucher-dich-vu,273818490,"Bảo hiểm du lịch toàn cầu MIC, chuyến đi từ 19 - 22 ngày, gói Thượng hạng",362600,518000,155400,30
TIKI,voucher-dich-vu,973176,"Khoá Học Online TOEIC Chuyên Đề",210000,210000,0,0
TIKI,voucher-dich-vu,17326162,"Rita Homespa - Couple VIP Chăm Sóc Da Chạy vitanmin C Cơ Bản Kết Hợp Massage Boby Đá Nóng/ Tinh Dầu 120 Phút",599000,599000,0,0
TIKI,voucher-dich-vu,137245812,"[APP] New Amanda & Friends 3 - Ứng dụng phần mềm trò chơi tương tác",25000,25000,0,0
TIKI,voucher-dich-vu,67131701,"Chicken Plus	Phiếu quà tặng Chicken Plus",29100,30000,900,3
TIKI,voucher-dich-vu,248604560,"Ibis Styles Hotel 4* Vũng Tàu - Buffet Sáng, Hồ Bơi Vô Cực, Đối Diện Biển Bãi Sau",1380000,1380000,0,0
TIKI,voucher-dich-vu,53853984,"KHÓA KÈM IELTS ONLINE 1-1- NÂNG BAND THẦN TỐC, RÚT NGẮN ĐẾN 80% THỜI GIAN HỌC MÀ VẪN ĐẠT KẾT QUẢ CAO",568000,568000,0,0
TIKI,voucher-dich-vu,191657122,"Phiếu Quà Tặng Extrim 200K",190000,200000,10000,5
TIKI,voucher-dich-vu,152618917,"Một Chiến Dịch Ở Bắc Kỳ",99000,99000,0,0
TIKI,voucher-dich-vu,116969518,"Evoucher - Monkey Stories (Trọn đời, 1 năm) - Phần mềm 4 kỹ năng tiếng Anh",399000,399000,0,0
TIKI,voucher-dich-vu,248326418,"[Đúng Việc] Voiz FM - Voucher nghe Sách Nói",79000,100000,21000,21
TIKI,voucher-dich-vu,174643280,"Massage Body + Massage Foot + Xông mũi + Đắp mặt nạ 80 Phút tại Paradise Spa",99000,99000,0,0
TIKI,voucher-dich-vu,189201399,"Sách nói: Đại Nam Dật Sử Và Sử Ta So Với Sử Tàu",99000,99000,0,0
TIKI,voucher-dich-vu,205582358,"Phiếu Quà Tặng Lẩu Đài Loan Băng Chuyền Shang Chi 500K",500000,500000,0,0
TIKI,voucher-dich-vu,262663539,"Thẻ hội viên đọc/nghe sách điện tử Waka 06 tháng",300000,300000,0,0
TIKI,voucher-dich-vu,7358865,"Voucher Dịch Vụ Tẩy Trắng Răng Nha Khoa Bằng Đèn Plasma tại Hệ thống nha khoa Hợp Nhất",400000,400000,0,0
TIKI,voucher-dich-vu,127457587,"[E-BOOK] i-Learn Smart Start Listening & Speaking 1 File nghe Audio",10000,10000,0,0
TIKI,voucher-dich-vu,186880784,"Giftpop - Phiếu Quà Tặng Le Monde Steak 100K",100000,100000,0,0
TIKI,voucher-dich-vu,122699503,"[E-BOOK] i-Learn Smart World 8 Sách mềm sách bài tập",15000,15000,0,0
TIKI,voucher-dich-vu,123777448,"[E-BOOK] Practice Tests Grade 7 Sách mềm sách học sinh",15000,15000,0,0
TIKI,voucher-dich-vu,973124,"Khóa Học Online Luyện TOEIC 700+",249000,249000,0,0
TIKI,voucher-dich-vu,186232165,"Giftpop - Phiếu Quà Tặng Pizza 4P's 200K",200000,200000,0,0
TIKI,voucher-dich-vu,209606272,"Tour Bà Nà, Gồm Vé Cáp Treo, Buffet Trưa, Cầu Vàng, Đón Tận Nơi Từ Đà Nẵng",950000,950000,0,0
TIKI,voucher-dich-vu,196726611,"FPT Play - Gói MAX-VIP 13 tháng/ Gói iZi 06-12 tháng - Gói dịch vụ phổ biến xem truyền hình, thể thao, phim truyện và giải trí",290000,290000,0,0
TIKI,voucher-dich-vu,209605812,"[Vé QRCODE] Vé Bà Nà Hills, Vui Chơi Không Giới Hạn, Không Cần Xếp Hàng Mua Vé",750000,750000,0,0
TIKI,voucher-dich-vu,189190792,"[E-Voucher Vietravel] Singapore 4N3D: Khám phá khu phố nhỏ Kampong Glam và Haji Lane, 1 ngày tự do",12990000,12990000,0,0
TIKI,voucher-dich-vu,98823543,"Jeonbok - Phiếu Quà Tặng 200K",190000,200000,10000,5
TIKI,voucher-dich-vu,186232386,"Giftpop - Phiếu Quà Tặng Pizza 4P's 1000K",1000000,1000000,0,0
TIKI,voucher-dich-vu,72934871,"Tour Nam Du - Lặn Ngắm San Hô 2N2Đ, Xe Giường Nằm, Gồm Vé Tàu Cao Tốc Superdong, Khởi Hành Tối Thứ 6 Hàng Tuần & Dịp Lễ Tết",1890000,1890000,0,0
TIKI,voucher-dich-vu,122911133,"[E-BOOK] i-Learn Smart Start Grade 4 Sách mềm sách học sinh",15000,15000,0,0
TIKI,voucher-dich-vu,76359124,"Hoàng Yến - Phiếu Quà Tặng 500K",500000,500000,0,0
TIKI,tui-vi-nu,177060582,"Túi xách nữ thời trang cao cấp",441000,490000,49000,10
TIKI,tui-vi-nu,185964455,"Túi xách nữ vải canvas thời trang cao cấp phong cách cá tính mới",315000,350000,35000,10
TIKI,tui-vi-nu,224888468,"Ví Da Bò Cầm Tay Dáng Dài Thời Trang cao cấp Cho Nữ phong cách mới",513000,570000,57000,10
TIKI,tui-vi-nu,203583425,"Ví Da Bò Cầm Tay Dáng Dài Thời Trang cao cấp Cho Nữ phong cách mới",531000,590000,59000,10
TIKI,tui-vi-nu,159946692,"Túi xách nữ công sở đựng laptop dáng đứng tote thời trang Yuumy YTX18",235000,520000,285000,55
TIKI,tui-vi-nu,193650197,"Ví nữ mini Yuumy YV40 màu ngẫu nhiên",69000,150000,81000,54
TIKI,tui-vi-nu,155287323,"Túi xách nữ công sở cỡ lớn YUUMY YTX20",235000,520000,285000,55
TIKI,tui-vi-nu,203583356,"Ví Da Bò Cầm Tay Dáng Dài Thời Trang cao cấp Cho Nữ phong cách mới",441000,490000,49000,10
TIKI,tui-vi-nu,248562171,"Ví Da Bò Cầm Tay Dáng Dài Thời Trang cao cấp Cho Nữ phong cách châu âu",477000,530000,53000,10
TIKI,tui-vi-nu,190582559,"Ví nữ cầm tay khóa cài YUUMY Seasand YV70",95000,190000,95000,50
TIKI,tui-vi-nu,89428878," Túi cói Merci đi du lịch đi chơi thời trang TX02",34997,34997,0,0
TIKI,tui-vi-nu,190355521,"Túi xách nữ da thật thời trang cao cấp phong cách mới",621000,690000,69000,10
TIKI,tui-vi-nu,162024663,"Túi xách nữ thời trang công sở cao cấp phong cách mới",404000,448200,44200,10
TIKI,tui-vi-nu,186650070,"Túi xách nữ thời trang cong sở cao cấp",387000,430000,43000,10
TIKI,tui-vi-nu,97707630,"Túi xách nữ thời trang công sở cao cấp phong cách mới",441000,490000,49000,10
TIKI,tui-vi-nu,116778345,"Combo 10 Túi đựng thẻ căn cước công dân, bằng lái xe, ATM, Card visit, CMND",9999,9999,0,0
TIKI,tui-vi-nu,73384998,"COMBO 20 BAO ĐỰNG THẺ CĂN CƯỚC CMND - ATM - NHÂN VIÊN - SINH VIÊN - BẰNG LÁI XE HIỆU HIER",22500,22500,0,0
TIKI,tui-vi-nu,90531483,"Túi xách nữ thời trang cao cấp",327000,362700,35700,10
TIKI,tui-vi-nu,207927121,"Túi xách nữ thời trang công sở cao cấp phong cách mới",405000,450000,45000,10
TIKI,tui-vi-nu,162029783,"Túi xách nữ thời trang công sở cao cấp phong cách mới",468000,520000,52000,10
TIKI,tui-vi-nu,142112282,"Túi Ví Đựng Bảo Vệ Chống Xướt Thẻ ATM, CCCD, Card Visa, Bằng Lái Xe, Vỏ bọc thẻ atm, bao túi đựng thẻ sinh viên, nhân viên, học sinh, name card, căn cước công dân",1000,1000,0,0
TIKI,tui-vi-nu,103660156,"Túi xách nữ thời trang cao cấp phong cách châu âu",351000,390000,39000,10
TIKI,tui-vi-nu,119790772,"Set 10 Vỏ Bọc Thẻ Trong Suốt, Túi Đựng Thẻ Căn Cước Công Dân, Bằng Lái Xe, Thẻ Ngân Hàng, Bao Bọc Thẻ Đa Năng",1000,1000,0,0
TIKI,tui-vi-nu,107615691,"Túi vải bố, Túi vải Canvas trơn màu Đen không khóa kéo",19000,19000,0,0
TIKI,tui-vi-nu,177822630,"VÍ SEN 4 - CHÍNH HÃNG KHACTEN.COM",600000,600000,0,0
TIKI,tui-vi-nu,199978511,"Túi xách nữ 100% da thật thời trang công sở cao cấp phong cách mới",711000,790000,79000,10
TIKI,tui-vi-nu,155636624,"Túi Xách Nữ Đeo Chéo Đựng Điện Thoại Cá Tính Đi Chơi Phong Cách Hàn Quốc -lD006",57888,57888,0,0
TIKI,tui-vi-nu,95289176,"Túi tote HAFELE",50000,50000,0,0
TIKI,tui-vi-nu,10239742,"Combo 5 bao  passport trong suốt đựng hộ chiếu loại dày 3 ngăn",14999,14999,0,0
TIKI,tui-vi-nu,77937135,"Túi Tote Nữ Thời Trang Hàn Quốc Vải Bố Canvas Màu Đen Dạng Đeo Vai Có Khóa Kéo Nhiều Ngăn Phụ Trong Ngoài Đựng Macbook, Laptop. Phụ Kiện Chống Sốc",80000,99000,19000,19
TIKI,tui-vi-nu,80976372,"Ví Da Đa Năng Đựng Tiền Và Thẻ Cho Cả Nam Và Nữ - Tặng Kèm 1 Móc Khóa Hình Vịt Vàng",79000,79000,0,0
TIKI,tui-vi-nu,192126231,"[CÓ NẮP] Combo 10 cái bao bằng lái dạng PET, căn cước công dân, thẻ giữ xe, thẻ ATM...dẻo trong bamarau (loại có nắp đậy)",9999,9999,0,0
TIKI,tui-vi-nu,167650547,"Túi đeo chéo nữ mini đựng điện thoại YUUMY YN120",165000,270000,105000,39
TIKI,tui-vi-nu,116388009,"Túi Tote Nữ Grepaco Xách Vải Bố Canvas Cao Cấp In Chữ Đẹp Đeo Chéo Vai Có Khóa Kéo Nhiều Ngăn Dùng Đi Học, Làm Công Sở, Du Lịch Phong Cách Thời Trang Hàn Quốc - Tặng Túi Đựng Mỹ Phẩm",113050,119000,5950,5
TIKI,tui-vi-nu,126131179,"Combo Vỏ bọc thẻ căn cước, thẻ tín dụng, bằng lái xe ATM DE88 Shalla",12870,17589,4719,27
TIKI,tui-vi-nu,92984529,"Ví Nữ Cầm Tay Gấp Gọn Để Tiền Thẻ Galaxy Store GVNUB04 - Hàng Chính Hãng",38000,198000,160000,81
TIKI,tui-vi-nu,120464074,"TÚI CÓI VINTAGE, TÚI CÓI ĐI BIỂN XINH XẮN, TÚI CÓI ĐA NĂNG QUAI VẢI BỐ",34000,45000,11000,24
TIKI,tui-vi-nu,167647747,"Túi nữ mini da mềm YUUMY YN119",175000,290000,115000,40
TIKI,tui-vi-nu,89773490,"TÚI CÓI MERCI SIZE TO ĐI BIỂN PHONG CÁCH HQC 487",69000,79000,10000,13
TIKI,tui-vi-nu,164061785,"Túi Vỏ Bao Đựng Bọc Thẻ Căn Cước Công Dân, Bằng Lái Xe, Thẻ Ngân Hàng, Thẻ Sinh Viên, Thẻ Nhân Viên",1000,1000,0,0
TIKI,tui-vi-nu,189170539,"Ví cầm tay nữ nhiều ngăn Lata VN64",290000,290000,0,0
TIKI,tui-vi-nu,75392240,"Túi xách tote vải Túi Tote Túi Vải Nữ Túi Đeo Chéo Hàn Quốc  cúc - MunNiNi",66900,66900,0,0
TIKI,tui-vi-nu,170493623,"Ví cầm tay nữ mini cute BST The Button Wallet V5 chính hãng NATLOLI nhỏ gọn kháng nước nhiều ngăn cao cấp",179000,256000,77000,30
TIKI,tui-vi-nu,137153961,"Túi Tote Canvas Đeo Chéo Nữ Đi Học Stand By Me Phong Cách Hàn Quốc",59000,59000,0,0
TIKI,tui-vi-nu,52519107,"Ví nữ dài cầm tay hai khóa kéo thời trang PC13",76000,100000,24000,24
TIKI,tui-vi-nu,184476501,"Túi tote unisex Elegant Chicbag chính hãng NATOLI chất vải canvas có khóa kéo chống nước nhiều ngăn",250000,358000,108000,30
TIKI,tui-vi-nu,38448729,"Ví nữ da bò mini Marrant - BHM8608 Vi đựng thẻ. hàng chính hãng",299000,299000,0,0
TIKI,tui-vi-nu,192339670,"Túi mini thời trang túi xách nữ đeo chéo vai phong cách hàn quốc họa tiết nổi bật K-911-2",165000,165000,0,0
TIKI,tui-vi-nu,193614786,"Túi Xách Nữ Đeo Vai Chéo Thời Trang Cao Cấp, Nhiều Ngăn Kéo Đựng Đồ Tiện Lợi, Nhiều Màu Sắc Lựa Chọn Cá Tính",120000,120000,0,0
TIKI,tui-vi-nu,85081131,"Túi đeo chéo nữ túi xách bò sữa ulzzang đi học đi chơi",69000,69000,0,0
TIKI,tui-vi-nu,76066141,"Combo 10 Túi Ví Đựng Bảo Vệ Chống Xước Thẻ ATM, CCCD , Card Visit, Driver License Bằng Lái Xe Trong Suốt",5800,5800,0,0
TIKI,tui-vi-nu,95861610," Túi Vải Canvas Đeo Vai Phong Cách Hàn Quốc Dành Cho Nam Nữ - Túi Tote Đeo Chéo Unisex",59000,59000,0,0
TIKI,tui-vi-nu,137150221,"Túi đeo chéo nữ vải dù nhiều ngăn chống nước phong cách Hàn Quốc Size 25cm TUI-048",109000,109000,0,0
TIKI,tui-vi-nu,51545193,"Túi xách nữ đeo chéo nhỏ xinh da mềm phong cách hàn quốc Mstaly TX15",38610,52767,14157,27
TIKI,tui-vi-nu,170984404,"Túi Đựng Thẻ Căn Cước Công Dân, Bao Bì Bọc Gói Bảo Quản Bằng Lái Xe Thẻ ATM Card visit Phụ Kiện Túi ví Nam Nữ",1499,1499,0,0
TIKI,balo-va-vali,152152254,"Vòng Gỗ Huyết Long Tỵ Dậu Sửu - Vòng Tay Tam Hợp Quý Nhân Huyết Rồng - May Mắn Tài Lộc",219000,219000,0,0
TIKI,balo-va-vali,44866294,"Nhẫn Nam Bản To Loại Bóng Titan Không Rỉ TT 2379 - 1 Cái",87000,87000,0,0
TIKI,balo-va-vali,161942149,"Ốp Kính Cường Lực Apple Watch Series 1/2/3/4/5/SE/6 Đủ Size 38mm 40mm 42mm 44mm",52000,52000,0,0
TIKI,balo-va-vali,8061519,"Đồng Hồ Nam Citizen Dây Da NH8363-14H - Mặt Xám",6485000,6485000,0,0
TIKI,balo-va-vali,181144977,"Vòng tay đá thạch anh tóc đen mệnh thủy, mộc - Ngọc Quý",800000,1140000,340000,30
TIKI,balo-va-vali,130014524,"Nhẫn xoàn, Phong cách Âu Mỹ, Màu vàng 18K, Chất liệu hợp kim đính Pha lê tinh thể, mẫu Luxi Green 007M, Kèm hộp đựng Cẩm Tú",168000,168000,0,0
TIKI,balo-va-vali,103419257,"Combo Nhẫn Xoàn, Kiểu dáng Ruby, Hợp kim tráng Platin, Hợp Nam Nữ, Phong cách Cung đình, Kèm túi đựng Cung Hỷ - mẫu CrownX.436B",136000,153000,17000,11
TIKI,balo-va-vali,157316575,"Đồng Hồ Nam Dây Nhựa Casio G-Shock GA-2100FR-5ADR Chính Hãng - GA-2100FR-5A",3291750,4389000,1097250,25
TIKI,balo-va-vali,87984992,"Nhẫn Dây Xích Khui Bia",6500,6500,0,0
TIKI,balo-va-vali,32215287,"Nhẫn nam quân đội mỹ -không đen -không rỷ",105000,105000,0,0
TIKI,balo-va-vali,150491033,"Vòng Cẩm Thạch Đỏ đẹp I Size 49mm Vòng tay đỏ đỏ đậm đẹp đeo lên may mắn chuẩn hợp Nữ mệnh Hỏa mệnh Thổ ạ Nữ cân  nặng 45kg -> 51kg đeo vừa tay đẹp xinh tay ạ",550000,1100000,550000,50
TIKI,balo-va-vali,26329169,"Vòng chuỗi hạt đeo tay 2 line nữ đá labradorite mài giác 5mm mệnh thủy , kim - Ngọc Quý Gemstones",1239000,1700000,461000,27
TIKI,balo-va-vali,59243874,"ĐỒNG HỒ NỮ DÂY DA MẶT VUÔNG THỜI TRANG CAO CẤP",120000,120000,0,0
TIKI,balo-va-vali,51933070,"Nhẫn Bạc Nữ - Nhẫn Bạc Nữ Đính Đá Bạc S925 Đơn Giản Phong Cách Hàn Quốc Thiết Kế Dáng Hở Điều Chỉnh Được Cỡ - N2458 - Bảo Ngọc Jewelry",220000,220000,0,0
TIKI,balo-va-vali,77947555,"Dây chuyền mặt đá cho nam nữ BHDC212",36000,59000,23000,39
TIKI,balo-va-vali,106393684,"(TẶNG CHỐT VÀ DỤNG CỤ THAY DÂY) Dây Đồng hồ Kim Loại Đúc Đầu cong đầu ôm",150000,150000,0,0
TIKI,balo-va-vali,184915973,"Vòng Tay Đá Ngọc Cẩm Thạch tự nhiên TR LÝ 49mm x cọng 7,2mm Màu bạch ngọc trắng bóng điểm lý xanh rêu rất là đẹp sang Nữ mệnh Kim, mệnh Thủy năngh 47kg - 51kg đeo đẹp ạ",899000,1798000,899000,50
TIKI,balo-va-vali,43936313,"Vòng Chuỗi Mân Côi Đá Thạch Anh Tóc Đen Phối Thánh Giá hạt 12mm, ni50 - Ngọc Qúy Gemstones",1039000,1480000,441000,30
TIKI,balo-va-vali,14998285,"Dây chuyền nam kiểu mì lớn mạ vàng 18k",113000,119000,6000,5
TIKI,balo-va-vali,14884836,"Bông Tai Ngọc Trai Cao Cấp Cỡ Hạt 7x7 Ly - B2352 - Bảo Ngọc Jewelry - Trắng",315000,332000,17000,5
TIKI,balo-va-vali,77742801,"Đồng hồ dây kim loại thời trang nam Skmei Sk6909, mặt tròn kính cứng kèm lịch ngày sang trọng",99000,99000,0,0
TIKI,balo-va-vali,31661608,"Đồng hồ nam dây thép không gỉ Skmei 90TCK58",251750,265000,13250,5
TIKI,balo-va-vali,49722402,"Nhẫn Nữ Bản To Titan Ko Đen TT 2464",105000,105000,0,0
TIKI,balo-va-vali,147344123,"Nhẫn nữ con công",75000,75000,0,0
TIKI,balo-va-vali,172154180,"Vòng thạch anh ưu linh trắng liền khối bản vuông mệnh thủy, kim - Ngọc Quý Gemstones",1999000,2500000,501000,20
TIKI,balo-va-vali,50377999,"Dây Chuyền Vuông Titan Nam Hình Song Long Mạ Vàng 18K + TẶNG LÁ BỒ ĐỀ MAY MẮN TÀI LỘC ĐỂ VÍ ĐIỆN THOẠI",327750,345000,17250,5
TIKI,balo-va-vali,54685037,"Nhẫn Cặp | Nhẫn Đôi Nam Nữ Freesize Thiết Kế Đơn Giản ND2518 (Có thể tùy chỉnh tùy ý theo cỡ tay)",372000,372000,0,0
TIKI,balo-va-vali,14903787,"Dây Chuyền Ngọc Trai Cao Cấp DB2354 Cỡ Hạt 12x16 Bảo Ngọc Jewelry",388000,388000,0,0
TIKI,balo-va-vali,68292794,"Dây Và Mặt Dây Chuyền Bạc Hiểu Minh DMD275 phật bà quan âm bồ tát",480000,590000,110000,19
TIKI,balo-va-vali,15627807,"Lu thống ngọc cẩm thạch",39130,39130,0,0
TIKI,balo-va-vali,46717935,"Vòng tay đá cẩm thạch xanh lý bản tròn mệnh mộc hỏa - Ni",1599000,2000000,401000,20
TIKI,balo-va-vali,20103710,"Vòng Tay Trầm Hương Chỉ Đỏ Thiên Mộc Hương",379000,490000,111000,23
TIKI,balo-va-vali,4407201,"Đồng Hồ thể thao Trẻ Em Chống Nước SKMEI 1061",170000,179000,9000,5
TIKI,balo-va-vali,72880942,"Đồng hồ nữ thời trang Hàn Quốc mặt nhỏ JW-6337 - Hàng chính hãng",199000,199000,0,0
TIKI,balo-va-vali,78622641,"Nhẫn Bạc Thái | Nhẫn Bạc Thái Hình Sao Cho Nữ N1740 - Bảo Ngọc Jewelry",200000,200000,0,0
TIKI,balo-va-vali,106391315,"(TẶNG KÈM CHỐT VÀ DỤNG CỤ THAY DÂY) Dây đồng hồ inox không gỉ size 19mm dạng 5 mắt dây Tissot đầu ôm bo tròn",150000,150000,0,0
TIKI,balo-va-vali,35233450,"Đồng hồ nam Sunrise 1146SA B [Full Box] - Kính Sapphire, chống xước, chống nước - Dây da cao cấp",2218800,2218800,0,0
TIKI,balo-va-vali,68347055,"Lắc Tay Nữ Bạc Hiểu Minh LTU409 kiềng bạc ta",680000,850000,170000,20
TIKI,balo-va-vali,45814396,"Mặt dây chuyền hạt đậu cẩm thạch phỉ thúy 1.8cm mệnh hỏa, mộc - Ngọc Quý Gemstones",439000,860000,421000,49
TIKI,balo-va-vali,114595314,"Đồng hồ nam quân đội chính hãng KASSAW S15008-1",3285000,3650000,365000,10
TIKI,tui-vi-nu,197321592,"Túi Tote Chần Bông SAIGON SWAGGER NOIR PUFFER TOTE BAG",531000,590000,59000,10
TIKI,tui-vi-nu,76102979,"Túi Xách Nữ, Túi Đeo Vai Nữ Phong Cách Vintage In Họa Tiết Siêu Dễ Thương",28000,29999,1999,7
TIKI,tui-vi-nu,86561273,"  50K Túi đeo chéo nữ dây pha xích mini",55000,55000,0,0
TIKI,tui-vi-nu,137952085,"Túi Giỏ Xách Đan Tay Xéo Quai Gỗ Hàng Xuất Khẩu Thủ Công Sang Chảnh Đi Chơi Đi Biển Chụp Hình - Doni House",126000,126000,0,0
TIKI,tui-vi-nu,13419271,"Ví Mini Cầm Tay Họa Tiết Kim Loại Hn001",62000,62000,0,0
TIKI,tui-vi-nu,193715750,"Túi Xách Nữ, Túi Đeo Chéo Nữ Đẹp Trẻ Trung Hàn Quốc",130000,130000,0,0
TIKI,tui-vi-nu,196341307,"Tấm Lót Chống Thấm Cho Bé Sơ Sinh 5 Lớp Chần Bông Thấm Hút Nhanh An Toàn Tiện Lợi - 231",115000,115000,0,0
TIKI,tui-vi-nu,185468208,"bóp ví nữ cầm tay hoặc đeo chéo hàng hiệu có nhiều ngăn dáng nằm với 2 ngăn kéo tiện dụng - N0109",158000,249000,91000,37
TIKI,tui-vi-nu,191259117,"Ví Da PU Mini Cầm Tay Họa Tiết Cô Gái Summer Xinh Xắn Nhiều Ngăn Có Khóa Kéo Bóp Nữ Cute Hot Trend Dễ Thương",50000,50000,0,0
TIKI,tui-vi-nu,68773394,"Túi Kẹp Nách Nữ Thời Trang Hot Trend Cá Tính TEB409",55000,55000,0,0
TIKI,tui-vi-nu,104091538,"Ví nữ cầm tay dáng dài YUUMY Seasand YUUMY YV47 phong cách hiện đại nhiều ngăn đựng tiền, thẻ card",89000,220000,131000,60
TIKI,tui-vi-nu,155169078,"Túi giỏ xách nữ đeo chéo cao cấp thời trang Hàn Quốc sang chảnh chất liệu da mềm mịn, kiểu dáng sang trọng,lịch sự TX048",219000,219000,0,0
TIKI,tui-vi-nu,149449476,"Túi xách nữ công sở - hàng quảng châu cao cấp (HOTTREND )",258000,258000,0,0
TIKI,tui-vi-nu,86561609," Túi Cói    Túi Xách Nữ Phong cách Vintage TV12",38000,41900,3900,9
TIKI,tui-vi-nu,93831393," Túi đeo chéo trong suốt | Mini Bag Unisex",123500,123500,0,0
TIKI,tui-vi-nu,206955191,"Túi xách, Husband & Wife, Best Friends for Life, mã G142. Có khóa kéo. Quà tặng cao cấp cho vợ chồng",109000,109000,0,0
TIKI,tui-vi-nu,53979971,"Ví nữ cầm tay cao cấp 2 ngăn kéo sang trọng, thiết kế nhiều ngăn tiện dụng TK0047 - ĐEN",76000,100000,24000,24
TIKI,tui-vi-nu,108154925,"Túi tote vải Túi Tote Túi Vải Nữ Túi túi xách Túi Tote Sinh Viên Chú Gà Sweet balo nữ vải",63000,63000,0,0
TIKI,tui-vi-nu,160314514,"Ví Ngắn Nữ Mini Cầm Tay Thời Trang TAILIAN Đựng Tiền Phong Cách Hàn Quốc Sang Trọng Da Cao Cấp Cực Đẹp TL36 - Micocah",109000,109000,0,0
TIKI,tui-vi-nu,108155133,"Balo thời trang, balo đi học, đựng laptop Túi Tote Mèo Mắt Long Lanh Mèo Cute balo nữ vải",93000,93000,0,0
TIKI,tui-vi-nu,142211339,"Túi Đeo Chéo Chống Thám, Kháng Khuẩn Stargo Retro - Hàng Chính Hãng",187000,219000,32000,15
TIKI,tui-vi-nu,176825223,"Ví đựng thẻ tín dụng ATM nhiều ngăn ví mini kháng nước nhỏ gọn 20 ngăn xinh xắn giá tốt",26000,26000,0,0
TIKI,tui-vi-nu,118403624,"Túi Cói Đi BiểnTúi Cói Merci SIÊU HÓT HÍT 2021(video tự quay, hàng chất lừ) Đi Biển, Đi Chơi, Đi Du Lịch, đi làm, đi học",80000,80000,0,0
TIKI,tui-vi-nu,190744476,"Túi Đeo Chéo Nam Nữ Vải Bố Túi Đeo Vai Nam Chất Liệu Kaki Chống Nước Size 24cm TUI-36",109000,109000,0,0
TIKI,tui-vi-nu,114119695,"Túi Đeo Chéo Mickey Dáng Vuông",189000,189000,0,0
TIKI,tui-vi-nu,5003107,"Túi Xách Nữ Thời Trang Cao Cấp Elly EL85",1049300,1499000,449700,30
TIKI,dong-ho-va-trang-suc,152152254,"Vòng Gỗ Huyết Long Tỵ Dậu Sửu - Vòng Tay Tam Hợp Quý Nhân Huyết Rồng - May Mắn Tài Lộc",219000,219000,0,0
TIKI,tui-vi-nu,182712650,"Ví nữ Monogram canvas ELLY – EVH90",599400,999000,399600,40
TIKI,tui-vi-nu,91430164,"Ví card holder",127000,127000,0,0
TIKI,dong-ho-va-trang-suc,150491033,"Vòng Cẩm Thạch Đỏ đẹp I Size 49mm Vòng tay đỏ đỏ đậm đẹp đeo lên may mắn chuẩn hợp Nữ mệnh Hỏa mệnh Thổ ạ Nữ cân  nặng 45kg -> 51kg đeo vừa tay đẹp xinh tay ạ",550000,1100000,550000,50
TIKI,tui-vi-nu,124239585,"Bóp nữ hình cây, ví ngắn nữ mini hàng Quảng Châu loại 1",39000,39000,0,0
TIKI,dong-ho-va-trang-suc,161942149,"Ốp Kính Cường Lực Apple Watch Series 1/2/3/4/5/SE/6 Đủ Size 38mm 40mm 42mm 44mm",52000,52000,0,0
TIKI,tui-vi-nu,105655289,"Túi xách túi đeo chéo nữ kiểu dáng công sở kèm dây nơ xinh xắn",99000,99000,0,0
TIKI,dong-ho-va-trang-suc,59243874,"ĐỒNG HỒ NỮ DÂY DA MẶT VUÔNG THỜI TRANG CAO CẤP",120000,120000,0,0
TIKI,dong-ho-va-trang-suc,157316575,"Đồng Hồ Nam Dây Nhựa Casio G-Shock GA-2100FR-5ADR Chính Hãng - GA-2100FR-5A",3291750,4389000,1097250,25
TIKI,tui-vi-nu,70937309,"Ví nữ cầm tay thời trang cao cấp ELLY – EV69",799000,799000,0,0
TIKI,tui-vi-nu,186606688,"Túi Vải Canvas Cao cấp - Độc quyền HeydayCacao",79000,79000,0,0
TIKI,dong-ho-va-trang-suc,103419257,"Combo Nhẫn Xoàn, Kiểu dáng Ruby, Hợp kim tráng Platin, Hợp Nam Nữ, Phong cách Cung đình, Kèm túi đựng Cung Hỷ - mẫu CrownX.436B",136000,153000,17000,11
TIKI,tui-vi-nu,173556714,"Túi Cói, Túi Cói Đi Biển Vintage, Túi Lục Bình Đi Biển, Túi Xách Đi Làm, Giỏ Du Lịch Chuẩn Đẹp",299000,299000,0,0
TIKI,tui-vi-nu,272429248,"Túi xách nữ vải dù siêu bền không thấm nước kiểu dáng Hàn Quốc size 21cm",119000,119000,0,0
TIKI,tui-vi-nu,118036773,"Đãi túi cho phật tử và thầy, túi kaki đeo vai",72000,72000,0,0
TIKI,tui-vi-nu,160314200,"Ví Ngắn Nữ Mini Cầm Tay Thời Trang TAILIAN Nhiều Ngăn Đựng Tiền Phối Vân Da Rắn Cao Cấp Siêu Đẹp Giá Rẻ TL34 - Micocah",119000,119000,0,0
TIKI,dong-ho-va-trang-suc,44866294,"Nhẫn Nam Bản To Loại Bóng Titan Không Rỉ TT 2379 - 1 Cái",87000,87000,0,0
TIKI,tui-vi-nu,88813417,"Túi xách Pierre Loues dáng túi trống đeo vai với 2 đầu gút thắt cách điệu thời trang dạo phố - PL514",257000,298000,41000,14
TIKI,dong-ho-va-trang-suc,106391315,"(TẶNG KÈM CHỐT VÀ DỤNG CỤ THAY DÂY) Dây đồng hồ inox không gỉ size 19mm dạng 5 mắt dây Tissot đầu ôm bo tròn",150000,150000,0,0
TIKI,tui-vi-nu,68626519,"Ví da nữ mini nhỏ gọn đựng tiền đựng thẻ YUUMY YV29 nhiều màu",69000,110000,41000,37
TIKI,dong-ho-va-trang-suc,26329169,"Vòng chuỗi hạt đeo tay 2 line nữ đá labradorite mài giác 5mm mệnh thủy , kim - Ngọc Quý Gemstones",1239000,1700000,461000,27
TIKI,dong-ho-va-trang-suc,14998285,"Dây chuyền nam kiểu mì lớn mạ vàng 18k",113000,119000,6000,5
TIKI,dong-ho-va-trang-suc,181144977,"Vòng tay đá thạch anh tóc đen mệnh thủy, mộc - Ngọc Quý",800000,1140000,340000,30
TIKI,dong-ho-va-trang-suc,77947555,"Dây chuyền mặt đá cho nam nữ BHDC212",36000,59000,23000,39
TIKI,dong-ho-va-trang-suc,49722402,"Nhẫn Nữ Bản To Titan Ko Đen TT 2464",105000,105000,0,0
TIKI,dong-ho-va-trang-suc,147344123,"Nhẫn nữ con công",75000,75000,0,0
TIKI,dong-ho-va-trang-suc,4407201,"Đồng Hồ thể thao Trẻ Em Chống Nước SKMEI 1061",170000,179000,9000,5
TIKI,tui-vi-nu,176835648,"Túi xách nữ thời trang công sở cao cấp phong cách mới",387000,430000,43000,10
TIKI,dong-ho-va-trang-suc,46717935,"Vòng tay đá cẩm thạch xanh lý bản tròn mệnh mộc hỏa - Ni",1599000,2000000,401000,20
TIKI,dong-ho-va-trang-suc,130014524,"Nhẫn xoàn, Phong cách Âu Mỹ, Màu vàng 18K, Chất liệu hợp kim đính Pha lê tinh thể, mẫu Luxi Green 007M, Kèm hộp đựng Cẩm Tú",168000,168000,0,0
TIKI,dong-ho-va-trang-suc,68292794,"Dây Và Mặt Dây Chuyền Bạc Hiểu Minh DMD275 phật bà quan âm bồ tát",480000,590000,110000,19
TIKI,dong-ho-va-trang-suc,106393684,"(TẶNG CHỐT VÀ DỤNG CỤ THAY DÂY) Dây Đồng hồ Kim Loại Đúc Đầu cong đầu ôm",150000,150000,0,0
TIKI,dong-ho-va-trang-suc,51933070,"Nhẫn Bạc Nữ - Nhẫn Bạc Nữ Đính Đá Bạc S925 Đơn Giản Phong Cách Hàn Quốc Thiết Kế Dáng Hở Điều Chỉnh Được Cỡ - N2458 - Bảo Ngọc Jewelry",220000,220000,0,0
TIKI,dong-ho-va-trang-suc,68347055,"Lắc Tay Nữ Bạc Hiểu Minh LTU409 kiềng bạc ta",680000,850000,170000,20
TIKI,dong-ho-va-trang-suc,31661608,"Đồng hồ nam dây thép không gỉ Skmei 90TCK58",251750,265000,13250,5
TIKI,dong-ho-va-trang-suc,14903787,"Dây Chuyền Ngọc Trai Cao Cấp DB2354 Cỡ Hạt 12x16 Bảo Ngọc Jewelry",388000,388000,0,0
TIKI,dong-ho-va-trang-suc,32215287,"Nhẫn nam quân đội mỹ -không đen -không rỷ",105000,105000,0,0
TIKI,dong-ho-va-trang-suc,72880942,"Đồng hồ nữ thời trang Hàn Quốc mặt nhỏ JW-6337 - Hàng chính hãng",199000,199000,0,0
TIKI,dong-ho-va-trang-suc,35233450,"Đồng hồ nam Sunrise 1146SA B [Full Box] - Kính Sapphire, chống xước, chống nước - Dây da cao cấp",2218800,2218800,0,0
TIKI,dong-ho-va-trang-suc,54685037,"Nhẫn Cặp | Nhẫn Đôi Nam Nữ Freesize Thiết Kế Đơn Giản ND2518 (Có thể tùy chỉnh tùy ý theo cỡ tay)",372000,372000,0,0
TIKI,dong-ho-va-trang-suc,114595314,"Đồng hồ nam quân đội chính hãng KASSAW S15008-1",3285000,3650000,365000,10
TIKI,dong-ho-va-trang-suc,172154180,"Vòng thạch anh ưu linh trắng liền khối bản vuông mệnh thủy, kim - Ngọc Quý Gemstones",1999000,2500000,501000,20
TIKI,dong-ho-va-trang-suc,43936313,"Vòng Chuỗi Mân Côi Đá Thạch Anh Tóc Đen Phối Thánh Giá hạt 12mm, ni50 - Ngọc Qúy Gemstones",1039000,1480000,441000,30
TIKI,dong-ho-va-trang-suc,15627807,"Lu thống ngọc cẩm thạch",39130,39130,0,0
TIKI,tui-vi-nu,263516111,"(HÀNG SẴN) Túi Xách Tay Da Mềm Thời Trang AT01 - Hàng Quảng Châu Cao Cấp",325000,325000,0,0
TIKI,dong-ho-va-trang-suc,20103710,"Vòng Tay Trầm Hương Chỉ Đỏ Thiên Mộc Hương",379000,490000,111000,23
TIKI,dong-ho-va-trang-suc,50377999,"Dây Chuyền Vuông Titan Nam Hình Song Long Mạ Vàng 18K + TẶNG LÁ BỒ ĐỀ MAY MẮN TÀI LỘC ĐỂ VÍ ĐIỆN THOẠI",327750,345000,17250,5
TIKI,dong-ho-va-trang-suc,8061519,"Đồng Hồ Nam Citizen Dây Da NH8363-14H - Mặt Xám",6485000,6485000,0,0
TIKI,dong-ho-va-trang-suc,77742801,"Đồng hồ dây kim loại thời trang nam Skmei Sk6909, mặt tròn kính cứng kèm lịch ngày sang trọng",99000,99000,0,0
TIKI,dong-ho-va-trang-suc,14884836,"Bông Tai Ngọc Trai Cao Cấp Cỡ Hạt 7x7 Ly - B2352 - Bảo Ngọc Jewelry - Trắng",315000,332000,17000,5
TIKI,dong-ho-va-trang-suc,87984992,"Nhẫn Dây Xích Khui Bia",6500,6500,0,0
TIKI,dong-ho-va-trang-suc,184915973,"Vòng Tay Đá Ngọc Cẩm Thạch tự nhiên TR LÝ 49mm x cọng 7,2mm Màu bạch ngọc trắng bóng điểm lý xanh rêu rất là đẹp sang Nữ mệnh Kim, mệnh Thủy năngh 47kg - 51kg đeo đẹp ạ",899000,1798000,899000,50
TIKI,dong-ho-va-trang-suc,78622641,"Nhẫn Bạc Thái | Nhẫn Bạc Thái Hình Sao Cho Nữ N1740 - Bảo Ngọc Jewelry",200000,200000,0,0
TIKI,dong-ho-va-trang-suc,45814396,"Mặt dây chuyền hạt đậu cẩm thạch phỉ thúy 1.8cm mệnh hỏa, mộc - Ngọc Quý Gemstones",439000,860000,421000,49
TIKI,tui-thoi-trang-nam,126039327,"Bóp Đựng Thẻ ATM Nhỏ Gọn SUPPLE, Da Bò SMALL PEBBLE Mềm Mại - Bền Bỉ, Chống Xước - Chống Nhăn Tốt, Thiết Kế Hiện Đại, Ngăn Súp Lê Rộng, Đựng Được Nhiều Thẻ Ngân Hàng, Card Danh Thiếp, Căn Cước Công Dân, Dáng Đứng - Gập 2 – Hàng Chính Hãng SAIGIO",683000,699000,16000,2
TIKI,tui-thoi-trang-nam,253171976,"Ví nam 100% da thật thông minh siêu mỏng thời trang cao cấp phong cách cá tính",351000,390000,39000,10
TIKI,tui-thoi-trang-nam,155330335,"Ví da nam, bóp da nam mini Bụi Leather V115 - Da bò Nappa cao cấp - Bảo hành 12 tháng",180000,278000,98000,35
TIKI,tui-thoi-trang-nam,113760273,"Ví nam da bò cao cấp phong cách mới",387000,430000,43000,10
TIKI,tui-thoi-trang-nam,117401394,"Ví Đựng Thẻ ATM Mini, Da Bò Mềm Mại GENTLE, Da Thật 100%, Thiết Kế Hiện Đại, Nhiều Ngăn Tiện Dụng, Đựng Thẻ Ngân Hàng, Danh Thiếp, Căn Cước, Hình Lưu Niệm, Dáng Đứng - Gập 2 - Hàng Chính Hãng SAIGIO",629000,649000,20000,3
TIKI,tui-thoi-trang-nam,189539055,"Túi đeo chéo vải Canvas T0166 unisex nam nữ phong cách trẻ trung Hàn",60000,120000,60000,50
TIKI,tui-thoi-trang-nam,75417728,"Bóp Ví Dài Nam Nữ KEIO NIPPON Da Bò Mill Cao Cấp Nhập Khẩu, Đựng Điện Thoại, Hộ Chiếu Kích Thước 20x11x2.5 cm VID0003",469000,469000,0,0
TIKI,tui-thoi-trang-nam,140308913,"Túi đeo bụng, đeo chéo nhiều ngăn đa năng chống thấm nước cho nam, nữ hàng cao cấp size 22cm",72022,98430,26408,27
TIKI,tui-thoi-trang-nam,90507801,"Túi đeo chéo đeo ngực nam có khóa chống trộm chống nước cao cấp",423000,470000,47000,10
TIKI,tui-thoi-trang-nam,195153629,"Túi Đeo Chéo Vải Canvas Bền Bỉ Phong Cách Thời Trang Unisex Nam Nữ Hàn  BL002",112500,150000,37500,25
TIKI,tui-thoi-trang-nam,105695598,"Ví nam cầm tay cao cấp - Clutch Cầm Tay chất lượng cao phong cách mới",359000,398000,39000,10
TIKI,tui-thoi-trang-nam,124966188,"Ví nam, bóp nam da bò sáp Mexico Bụi Leather V102 - Bảo hành 12 tháng",200000,370000,170000,46
TIKI,tui-thoi-trang-nam,244316262,"Ví nam đựng tiền đựng chìa khóa đựng thẻ đa năng 100% da bò thật cao cấp phong cách mới",333000,370000,37000,10
TIKI,tui-thoi-trang-nam,82372883,"Túi đeo chéo nam cao cấp phong cách mới",297000,330000,33000,10
TIKI,tui-thoi-trang-nam,21602898,"Ví Nam, Bóp Nam [Dáng Đứng] Da Bò Thật Cao Cấp - Thời Trang",99000,99000,0,0
TIKI,tui-thoi-trang-nam,146618296,"Bóp Da Đựng Thẻ ATM Nhỏ Gọn, Chất Da Pull-Up Mềm Mại, Trẻ Trung - Cá Tính, Thiết Kế Hiện Đại, Nhiều Ngăn Tiện Dụng, Đựng Thẻ Ngân Hàng, Card Danh Thiếp, Căn Cước Công Dân, Hình Lưu Niệm, Dáng Đứng - Gập 2 - Hàng Chính Hãng SAIGIO",779000,799000,20000,3
TIKI,tui-thoi-trang-nam,20834169,"Ví Nam Dài Cầm Tay Nam Thời Trang Hàn Quốc",133650,182655,49005,27
TIKI,tui-thoi-trang-nam,74830942,"Ví da thời trang nam phong cách Hàn Quốc cao cấp VN21 chống nước nhiều ngăn phong cách trẻ sành điệu gu nam tính",119000,119000,0,0
TIKI,tui-thoi-trang-nam,105695598,"Ví nam cầm tay cao cấp - Clutch Cầm Tay chất lượng cao phong cách mới",359000,398000,39000,10
TIKI,tui-thoi-trang-nam,262043357,"Túi da cao cấp Macsim mã MSN22",1440000,1440000,0,0
TIKI,tui-thoi-trang-nam,262043389,"Túi xách - Túi da cao cấp Macsim mã MSTH23",1360000,1360000,0,0
TIKI,tui-thoi-trang-nam,167468890,"Ví nam, bop nam, ví nam mini, bóp da nam, ví da nam đẹp, vi da nam, ví da nam P015 kiểu dáng thanh lịch, phong cách Hàn Quốc",47000,59000,12000,20
TIKI,tui-thoi-trang-nam,79467350,"Túi đeo chéo UAG Hip Pack thời trang, chống nước - Hàng Chính Hãng",1300000,1300000,0,0
TIKI,tui-thoi-trang-nam,155495937,"Ví namecard da bò V131, ví đựng thẻ card holder da thật nhỏ gọn, thương hiệu Bụi leather chuyên đồ da thật",49000,84000,35000,42
TIKI,tui-thoi-trang-nam,174661875,"Túi Đeo Chéo Ngực Cho Nam Chống Nước, Chống Xước, Chống Bám Bẩn, Nhiều Ngăn Phong Cách Thời Trang Cao Cấp Besti Y02- Hàng Chính Hãng",190000,190000,0,0
TIKI,tui-thoi-trang-nam,74926237,"Túi Bao Tử Đeo Chéo Cao Cấp Đơn Giản Nhỏ Gọn Nam Nữ Để Điện Thoại Ví Galaxy Store GTBT02 - Hàng Chính Hãng",125000,350000,225000,64
TIKI,tui-thoi-trang-nam,155495937,"Ví namecard da bò V131, ví đựng thẻ card holder da thật nhỏ gọn, thương hiệu Bụi leather chuyên đồ da thật",49000,84000,35000,42
TIKI,tui-thoi-trang-nam,197879894,"Bóp Đứng Nam Nhỏ Gọn, Chất Liệu Da Bò PULL-UP Mềm Mại, Mỏng Nhẹ, Phong Cách Hiện Đại - Cá Tính, Size Trung, Dáng Đứng - Gập 2, Nhiều Ngăn Để Tiền Và Giấy Tờ Tiện Dụng",982000,999000,17000,2
TIKI,tui-thoi-trang-nam,184491427,"Túi đeo chéo nam 100% da bò thật cao cấp phong cách mới",477000,530000,53000,10
TIKI,tui-thoi-trang-nam,138556972,"Cặp da nam công sở TRITA TCA16",269000,460000,191000,42
TIKI,tui-thoi-trang-nam,89786167,"Túi đeo chéo nam nữ vải dù chống nước phong cách Hàn Quốc - Túi bao tử nam TC83",76230,104181,27951,27
TIKI,tui-thoi-trang-nam,106693981,"Túi Đeo Chéo Nam Vải Dù Cao Cấp, Phong Cách Thời Trang Châu Âu, Túi Đeo Vai Chống Thấm Nước Tốt, Vải Mềm Chống Nhăn, Đường Chỉ May Chắc Chắn, Khóa Kéo Bền Đẹp, Túi Dành Cho Học Sinh, Sinh Viên, Người Đi Làm",219000,219000,0,0
TIKI,tui-thoi-trang-nam,126765353,"Túi bao tử - đeo chéo unisex nam nữ vải chống nước phong cách Hàn",76230,104181,27951,27
TIKI,tui-thoi-trang-nam,184491427,"Túi đeo chéo nam 100% da bò thật cao cấp phong cách mới",477000,530000,53000,10
TIKI,tui-thoi-trang-nam,153264933,"Túi đeo chéo nam nữ 4 ngăn cao cấp D77 Shalla",38610,52767,14157,27
TIKI,tui-thoi-trang-nam,72605942,"Túi Đeo Chéo Túi Đeo Ngực Nam Nữ Chống Nước Thể Thao",160000,160000,0,0
TIKI,tui-thoi-trang-nam,72869810,"Túi Đeo Chéo Chống Nước FALDO 02",350000,350000,0,0
TIKI,tui-thoi-trang-nam,75728670,"Túi đeo chéo nam tích hợp khóa chống trộm chống nước cao cấp phong cách mới",297000,330000,33000,10
TIKI,tui-thoi-trang-nam,176147572,"Túi Đeo Chéo Nam Thể Thao Chống Nước, Chống Xước, Chống Bám Bụi,chất Liệu Vải Oxford Thiết Kế Thông Minh, Phong Cách Hiện Đại Thời Trang Cao Cấp Besti Y03- Hàng Chính Hãng",250000,250000,0,0
TIKI,tui-thoi-trang-nam,4207965,"Túi đựng ipad Simplecarry LC Ipad",390000,390000,0,0
TIKI,tui-thoi-trang-nam,163281652,"Túi đeo chéo đeo ngực nam cao cấp phong cách châu âu",711000,790000,79000,10
TIKI,tui-thoi-trang-nam,83677957,"Balo đeo chéo nam thời trang Yuumy RBAC01",189000,390000,201000,52
TIKI,tui-thoi-trang-nam,185995682,"Túi đeo chéo đeo ngực nam đa năng cao cấp phong cách mới",270000,299000,29000,10
TIKI,tui-thoi-trang-nam,75418303,"Bóp Ví Dài Nam Nữ KEIO NIPPON Da Bò Mill Cao Cấp Nhập Khẩu, Kích Thước 18x9x2cm VID-GAP001",349000,349000,0,0
TIKI,tui-thoi-trang-nam,183531122,"Túi đeo chéo da nam dáng ngang phối ngăn đôi TRITA RTN6",309000,520000,211000,41
TIKI,voucher-dich-vu,195848416,"[EVoucher Vietravel] Trải nghiệm du lịch nghỉ dưỡng sang trọng cùng Siêu du thuyền Spectrum of the Seas: Singapore - Malaysia (Kuala Lumpur - Penang) - Thailand (Phuket)",33990000,33990000,0,0
TIKI,tui-thoi-trang-nam,73502969,"Túi bao tử cao cấp đeo hông đeo ngực tiện lợi MIBAG37",76230,104181,27951,27
TIKI,tui-thoi-trang-nam,191490265,"Túi đeo chéo nam nữ cao cấp vải chống thấm nước BEE GEE DCN9031B",332000,670000,338000,50
TIKI,tui-thoi-trang-nam,198224201,"Túi Đeo Chéo Grepaco Nam Nữ Unisex Vải Bố Canvas Thời Trang Hàn Quốc Đa Năng Đựng Điện Thoại Máy Tính Bảng Mini Chống Thấm Xước Nhiều Ngăn Khóa Kéo YKK, Phù Hợp Nhiều Kiểu Xách Đeo Khác Nhau - Hàng Chính Hãng",94050,99000,4950,5
TIKI,tui-thoi-trang-nam,95446218,"Túi xách nam công sở cao cấp siêu bền đẹp",423000,470000,47000,10
TIKI,tui-thoi-trang-nam,186483412,"Túi xách nam công sở cao cấp phong cách mới",450000,499000,49000,10
TIKI,tui-thoi-trang-nam,75645911,"Túi đeo chéo nam phong cách mới tích hợp khóa chống trộm và chống thấm nước cao cấp",441000,490000,49000,10
TIKI,tui-thoi-trang-nam,7763050,"Cặp nam đeo chéo TROY phối nắp",99000,129000,30000,23
TIKI,tui-thoi-trang-nam,109483831,"Túi đeo chéo nam thời trang cao cấp ",450000,499000,49000,10
TIKI,voucher-dich-vu,252259799,"[Voucher 12 tháng] Bộ công cụ Học - Thi - Hướng nghiệp lớp 8, VitanEdu",375000,375000,0,0
TIKI,voucher-dich-vu,272744652,"Voucher tiền mặt 200k Áp dụng sử dụng tại Chuỗi Nhà Hàng Chay Bà Xã",200000,200000,0,0
TIKI,voucher-dich-vu,15649850,"Gói Khám Chuyên Sâu Toàn Diện Cho Nữ Tại Phòng Khám Đa Khoa Quốc Tế Golden Healthcare",6050000,6050000,0,0
TIKI,voucher-dich-vu,119445513,"[E-BOOK] Tiếng Anh 1 i-Learn Smart Start File nghe Audio Bài học",10000,10000,0,0
TIKI,voucher-dich-vu,7003317,"Sim 4G Thái Lan",120000,120000,0,0
TIKI,voucher-dich-vu,183335355,"Sách nói: Hướng Dẫn Đầu Tư Vàng và Bạc",99000,99000,0,0
TIKI,voucher-dich-vu,208206743,"[EVoucher Vietravel] Voucher du lịch châu Âu khởi hành Tết Nguyên đán năm 2023",42495000,42495000,0,0
TIKI,voucher-dich-vu,104613657,"Sinh Trắc Vân Tay Gen Talents – Module Nâng Cao Năng Lực Học Tập",1870000,1870000,0,0
TIKI,tui-thoi-trang-nam,20882002,"Ví Nam Dài Cầm Tay - Ví Bóp Cầm Tay Dài Nam Thời Trang",90090,123123,33033,27
TIKI,tui-thoi-trang-nam,155776133,"Túi đeo chéo nam nữ unisex phong cách ulzzang sợi polyesster cao cấp chống thấm nước Haoshuai S12",125000,125000,0,0
TIKI,voucher-dich-vu,252583621,"[Voucher 12 tháng] Bộ công cụ Học - Thi - Hướng nghiệp lớp 5, VitanEdu",375000,375000,0,0
TIKI,voucher-dich-vu,56759597,"Bít tết tình nhân - 2 suất Bít tết",129000,129000,0,0
TIKI,voucher-dich-vu,164249234,"Vé Tắm Bùn Hòn Tằm. Bao Gồm Bữa Trưa. Merperle Hòn Tằm Resort Nha Trang 5",385000,385000,0,0
TIKI,voucher-dich-vu,118521675,"[E-voucher] - Monkey Stories (Tặng 3 tháng Monkey Math)- Phần mềm tương tác phát triển toàn diện 4 kỹ năng tiếng Anh cho bé",832000,832000,0,0
TIKI,voucher-dich-vu,122642438,"[E-BOOK] Practice Tests Grade 6 Sách mềm sách học sinh",15000,15000,0,0
TIKI,voucher-dich-vu,25286369,"Tour 3N2Đ Đà Nẵng - Bà Nà - Hội An - Huế, Khách Sạn 3 Sao, Khởi Hành Hàng Ngày",2188000,2188000,0,0
TIKI,voucher-dich-vu,177234572,"Sách nói: Liệu Pháp Tâm Hồn",99000,99000,0,0
TIKI,voucher-dich-vu,181266533,"Tada Việt Nam - Cho Thuê Bộ Phát Wifi Đi Du Lịch Hàn Quốc Không Giới Hạn Tại Hà Nội Và Hồ Chí Minh - 1 Ngày",120000,120000,0,0
TIKI,voucher-dich-vu,42989460,"Gói chăm sóc răng miệng 1 năm cho gia đình - Nha Khoa Gia Hân",3000000,3000000,0,0
TIKI,voucher-dich-vu,178059559,"Sách nói: 9 Lần Khởi Nghiệp - Chuyện Kể Về Những Thất Bại Và Thành Công Của Một Triệu Phú",99000,99000,0,0
TIKI,voucher-dich-vu,262525304,"Phú Quốc [E-Voucher] Tour 3 ĐẢO ĐẸP NHẤT PHÚ QUỐC, Miễn phí chụp ảnh, quay Flycam",400000,400000,0,0
TIKI,voucher-dich-vu,205664190,"[Siêu Hời] Gói 4N3Đ Vinpearl Villa Dành Cho 4 Người Lớn, 4 Trẻ Em, Gồm 9 Bữa Buffet, Vui Chơi Vinwonders Safari, Áp Dụng Toàn Quốc",22800000,22800000,0,0
TIKI,voucher-dich-vu,19948410,"Liệu Trình Trị Mụn Bằng Ánh Sáng Sinh Học Tại Thẩm Mỹ Viện Phương",399000,399000,0,0
TIKI,voucher-dich-vu,179695752,"TOUR 4N3D. HÀNH TRÌNH KHÁM PHÁ PHUKET - PHI PHI. ",11199000,11199000,0,0
TIKI,voucher-dich-vu,184499758,"Sách nói: Hiệu ứng lan truyền",99000,99000,0,0
TIKI,voucher-dich-vu,155110421,"Sách nói: Nghệ Thuật Theo Đuổi Sự Tối Giản",99000,99000,0,0
TIKI,voucher-dich-vu,65119569,"Khóa học Phân tích Kỹ thuật Định giá và Đầu tư Chứng khoán - Tài Chính - Cổ phiếu cùng Chuyên gia từ SSI",3000000,3000000,0,0
TIKI,voucher-dich-vu,252255127,"[Voucher 12 tháng] Bộ công cụ Học - Thi - Hướng nghiệp lớp 10, VitanEdu",600000,600000,0,0
TIKI,voucher-dich-vu,39707908,"1 Trong Các DỊch Vụ Chăm Sóc Thanh Tẩy Body Tại Ấm Brows & Spa",79000,79000,0,0
TIKI,voucher-dich-vu,72099407,"KHÓA HỌC HÀ NỘI - ỨNG DỤNG TABLEAU BI TRONG DOANH NGHIỆP",3900000,3900000,0,0
TIKI,voucher-dich-vu,210165532,"EDUPIA Gói học Trọn Đời - Tiếng anh online Tiểu học và THCS chuẩn bản ngữ",1290000,1290000,0,0
TIKI,voucher-dich-vu,72215318,"KHÓA HỌC HCM - AUTOMATION TESTING",6900000,6900000,0,0
TIKI,voucher-dich-vu,166157116,"Phiếu Quà Tặng KaT Jewelry 30K",28500,30000,1500,5
TIKI,voucher-dich-vu,137249634,"[E-BOOK] New Amanda & Friends 3 File nghe Audio",10000,10000,0,0
TIKI,voucher-dich-vu,252585354,"[Voucher 12 tháng] Bộ công cụ Học - Thi - Hướng nghiệp lớp 2, VitanEdu",375000,375000,0,0
TIKI,voucher-dich-vu,72215490,"KHÓA HỌC LẬP TRÌNH VIÊN JAVASCRIPT",5500000,5500000,0,0
TIKI,voucher-dich-vu,10782316,"Liệu Trình Chăm Sóc Da Định Kỳ Giúp Da Sáng Mịn Tại Rita Homespa",99000,99000,0,0
TIKI,voucher-dich-vu,68481641,"Cộng Cà Phê - Voucher Cộng Cà Phê 30K",30000,30000,0,0
TIKI,voucher-dich-vu,71509349,"Gói Tiếng anh 1 năm_Ứng dụng đọc sách dành cho trẻ em Umbalena",399000,399000,0,0
TIKI,voucher-dich-vu,13102048,"Khóa Luyện Thi Online Tiếng Anh Cambridge PET (B1) ",699000,699000,0,0
TIKI,voucher-dich-vu,67106517,"Chicken Plus - Đùi Gà Chiên Truyền Thống",149000,149000,0,0
TIKI,voucher-dich-vu,181144977,"Vòng tay đá thạch anh tóc đen mệnh thủy, mộc - Ngọc Quý",800000,1140000,340000,30
TIKI,voucher-dich-vu,106393684,"(TẶNG CHỐT VÀ DỤNG CỤ THAY DÂY) Dây Đồng hồ Kim Loại Đúc Đầu cong đầu ôm",150000,150000,0,0
TIKI,voucher-dich-vu,161942149,"Ốp Kính Cường Lực Apple Watch Series 1/2/3/4/5/SE/6 Đủ Size 38mm 40mm 42mm 44mm",52000,52000,0,0
TIKI,voucher-dich-vu,130014524,"Nhẫn xoàn, Phong cách Âu Mỹ, Màu vàng 18K, Chất liệu hợp kim đính Pha lê tinh thể, mẫu Luxi Green 007M, Kèm hộp đựng Cẩm Tú",168000,168000,0,0
TIKI,voucher-dich-vu,77742801,"Đồng hồ dây kim loại thời trang nam Skmei Sk6909, mặt tròn kính cứng kèm lịch ngày sang trọng",99000,99000,0,0
TIKI,voucher-dich-vu,157316575,"Đồng Hồ Nam Dây Nhựa Casio G-Shock GA-2100FR-5ADR Chính Hãng - GA-2100FR-5A",3291750,4389000,1097250,25
TIKI,voucher-dich-vu,59243874,"ĐỒNG HỒ NỮ DÂY DA MẶT VUÔNG THỜI TRANG CAO CẤP",120000,120000,0,0
TIKI,voucher-dich-vu,44866294,"Nhẫn Nam Bản To Loại Bóng Titan Không Rỉ TT 2379 - 1 Cái",87000,87000,0,0
TIKI,voucher-dich-vu,150491033,"Vòng Cẩm Thạch Đỏ đẹp I Size 49mm Vòng tay đỏ đỏ đậm đẹp đeo lên may mắn chuẩn hợp Nữ mệnh Hỏa mệnh Thổ ạ Nữ cân  nặng 45kg -> 51kg đeo vừa tay đẹp xinh tay ạ",550000,1100000,550000,50
TIKI,voucher-dich-vu,26329169,"Vòng chuỗi hạt đeo tay 2 line nữ đá labradorite mài giác 5mm mệnh thủy , kim - Ngọc Quý Gemstones",1239000,1700000,461000,27
TIKI,voucher-dich-vu,32215287,"Nhẫn nam quân đội mỹ -không đen -không rỷ",105000,105000,0,0
TIKI,voucher-dich-vu,147344123,"Nhẫn nữ con công",75000,75000,0,0
TIKI,voucher-dich-vu,8061519,"Đồng Hồ Nam Citizen Dây Da NH8363-14H - Mặt Xám",6485000,6485000,0,0
TIKI,voucher-dich-vu,14884836,"Bông Tai Ngọc Trai Cao Cấp Cỡ Hạt 7x7 Ly - B2352 - Bảo Ngọc Jewelry - Trắng",315000,332000,17000,5
TIKI,voucher-dich-vu,103419257,"Combo Nhẫn Xoàn, Kiểu dáng Ruby, Hợp kim tráng Platin, Hợp Nam Nữ, Phong cách Cung đình, Kèm túi đựng Cung Hỷ - mẫu CrownX.436B",136000,153000,17000,11
TIKI,voucher-dich-vu,152152254,"Vòng Gỗ Huyết Long Tỵ Dậu Sửu - Vòng Tay Tam Hợp Quý Nhân Huyết Rồng - May Mắn Tài Lộc",219000,219000,0,0
TIKI,voucher-dich-vu,172154180,"Vòng thạch anh ưu linh trắng liền khối bản vuông mệnh thủy, kim - Ngọc Quý Gemstones",1999000,2500000,501000,20
TIKI,voucher-dich-vu,87984992,"Nhẫn Dây Xích Khui Bia",6500,6500,0,0
TIKI,voucher-dich-vu,31661608,"Đồng hồ nam dây thép không gỉ Skmei 90TCK58",251750,265000,13250,5
TIKI,voucher-dich-vu,50377999,"Dây Chuyền Vuông Titan Nam Hình Song Long Mạ Vàng 18K + TẶNG LÁ BỒ ĐỀ MAY MẮN TÀI LỘC ĐỂ VÍ ĐIỆN THOẠI",327750,345000,17250,5
TIKI,voucher-dich-vu,184915973,"Vòng Tay Đá Ngọc Cẩm Thạch tự nhiên TR LÝ 49mm x cọng 7,2mm Màu bạch ngọc trắng bóng điểm lý xanh rêu rất là đẹp sang Nữ mệnh Kim, mệnh Thủy năngh 47kg - 51kg đeo đẹp ạ",899000,1798000,899000,50
TIKI,voucher-dich-vu,51933070,"Nhẫn Bạc Nữ - Nhẫn Bạc Nữ Đính Đá Bạc S925 Đơn Giản Phong Cách Hàn Quốc Thiết Kế Dáng Hở Điều Chỉnh Được Cỡ - N2458 - Bảo Ngọc Jewelry",220000,220000,0,0
TIKI,voucher-dich-vu,43936313,"Vòng Chuỗi Mân Côi Đá Thạch Anh Tóc Đen Phối Thánh Giá hạt 12mm, ni50 - Ngọc Qúy Gemstones",1039000,1480000,441000,30
TIKI,voucher-dich-vu,54685037,"Nhẫn Cặp | Nhẫn Đôi Nam Nữ Freesize Thiết Kế Đơn Giản ND2518 (Có thể tùy chỉnh tùy ý theo cỡ tay)",372000,372000,0,0
TIKI,voucher-dich-vu,14998285,"Dây chuyền nam kiểu mì lớn mạ vàng 18k",113000,119000,6000,5
TIKI,voucher-dich-vu,77947555,"Dây chuyền mặt đá cho nam nữ BHDC212",36000,59000,23000,39
TIKI,voucher-dich-vu,106391315,"(TẶNG KÈM CHỐT VÀ DỤNG CỤ THAY DÂY) Dây đồng hồ inox không gỉ size 19mm dạng 5 mắt dây Tissot đầu ôm bo tròn",150000,150000,0,0
TIKI,voucher-dich-vu,20103710,"Vòng Tay Trầm Hương Chỉ Đỏ Thiên Mộc Hương",379000,490000,111000,23
TIKI,voucher-dich-vu,114595314,"Đồng hồ nam quân đội chính hãng KASSAW S15008-1",3285000,3650000,365000,10
TIKI,voucher-dich-vu,49722402,"Nhẫn Nữ Bản To Titan Ko Đen TT 2464",105000,105000,0,0
TIKI,voucher-dich-vu,14903787,"Dây Chuyền Ngọc Trai Cao Cấp DB2354 Cỡ Hạt 12x16 Bảo Ngọc Jewelry",388000,388000,0,0
TIKI,voucher-dich-vu,4407201,"Đồng Hồ thể thao Trẻ Em Chống Nước SKMEI 1061",170000,179000,9000,5
TIKI,voucher-dich-vu,15627807,"Lu thống ngọc cẩm thạch",39130,39130,0,0
TIKI,voucher-dich-vu,72880942,"Đồng hồ nữ thời trang Hàn Quốc mặt nhỏ JW-6337 - Hàng chính hãng",199000,199000,0,0
TIKI,voucher-dich-vu,35233450,"Đồng hồ nam Sunrise 1146SA B [Full Box] - Kính Sapphire, chống xước, chống nước - Dây da cao cấp",2218800,2218800,0,0
TIKI,voucher-dich-vu,78622641,"Nhẫn Bạc Thái | Nhẫn Bạc Thái Hình Sao Cho Nữ N1740 - Bảo Ngọc Jewelry",200000,200000,0,0
TIKI,voucher-dich-vu,45814396,"Mặt dây chuyền hạt đậu cẩm thạch phỉ thúy 1.8cm mệnh hỏa, mộc - Ngọc Quý Gemstones",439000,860000,421000,49
TIKI,voucher-dich-vu,68347055,"Lắc Tay Nữ Bạc Hiểu Minh LTU409 kiềng bạc ta",680000,850000,170000,20
TIKI,voucher-dich-vu,46717935,"Vòng tay đá cẩm thạch xanh lý bản tròn mệnh mộc hỏa - Ni",1599000,2000000,401000,20
TIKI,voucher-dich-vu,68292794,"Dây Và Mặt Dây Chuyền Bạc Hiểu Minh DMD275 phật bà quan âm bồ tát",480000,590000,110000,19
TIKI,tui-vi-nu,86560782,"Túi đeo chéo    Túi vải mini tai thỏ siêu dễ thương thiết kế Hàn Quốc TV05",52000,52000,0,0
TIKI,tui-vi-nu,250692203,"Túi Tote Vải Canvas Có Khóa Phong Cách Hàn Quốc",90160,90160,0,0
TIKI,tui-vi-nu,37652811,"Túi vải đay HELLO WEEKEND",269000,269000,0,0
TIKI,tui-vi-nu,157254351,"Ví Đựng Thẻ Card Holder SAIGON SWAGGER Journal Zip Card Case",230000,230000,0,0
TIKI,tui-vi-nu,184918441,"Túi xách nữ thời trang công sở cao cấp phong cách mới – TN1008",210000,420000,210000,50
TIKI,tui-vi-nu,194456982,"Túi đựng tiền, túi đựng đồ mini phong cách Châu Âu mã 1042 - ĐEN	Túi đựng tiền, túi đựng đồ mini phong cách Châu Âu mã 1042",179000,329000,150000,46
TIKI,tui-vi-nu,182805698,"Túi xách nữ Monogram Canvas ELLY – EL198",1799000,1799000,0,0
TIKI,tui-vi-nu,90163531,"Túi Vải Canvas Đeo Chéo Nhật Bản ️ HOTTREND ️ Túi đeo chéo kẻ caro mini nữ thời trang tặng sticker TN76",69000,69000,0,0
TIKI,tui-vi-nu,136940137,"TÚI THỔ CẨM ĐEO CHÉO ĐỰNG ĐIỆN THOẠI",15000,15000,0,0
TIKI,tui-vi-nu,70906430,"Túi cói xách tay kiểu dáng vintage",189000,189000,0,0
TIKI,tui-vi-nu,128291458,"Phụ kiện hoạt hình gắn túi , balo",6000,6000,0,0
TIKI,tui-vi-nu,57100783,"Túi xách nữ kiểu dáng trẻ trung SW48",149000,149000,0,0
TIKI,tui-vi-nu,77548527,"Túi Đeo chéo nữ gấu thời trang cho bé hình chuột GG01 Tặng móc khóa thỏ trắng",58410,79827,21417,27
TIKI,tui-vi-nu,209414012,"Túi xách nữ thời trang hottrend siêu xinh đeo chéo ngang nhiều màu tôn dáng giá rẻ",181000,181000,0,0
TIKI,tui-vi-nu,8114416,"Túi Xách Nữ Cao Cấp Da Thật Elly ET79",1689350,2599000,909650,35
TIKI,tui-vi-nu,158720856,"Túi đeo chéo da nữ thời trang Hàn Quốc DT135TI",99000,99000,0,0
TIKI,tui-vi-nu,42125853,"Túi đeo nữ mini H0001",39000,70000,31000,44
TIKI,tui-vi-nu,74463160,"Ví Đựng Thời Trang Tiện Ich HARAS V268",35000,35000,0,0
TIKI,tui-vi-nu,152951458,"Túi Cói, Túi Trụ Hoa và Túi Trụ Lủng Lẳng",265000,265000,0,0
TIKI,tui-vi-nu,157479189,"ví bóp nữ cầm tay nhiều ngăn dáng dài sang trọng đi tiệc cưới - PL9283",138000,259000,121000,47
TIKI,tui-vi-nu,52890054,"Ví Nữ Ngắn Thời Trang Cao Cấp HNN20-Tặng Kèm 01 Sản Phẩm Ngẫu Nhiên",99000,99000,0,0
TIKI,tui-vi-nu,13090538,"Túi đựng điện thoại 2 dây đeo đẹp cho bạn gái",59000,59000,0,0
TIKI,tui-vi-nu,44148141,"Túi Vải Tote Canvas Cao Cấp, Dày Dặn Hình Hoa Cúc Họa Mi, Phong Cách Basic",88900,88900,0,0
TIKI,tui-vi-nu,191995263,"Vỏ bao hộ chiếu (passport) dẻo trong có khe đựng vé máy bay và các thoại thẻ hiệu bamarau B132",2999,2999,0,0
TIKI,tui-vi-nu,11186154,"Túi đeo vai ANELLO đeo 2 kiểu vải polyester chịu nhiệt cỡ nhỏ AT-C1839 - Màu",1840000,1840000,0,0
TIKI,tui-vi-nu,177594039,"Ví đựng hộ chiếu Passport giấy tờ xe, thẻ thời trang chất liệu da bò cao cấp 40596",177651,177651,0,0
TIKI,tui-vi-nu,107962577,"Ví Đựng Thẻ/ Ví Da Mini Handmade Đựng Tiền Sành Điệu Sang Chảnh",99000,99000,0,0
TIKI,tui-vi-nu,112210007,"Túi đeo chéo nữ công sở cao cấp họa tiết sang trọng nhiều ngăn tặng kèm móc gấu",159000,159000,0,0
TIKI,tui-vi-nu,209414357,"Ví bóp nữ cầm tay da trơn mềm xinh xắn dễ phối đồ cobala ví túi xinh",141000,141000,0,0
TIKI,tui-vi-nu,113039984,"Túi đeo chéo nữ công sở dạo phố thời trang cao cấp",99000,99000,0,0
TIKI,tui-vi-nu,104944481,"Túi đeo chéo đi học, đi làm, đi chơi thời trang dành cho nữ TUI005",113050,119000,5950,5
TIKI,tui-vi-nu,125100701,"Ví Cầm Tay Kim Tuyến Đi Tiệc chodeal24h.com (Vàng gold)",59000,59000,0,0
TIKI,tui-vi-nu,114358110,"Túi xách túi đeo chéo nữ khóa dây da dây xích phối đẹp mắt",75000,75000,0,0
TIKI,tui-vi-nu,169354370,"Clutch nhung đính đá tua rua cao cấp-túi nhung đá đi tiệc siêu sang",320000,320000,0,0
TIKI,tui-vi-nu,248990778,"Dây kéo 1 chiều răng 5 (không kèm đầu khóa)",40000,40000,0,0
TIKI,tui-vi-nu,174399995,"Túi Đeo Chéo Nữ Đựng Điện Thọai FOREVER YOUNG Dáng Vuông Nhiều Ngăn Đựng Chất Bền Đẹp FY15",249000,249000,0,0
TIKI,tui-vi-nu,247745940,"Túi Xách Nữ ️️ Túi Nữ Da Mềm Luxury thời trang, phong cách trẻ trung mã số LXRBB0012",79000,79000,0,0
TIKI,tui-vi-nu,149764208,"Túi xách nữ đeo chéo họa tiết hoa văn độc đáo thời trang cao cấp phong cách Hàn Quốc",139000,139000,0,0
TIKI,tui-vi-nu,188385295,"Túi xách nữ Da Bò 100% Cao Câp  Vừa Túi đeo chéo, Cầm Tay - Thời trang Nhật Bản và Hàn Quốc kết hợp sản xuất ",756000,756000,0,0
TIKI,tui-vi-nu,183243463,"Túi Tote canvas - Hoa ghi - thêu tay thủ công, nữ tính, gọn nhẹ",325000,325000,0,0
TIKI,dong-ho-va-trang-suc,46301639,"Nhẫn Nam Chữ Tài Mạ Vàng 18k - Tặng Kèm Hộp Trang Sức",84000,94000,10000,11
TIKI,dong-ho-va-trang-suc,15682093,"Đồng hồ nam chính hãng LOBINNI L13022-1 hàng mới 100%,Kính sapphire ,chống xước,chống nước 50m,mặt trắng vỏ vàng hồng dây da nâu xịn, thép không gỉ 316L,Đồng hồ cơ (Automatic) bảo hành 24 tháng, Mới 100%,thiết kế đơn giản trẻ trung và sang trọng",5895000,6550000,655000,10
TIKI,dong-ho-va-trang-suc,13366657,"ĐỒNG HỒ NỮ JA-1017D JULIUS HÀN QUỐC DÂY DA",599000,599000,0,0
TIKI,dong-ho-va-trang-suc,179781740,"Đồng Hồ Casio W-218HC-2AVDF Dây Nhựa Nam - Mặt Vuông - WR50M",678400,848000,169600,20
TIKI,dong-ho-va-trang-suc,137938136,"Dây đeo cho Miband 6, Mi band 5/ 4/ 3 - bản Plus, chốt gài (DMJG6)",120000,120000,0,0
TIKI,dong-ho-va-trang-suc,126022080,"Vòng tay gỗ Trắc Đen / Đỏ màu tự nhiên (BH686) Phong Thủy - Tài Lộc - Bracelet of HAHANCO",35000,35000,0,0
TIKI,dong-ho-va-trang-suc,112887210,"Đồng hồ nam LOBINNI Ref.1023-11 Chính Hãng Thụy Sỹ ,Hàng mới 100%,Kính sapphire nguyên khối,chống xước,Chống nước 50m,dây da xịn,Máy cơ( Automatic),Bảo hành 24 tháng,",3465000,3850000,385000,10
TIKI,dong-ho-va-trang-suc,2775543,"Đồng hồ Nam thể thao SKMEI 1243 - DHA509",142000,245000,103000,42
TIKI,dong-ho-va-trang-suc,67332965,"Nhẫn Hổ Phách Baltic Xanh Lá",1168400,1270000,101600,8
TIKI,dong-ho-va-trang-suc,44237915,"CUỘN DÂY THUN CO GIÃN ĐỘ DẦY CUỘN THUN 1MM  MÀU VÀNG VÀNG TƯƠI  XỎ VÒNG TAY GỖ NAM ",65000,130000,65000,50
TIKI,dong-ho-va-trang-suc,176789842,"Đôi Bông Tai Hoa Mai Trái Tim kiểu mới đẹp Ngang 12mm x Dầy 3mm Đá Ngọc cẩm thạch tự nhiên xanh ngọc bóng đẹp Nữ mệnh Thủy Mộc Hỏa bọc vàng đeo rất đẹp sang ạ",480000,960000,480000,50
TIKI,dong-ho-va-trang-suc,50303791,"Nhẫn Bạc Ngọc Trai Thật Cho Nữ - Nhẫn Ngọc Trai Bạc Nữ Thời Trang N1404 Bảo Ngọc Jewelry (Ngọc trai nước ngọt tự nhiên, Bạc s925 tinh khiết)",556000,556000,0,0
TIKI,dong-ho-va-trang-suc,121026888,"Mặt Phật Bản Mệnh-Vòng Tay Trầm Hương Tốc-Theo Tuổi-Theo Mệnh-Lạc Việt Trầm Hương",408000,408000,0,0
TIKI,dong-ho-va-trang-suc,22939347,"Dây Chuyền Nam Mặt Sư Tử Mạ Vàng 24k MD76",280000,295000,15000,5
TIKI,dong-ho-va-trang-suc,20779252,"Vòng Tay Phong Thủy Nữ Đá Ruby Phối Charm Hoa Hướng Dương Bạc (6mm) Mệnh Hỏa, Thổ Ngọc Quý Gemstones",1599000,1998000,399000,20
TIKI,dong-ho-va-trang-suc,36530088,"Đồng hồ Nam chính hãng SKMEI RB9069, mặt số 3D, chống nước, kèm hộp da bảo quản cao cấp",260000,274000,14000,5
TIKI,dong-ho-va-trang-suc,109487942,"Đồng Hồ Nam Điện Tử Casio CA-53WF-3BDF Dây Nhựa",753000,1004000,251000,25
TIKI,dong-ho-va-trang-suc,105230905,"Hoa tai nam nữ titanium không cần bấm lỗ vẫn đeo được cao cấp",15000,15000,0,0
TIKI,dong-ho-va-trang-suc,89878957,"Bông tai nữ bằng bạc khuyên nụ MS67g",118000,118000,0,0
TIKI,dong-ho-va-trang-suc,99909672,"Dây chuyền bạc nam 15 chỉ MS01",1700000,1700000,0,0
TIKI,dong-ho-va-trang-suc,14439656,"Đồng hồ nữ dây nhựa Casio LA-20WH-4ADF",579200,724000,144800,20
TIKI,dong-ho-va-trang-suc,186638903,"Đồng Hồ Nam Dây Nhựa Casio Standard WS-1400H-1AVDF Chính Hãng - WS-1400H-1A Pin 10 Năm",886500,1182000,295500,25
TIKI,dong-ho-va-trang-suc,22011731,"Lắc tay nữ kiểu lặc mạ",189000,189000,0,0
TIKI,dong-ho-va-trang-suc,63448475,"Đồng hồ nam Dây Da SRWATCH SG3004.4602CV",875000,1250000,375000,30
TIKI,dong-ho-va-trang-suc,66792697,"CHIẾC VÒNG TAY NỮ LÝ SỊN SAO 55MM HÀNG CAO CẤP 100% CẨM THẠCH THIÊN NHIÊN XANH NGỌC ĐẬM VÂN RẤT SANG NỮ 55KG ĐẾN 65KG",2500000,5000000,2500000,50
TIKI,dong-ho-va-trang-suc,66591120,"Đồng hồ Casio Nam G Shock GW-B5600DC-1DR",4769000,4769000,0,0
TIKI,dong-ho-va-trang-suc,118775350,"Vòng Tay Nữ Bạc S925 Hồ Điệp Đá Sapphire Xanh Sáng Trọng L2563 - Bảo Ngọc Jewelry",450000,450000,0,0
TIKI,dong-ho-va-trang-suc,104126675,"Dây đồng hồ da bò chịu nước size 20 và 22 có chốt thông minh",174000,174000,0,0
TIKI,dong-ho-va-trang-suc,93142925,"Bông tai nữ chất liệu bạc 925 treo bi cầu MS75h",118000,118000,0,0
TIKI,dong-ho-va-trang-suc,102552161,"Bông tai hoa lá con ong tươi tắn S925",89000,89000,0,0
TIKI,dong-ho-va-trang-suc,177771434,"Lắc tay vàng 14k LLF135 Huy Thanh Jewelry",3127000,3127000,0,0
TIKI,dong-ho-va-trang-suc,102142443,"Lắc tay bạc kim tiền mặt cỏ 4 lá MS115",203000,203000,0,0
TIKI,dong-ho-va-trang-suc,155045131,"Đồng Hồ Nam Casio G-Shock Nam GA-100A-9A Vỏ Vàng Chính Hãng",3184000,3184000,0,0
TIKI,dong-ho-va-trang-suc,99494956,"100 viên bi bạc ta 5li mix vòng",380000,380000,0,0
TIKI,dong-ho-va-trang-suc,42688426,"Set 5 Vòng đeo tay phản quang đan len nam nữ phong cách siêu hot V14",75000,75000,0,0
TIKI,dong-ho-va-trang-suc,66394678,"Đồng hồ Casio Nam G Shock GBX-100-2DR",5721000,5721000,0,0
TIKI,dong-ho-va-trang-suc,20280968,"Dây đeo vòng cổ 3mm",14200,14200,0,0
TIKI,dong-ho-va-trang-suc,95859401,"Dây chuyền nữ mặt trái tim chất liệu bạc Ý MS13b",226000,226000,0,0
TIKI,dong-ho-va-trang-suc,22434506,"Đồng Hồ Nam Orient FUNG2001F0",2175000,2900000,725000,25
TIKI,dong-ho-va-trang-suc,36368958,"Nhẫn cặp đôi bạc LOVE - Trang sức Panmila (ND.A6.B)",70000,70000,0,0
TIKI,tui-thoi-trang-nam,133900168," Ví nam da bò thật VO 031005",165000,320000,155000,48
TIKI,tui-thoi-trang-nam,147326633,"Cặp đa năng - Loại dày - cho học sinh giáo viên công sở, Cặp Laptop 5.0 VSTYLE (Văn phòng phẩm giá sỉ)",399000,399000,0,0
TIKI,tui-thoi-trang-nam,193044239,"Túi xách nam công sở da bò thật tích hợp khóa chống trộm cao cấp",882000,980000,98000,10
TIKI,tui-thoi-trang-nam,51147505,"Túi đeo ngực,đeo chéo nam đã tích hợp công nghệ 4.0",529000,799000,270000,34
TIKI,tui-thoi-trang-nam,10583890,"Túi Đeo Chéo Nam Chống Trộm",111000,111000,0,0
TIKI,tui-thoi-trang-nam,19707078,"Túi đeo hông nam du lịch, phượt",157500,157500,0,0
TIKI,tui-thoi-trang-nam,14062664,"Cặp Da Nam Công Sở KG001",299500,599000,299500,50
TIKI,tui-thoi-trang-nam,97644482,"Túi đeo chéo nam VPC kiểu ngang bóng trơn VF47 Tặng móc khóa hình khiên",82067,112158,30091,27
TIKI,tui-thoi-trang-nam,102012371,"Túi đeo chéo nam nữ chất liệu vải chống thấm nước phong cách Hàn Quốc - Túi bao tử Unisex TC06",76230,104181,27951,27
TIKI,tui-thoi-trang-nam,137499373,"Bóp Ví Nam Da Bò Cao Cấp Vân Cá Sấu Gù Nguyên Con Ví Đứng màu đen,màu nâu Viền khâu thủ công sang Trọng Bảo Hành 12 TH",175000,175000,0,0
TIKI,tui-thoi-trang-nam,169278770,"ví nam AD009, bóp nam da bò nappa cao cấp, ví da nam ví ngang thiết kế nhiều ngăn đựng tiền đựng thẻ, bảo hành da 6 tháng - Adonis Store",169000,269000,100000,37
TIKI,tui-thoi-trang-nam,93878483,"Túi đeo chéo thông minh Divoom Pixoo Slingbag hiển thị màn hình Led, tích hợp app Divoom",1590000,1950000,360000,18
TIKI,tui-thoi-trang-nam,164554647,"Túi Đeo Chéo Nam, Túi Chéo Nam Đi Chơi Chất Đẹp, Túi Xách Nam, Túi Đeo Chéo Nhiều Màu, Thời Trang Siêu Chất - OTV164 - Ope Store",250000,250000,0,0
TIKI,balo-va-vali,170498952,"Bóp đựng tiền nhiều ngăn Simple Vertical Wallet V3 chính hãng NATOLI cầm tay kháng nước cao cấp",179000,256000,77000,30
TIKI,tui-thoi-trang-nam,157434406,"Túi Đeo Chéo Da Nam 4U Thời Trang Cá Tính D276",199000,220000,21000,10
TIKI,balo-va-vali,14062664,"Cặp Da Nam Công Sở KG001",299500,599000,299500,50
TIKI,balo-va-vali,102012371,"Túi đeo chéo nam nữ chất liệu vải chống thấm nước phong cách Hàn Quốc - Túi bao tử Unisex TC06",76230,104181,27951,27
TIKI,tui-thoi-trang-nam,67451818,"Túi Nam 4U Da Tổng Hợp Công Sở Sang Trọng DN269 (đen-nâu)",169000,195000,26000,13
TIKI,tui-thoi-trang-nam,170498952,"Bóp đựng tiền nhiều ngăn Simple Vertical Wallet V3 chính hãng NATOLI cầm tay kháng nước cao cấp",179000,256000,77000,30
TIKI,balo-va-vali,164338907,"Túi đeo chéo đeo ngực nam cao cấp phong cách châu âu",603000,670000,67000,10
TIKI,tui-thoi-trang-nam,148966755,"Bóp Da Nam, Ví Da Nam Đựng Tiền Nhiều Ngăn Tiện Lợi - Dòng Cao Cấp 2 Kiểu Dáng Ngang Và Đứng",85000,85000,0,0
TIKI,balo-va-vali,155339338,"Ví đựng thẻ da bò sáp ngựa điên Crazyhorse V117 cao cấp, card holder da thật, đường chỉ may tinh tế, ví mini nam nhỏ gọn, đựng thẻ tiện lợi, fullbox, thương hiệu Bụi leather chuyên đồ da thật",130000,205000,75000,37
TIKI,balo-va-vali,67451818,"Túi Nam 4U Da Tổng Hợp Công Sở Sang Trọng DN269 (đen-nâu)",169000,195000,26000,13
TIKI,balo-va-vali,184517203,"Túi đeo chéo nam cao cấp phong cách mới",288000,320000,32000,10
TIKI,balo-va-vali,19707078,"Túi đeo hông nam du lịch, phượt",157500,157500,0,0
TIKI,tui-thoi-trang-nam,188997575,"Bao da dành cho Chìa Khóa Smartkey Yamaha NVX, Janus, Nozza Grande, FreeGo, Latte, Exciter 155 VVA handmade da thật",99000,99000,0,0
TIKI,balo-va-vali,97644482,"Túi đeo chéo nam VPC kiểu ngang bóng trơn VF47 Tặng móc khóa hình khiên",82067,112158,30091,27
TIKI,balo-va-vali,87858835,"Túi đeo chéo nam nữ siêu đẹp siêu sang - Mã 8596",289000,499000,210000,42
TIKI,tui-thoi-trang-nam,76448408,"Túi xách nam công sở cao cấp phong cách mới",423000,470000,47000,10
TIKI,balo-va-vali,44336401,"Túi đeo chéo nam nữ unisex du lịch thời trang Hàn quốc BEE GEE cao cấp đẹp giá rẻ - XAM",50000,100000,50000,50
TIKI,tui-thoi-trang-nam,164338907,"Túi đeo chéo đeo ngực nam cao cấp phong cách châu âu",603000,670000,67000,10
TIKI,balo-va-vali,133900168," Ví nam da bò thật VO 031005",165000,320000,155000,48
TIKI,balo-va-vali,76448408,"Túi xách nam công sở cao cấp phong cách mới",423000,470000,47000,10
TIKI,tui-thoi-trang-nam,155339338,"Ví đựng thẻ da bò sáp ngựa điên Crazyhorse V117 cao cấp, card holder da thật, đường chỉ may tinh tế, ví mini nam nhỏ gọn, đựng thẻ tiện lợi, fullbox, thương hiệu Bụi leather chuyên đồ da thật",130000,205000,75000,37
TIKI,tui-thoi-trang-nam,87858835,"Túi đeo chéo nam nữ siêu đẹp siêu sang - Mã 8596",289000,499000,210000,42
TIKI,balo-va-vali,173343742,"Ví Nam Ngang Cao Cấp Sang Trọng, Chất Liệu Bền Đẹp, Ví Da Nam, Ví Nam Cầm Tay Nhiều Ngăn Tiện Lợi - Hàng chính hãng",32000,180000,148000,82
TIKI,balo-va-vali,148966755,"Bóp Da Nam, Ví Da Nam Đựng Tiền Nhiều Ngăn Tiện Lợi - Dòng Cao Cấp 2 Kiểu Dáng Ngang Và Đứng",85000,85000,0,0
TIKI,tui-thoi-trang-nam,184517203,"Túi đeo chéo nam cao cấp phong cách mới",288000,320000,32000,10
TIKI,balo-va-vali,157434406,"Túi Đeo Chéo Da Nam 4U Thời Trang Cá Tính D276",199000,220000,21000,10
TIKI,balo-va-vali,155339755,"Ví sen 3 PLUS da bò Pullup V123, bóp mini nam nhỏ gọn hai màu đen và nâu, đường chỉ may tinh tế, đựng thẻ kẹp tiền tiện lợi, fullbox, thương hiệu Bụi leather chuyên đồ da thật",160000,278000,118000,42
TIKI,tui-thoi-trang-nam,109389766,"Túi xách nam công sở da tự nhiên cao cấp phong cách mới",423000,470000,47000,10
TIKI,balo-va-vali,10583890,"Túi Đeo Chéo Nam Chống Trộm",111000,111000,0,0
TIKI,tui-thoi-trang-nam,167443834,"Túi đeo chéo nam 100% da bò thật cao cấp phong cách mới",477000,530000,53000,10
TIKI,tui-thoi-trang-nam,117401394,"Ví Đựng Thẻ ATM Mini, Da Bò Mềm Mại GENTLE, Da Thật 100%, Thiết Kế Hiện Đại, Nhiều Ngăn Tiện Dụng, Đựng Thẻ Ngân Hàng, Danh Thiếp, Căn Cước, Hình Lưu Niệm, Dáng Đứng - Gập 2 - Hàng Chính Hãng SAIGIO",629000,649000,20000,3
TIKI,balo-va-vali,75616814,"Túi đeo chéo nam tích hợp khóa chống trộm và chống thấm nước cao cấp phong cách mới",423000,470000,47000,10
TIKI,balo-va-vali,147326633,"Cặp đa năng - Loại dày - cho học sinh giáo viên công sở, Cặp Laptop 5.0 VSTYLE (Văn phòng phẩm giá sỉ)",399000,399000,0,0
TIKI,tui-thoi-trang-nam,184123552,"Túi xách nam thời trang công sở chống thấm nước cao cấp",450000,499000,49000,10
TIKI,tui-thoi-trang-nam,173343742,"Ví Nam Ngang Cao Cấp Sang Trọng, Chất Liệu Bền Đẹp, Ví Da Nam, Ví Nam Cầm Tay Nhiều Ngăn Tiện Lợi - Hàng chính hãng",32000,180000,148000,82
TIKI,balo-va-vali,155330335,"Ví da nam, bóp da nam mini Bụi Leather V115 - Da bò Nappa cao cấp - Bảo hành 12 tháng",180000,278000,98000,35
TIKI,balo-va-vali,164554647,"Túi Đeo Chéo Nam, Túi Chéo Nam Đi Chơi Chất Đẹp, Túi Xách Nam, Túi Đeo Chéo Nhiều Màu, Thời Trang Siêu Chất - OTV164 - Ope Store",250000,250000,0,0
TIKI,balo-va-vali,117401394,"Ví Đựng Thẻ ATM Mini, Da Bò Mềm Mại GENTLE, Da Thật 100%, Thiết Kế Hiện Đại, Nhiều Ngăn Tiện Dụng, Đựng Thẻ Ngân Hàng, Danh Thiếp, Căn Cước, Hình Lưu Niệm, Dáng Đứng - Gập 2 - Hàng Chính Hãng SAIGIO",629000,649000,20000,3
TIKI,balo-va-vali,58563589,"Cặp Công Sở Đa Năng TRITA TCA6",369000,660000,291000,44
TIKI,balo-va-vali,44044210,"Cặp công sở thời trang CAYUUMY06",235000,390000,155000,40
TIKI,tui-thoi-trang-nam,125037676,"Ví nam, bóp nam da bò Nappa Bụi Leather V104 - Bảo hành 12 tháng",209000,370000,161000,44
TIKI,tui-thoi-trang-nam,58563589,"Cặp Công Sở Đa Năng TRITA TCA6",369000,660000,291000,44
TIKI,tui-thoi-trang-nam,93151621,"Túi Đeo Chéo Nam Thời Trang Vải Bố Canvas Cao Cấp Dạng Hộp Chống Thấm Nước, Du Lịch, Đi Học, Đi Chơi",60000,69000,9000,13
TIKI,balo-va-vali,102012570,"Túi đeo chéo nam mini vải canvas bền bỉ phong cách unisex Hàn Quốc TC02",198000,198000,0,0
TIKI,balo-va-vali,169278770,"ví nam AD009, bóp nam da bò nappa cao cấp, ví da nam ví ngang thiết kế nhiều ngăn đựng tiền đựng thẻ, bảo hành da 6 tháng - Adonis Store",169000,269000,100000,37
TIKI,tui-thoi-trang-nam,44336401,"Túi đeo chéo nam nữ unisex du lịch thời trang Hàn quốc BEE GEE cao cấp đẹp giá rẻ - XAM",50000,100000,50000,50
TIKI,balo-va-vali,125037676,"Ví nam, bóp nam da bò Nappa Bụi Leather V104 - Bảo hành 12 tháng",209000,370000,161000,44
TIKI,tui-thoi-trang-nam,155330335,"Ví da nam, bóp da nam mini Bụi Leather V115 - Da bò Nappa cao cấp - Bảo hành 12 tháng",180000,278000,98000,35
TIKI,balo-va-vali,51147505,"Túi đeo ngực,đeo chéo nam đã tích hợp công nghệ 4.0",529000,799000,270000,34
TIKI,balo-va-vali,193044239,"Túi xách nam công sở da bò thật tích hợp khóa chống trộm cao cấp",882000,980000,98000,10
TIKI,tui-thoi-trang-nam,155339755,"Ví sen 3 PLUS da bò Pullup V123, bóp mini nam nhỏ gọn hai màu đen và nâu, đường chỉ may tinh tế, đựng thẻ kẹp tiền tiện lợi, fullbox, thương hiệu Bụi leather chuyên đồ da thật",160000,278000,118000,42
TIKI,tui-thoi-trang-nam,67299408,"Túi đeo chéo nam da bò cao cấp YILIDAISHU T32 27x25x6cm(Nâu - Đen)",299000,299000,0,0
TIKI,tui-thoi-trang-nam,125289842,"Ví nam, bóp nam da bò Saffiano Bụi Leather V140 - Bảo hành 12 tháng",215000,412000,197000,48
TIKI,balo-va-vali,109389766,"Túi xách nam công sở da tự nhiên cao cấp phong cách mới",423000,470000,47000,10
TIKI,balo-va-vali,93878483,"Túi đeo chéo thông minh Divoom Pixoo Slingbag hiển thị màn hình Led, tích hợp app Divoom",1590000,1950000,360000,18
TIKI,balo-va-vali,137499373,"Bóp Ví Nam Da Bò Cao Cấp Vân Cá Sấu Gù Nguyên Con Ví Đứng màu đen,màu nâu Viền khâu thủ công sang Trọng Bảo Hành 12 TH",175000,175000,0,0
TIKI,tui-thoi-trang-nam,77747266,"Túi đeo chéo vải canvas cao cấp phong cách mới",269000,298000,29000,10
TIKI,tui-thoi-trang-nam,102012570,"Túi đeo chéo nam mini vải canvas bền bỉ phong cách unisex Hàn Quốc TC02",198000,198000,0,0
TIKI,balo-va-vali,67299408,"Túi đeo chéo nam da bò cao cấp YILIDAISHU T32 27x25x6cm(Nâu - Đen)",299000,299000,0,0
TIKI,balo-va-vali,167443834,"Túi đeo chéo nam 100% da bò thật cao cấp phong cách mới",477000,530000,53000,10
TIKI,tui-thoi-trang-nam,44044210,"Cặp công sở thời trang CAYUUMY06",235000,390000,155000,40
TIKI,balo-va-vali,188997575,"Bao da dành cho Chìa Khóa Smartkey Yamaha NVX, Janus, Nozza Grande, FreeGo, Latte, Exciter 155 VVA handmade da thật",99000,99000,0,0
TIKI,tui-thoi-trang-nam,75616814,"Túi đeo chéo nam tích hợp khóa chống trộm và chống thấm nước cao cấp phong cách mới",423000,470000,47000,10
TIKI,balo-va-vali,93151621,"Túi Đeo Chéo Nam Thời Trang Vải Bố Canvas Cao Cấp Dạng Hộp Chống Thấm Nước, Du Lịch, Đi Học, Đi Chơi",60000,69000,9000,13
TIKI,balo-va-vali,125289842,"Ví nam, bóp nam da bò Saffiano Bụi Leather V140 - Bảo hành 12 tháng",215000,412000,197000,48
TIKI,balo-va-vali,184123552,"Túi xách nam thời trang công sở chống thấm nước cao cấp",450000,499000,49000,10
TIKI,balo-va-vali,77747266,"Túi đeo chéo vải canvas cao cấp phong cách mới",269000,298000,29000,10
TIKI,tui-vi-nu,79965375,"Túi đeo chéo nữ thời trang kiểu dáng Hàn Quốc chất vải mềm mại chống nước TN131",99000,99000,0,0
TIKI,tui-vi-nu,177238136,"Túi xách nữ thời trang công sở cao cấp phong cách mới",423000,470000,47000,10
TIKI,tui-vi-nu,205081399,"Túi xách nữ công sở đeo chéo kẹp nách đeo vai tote da thời trang cao cấp MX078",789000,789000,0,0
TIKI,tui-vi-nu,109242515,"Túi đeo chéo thời trang Unisex Zakomi vải cao cấp chống thấm nước ZTDC001 - Bảo hành 12 tháng",199000,199000,0,0
TIKI,tui-vi-nu,100000538,"Túi xách nữ da mểm cao cấp",380000,380000,0,0
TIKI,tui-vi-nu,85137894," MERCI Túi cói thời trang Merci chuẩn loại 1",44000,47000,3000,6
TIKI,tui-vi-nu,160648292,"Túi xách nữ công sở dáng ngang cao cấp YUUMY YTX21",205000,420000,215000,51
TIKI,tui-vi-nu,203913255,"Túi Xách Nữ Đeo Chéo Đeo Vai Quảng Châu Cao Cấp Đi Học Đi Chơi Siêu Xinh TUVIDA_VN TX18 Túi Tote",183750,183750,0,0
TIKI,voucher-dich-vu,205081399,"Túi xách nữ công sở đeo chéo kẹp nách đeo vai tote da thời trang cao cấp MX078",789000,789000,0,0
TIKI,tui-vi-nu,144515523,"Túi xách da nữ đa năng LATA TX10",490000,490000,0,0
TIKI,tui-vi-nu,177859868,"túi đeo chéo nữ,túi đeo vai thời trang phong cách đơn giản dễ phối đồ phù hợp với mọi lứa tuổi (hình ảnh shop tự chụp cam kết 100%)",167000,167000,0,0
TIKI,tui-vi-nu,164348896,"Túi xách nữ, Túi đeo chéo nữ T05 da cao cấp thời trang công sở",170700,170700,0,0
TIKI,voucher-dich-vu,100000538,"Túi xách nữ da mểm cao cấp",380000,380000,0,0
TIKI,tui-vi-nu,249457427,"Túi Xách Nữ Đựng Vừa A4 Thanh Lịch Sang Trọng ZTX04",169000,315000,146000,46
TIKI,tui-vi-nu,172377943,"Ví nữ mini nắp cách điệu YUUMY Seasand YV59",75000,150000,75000,50
TIKI,voucher-dich-vu,203913255,"Túi Xách Nữ Đeo Chéo Đeo Vai Quảng Châu Cao Cấp Đi Học Đi Chơi Siêu Xinh TUVIDA_VN TX18 Túi Tote",183750,183750,0,0
TIKI,tui-vi-nu,193720405,"VÍ CẦM TAY NAM HỌA TIẾT DA CÁ SẤU",450000,450000,0,0
TIKI,tui-vi-nu,79270437,"Túi đeo chéo nữ thời trang cao cấp Hàn Quốc TN116",99000,99000,0,0
TIKI,voucher-dich-vu,177859868,"túi đeo chéo nữ,túi đeo vai thời trang phong cách đơn giản dễ phối đồ phù hợp với mọi lứa tuổi (hình ảnh shop tự chụp cam kết 100%)",167000,167000,0,0
TIKI,tui-vi-nu,206651826,"Ví Đựng Thẻ Card Holder Nam Nữ Songhan Leather WL01.Ví MiNi Da Bò Thật Cao Cấp Nhỏ Gọn Gập Đôi Nhiều Ngăn Thời Trang",259000,259000,0,0
TIKI,tui-vi-nu,174469000,"Ví Nữ Mini Cầm Tay PERFECT FOR YOU Dáng Ngắn Nhiều Ngăn Tiện Dụng Chất Da Xước Cao Cấp Cực Đẹp PFY04",149000,149000,0,0
TIKI,voucher-dich-vu,249457427,"Túi Xách Nữ Đựng Vừa A4 Thanh Lịch Sang Trọng ZTX04",169000,315000,146000,46
TIKI,tui-vi-nu,57173375,"Ví đựng thẻ thời trang cao cấp CL-022",99000,99000,0,0
TIKI,voucher-dich-vu,193720405,"VÍ CẦM TAY NAM HỌA TIẾT DA CÁ SẤU",450000,450000,0,0
TIKI,tui-vi-nu,186650070,"Túi xách nữ thời trang cong sở cao cấp",387000,430000,43000,10
TIKI,tui-vi-nu,200671780,"TÚI XÁCH DA NỮ ĐEO VAI KHÓA KÉO LIBERAL YLYN134",200000,200000,0,0
TIKI,voucher-dich-vu,206651826,"Ví Đựng Thẻ Card Holder Nam Nữ Songhan Leather WL01.Ví MiNi Da Bò Thật Cao Cấp Nhỏ Gọn Gập Đôi Nhiều Ngăn Thời Trang",259000,259000,0,0
TIKI,tui-vi-nu,136940059,"TÚI THỔ CẨM ĐEO CHÉO ĐỰNG ĐIỆN THOẠI",15000,15000,0,0
TIKI,tui-vi-nu,114119999,"Ví nữ mini hoạt hình cao cấp ngắn cute nhỏ gọn đựng tiền thẻ căn cước bỏ túi thời trang tiện lợi giá rẻ",76000,76000,0,0
TIKI,tui-vi-nu,173169248,"Túi Cói, Túi Cói Đi Biển, Giỏ Cói, Giỏ Lục Bình Quai Mây Sang Trọng-Thủ Công Mỹ Nghệ Cao Cấp",295000,295000,0,0
TIKI,voucher-dich-vu,57173375,"Ví đựng thẻ thời trang cao cấp CL-022",99000,99000,0,0
TIKI,voucher-dich-vu,200671780,"TÚI XÁCH DA NỮ ĐEO VAI KHÓA KÉO LIBERAL YLYN134",200000,200000,0,0
TIKI,tui-vi-nu,12275060,"Balo nữ thời trang cao cấp ELLY EBH26",699300,999000,299700,30
TIKI,tui-vi-nu,35346241,"Clutch tiệc cầm tay phong cách sao Hàn",230000,230000,0,0
TIKI,voucher-dich-vu,173169248,"Túi Cói, Túi Cói Đi Biển, Giỏ Cói, Giỏ Lục Bình Quai Mây Sang Trọng-Thủ Công Mỹ Nghệ Cao Cấp",295000,295000,0,0
TIKI,tui-vi-nu,67070321,"Túi xách đeo chéo nữ vải dù chống nước cao cấp",109000,109000,0,0
TIKI,tui-vi-nu,16018257,"Ví da bò Vinalea VUN0006E",155000,155000,0,0
TIKI,voucher-dich-vu,35346241,"Clutch tiệc cầm tay phong cách sao Hàn",230000,230000,0,0
TIKI,tui-vi-nu,164961179,"Túi đeo chéo, đeo vai nữ mini da cao cấp T0229 Khóa gài chống thấm nước, bền bỉ phong cách thời trang Hàn",130000,260000,130000,50
TIKI,tui-vi-nu,187328731,"Bao bọc thẻ căn cước, thẻ ATM, thẻ PET - Loại dày, trắng trong, có nắp",1499,1499,0,0
TIKI,voucher-dich-vu,16018257,"Ví da bò Vinalea VUN0006E",155000,155000,0,0
TIKI,tui-vi-nu,114644919,"Túi cói Merci, túi cói du lịch phong cách Vintage có đệm đáy giữ form túi, có ngăn nhỏ kéo khóa Lisa, M44",46000,48970,2970,6
TIKI,tui-vi-nu,160314163,"Ví Nữ Mini Cầm Tay PERFECT FOR YOU Gấp 3 Nhỏ Gọn Nhiều Ngăn Tiện Dụng Chất Da Cao Cấp Cực Đẹp PFY11 - Micocah Mall",129000,129000,0,0
TIKI,tui-vi-nu,117294101,"Túi xách,đeo vai bằng vải viền da phong cách Ulzzang 2 trong 1 có 3 màu xinh yêu ( hàng có sẵn)",115000,115000,0,0
TIKI,tui-vi-nu,135095916,"Túi tote đeo vai, đeo chéo vải bố canvas T046 nữ 2 dây đựng đồ đi học, đi chơi mềm đẹp",70000,140000,70000,50
TIKI,voucher-dich-vu,164961179,"Túi đeo chéo, đeo vai nữ mini da cao cấp T0229 Khóa gài chống thấm nước, bền bỉ phong cách thời trang Hàn",130000,260000,130000,50
TIKI,tui-vi-nu,22670247," Túi móc treo",369000,369000,0,0
TIKI,voucher-dich-vu,160314163,"Ví Nữ Mini Cầm Tay PERFECT FOR YOU Gấp 3 Nhỏ Gọn Nhiều Ngăn Tiện Dụng Chất Da Cao Cấp Cực Đẹp PFY11 - Micocah Mall",129000,129000,0,0
TIKI,voucher-dich-vu,117294101,"Túi xách,đeo vai bằng vải viền da phong cách Ulzzang 2 trong 1 có 3 màu xinh yêu ( hàng có sẵn)",115000,115000,0,0
TIKI,tui-vi-nu,72958731,"Túi đeo chéo nữ đựng điện thoại 2 mặt có cảm ứng Shalla MN2 Tặng móc khóa cá heo",33778,46164,12386,27
TIKI,tui-vi-nu,118026376,"TÚI ĐI CHÙA # Giỏ Xách Adi # Bị # Túi Vải",30000,30000,0,0
TIKI,tui-vi-nu,45871746,"quai đeo túi xách dạng dây da và xích kim loại túi cnk 110cm",90000,90000,0,0
TIKI,voucher-dich-vu,22670247," Túi móc treo",369000,369000,0,0
TIKI,tui-vi-nu,56402731,"túi chim cánh cụt",110000,110000,0,0
TIKI,tui-vi-nu,145494864,"Túi Đeo Chéo Unisex Sắc Màu Thời Trang Peozi SM06 Unisex Sport Mini Bag | Túi Mini Đa Năng Vừa Là Túi Bao Tử + Túi Đựng Điện Thoại Chạy Bộ, Đạp Xe",57000,57000,0,0
TIKI,voucher-dich-vu,118026376,"TÚI ĐI CHÙA # Giỏ Xách Adi # Bị # Túi Vải",30000,30000,0,0
TIKI,tui-vi-nu,193720488,"VÍ CẦM TAY THIẾT KẾ SANG TRỌNG",350000,350000,0,0
TIKI,voucher-dich-vu,56402731,"túi chim cánh cụt",110000,110000,0,0
TIKI,tui-vi-nu,183736392,"1.	Túi xách nữ đẹp FA FTX1",550000,550000,0,0
TIKI,tui-vi-nu,12453280,"Ví da cầm tay cao cấp dùng đựng điện thoại, thẻ và giấy tờ cho nữ AV002 (Hot Model 2019)",159000,159000,0,0
TIKI,tui-vi-nu,271474405,"TÚI CANVAS GẤU TRÚC HOA HOA - HUAHUA PANDA",59000,59000,0,0
TIKI,tui-vi-nu,68349508,"Ví cầm tay thời trang đa năng YUUMY YMK2 nhiều màu",29000,50000,21000,42
TIKI,voucher-dich-vu,193720488,"VÍ CẦM TAY THIẾT KẾ SANG TRỌNG",350000,350000,0,0
TIKI,voucher-dich-vu,183736392,"1.	Túi xách nữ đẹp FA FTX1",550000,550000,0,0
TIKI,tui-vi-nu,89135102,"túi xách ,túi đeo vai, đeo chéo nữ vải canvas cao cấp phong cách mới",269000,298000,29000,10
TIKI,tui-vi-nu,199681840,"Money Clip Wallet - Ví kẹp tiền da nam đựng thẻ Carbon RFID tối đa đến 15 thẻ",290000,290000,0,0
TIKI,voucher-dich-vu,271474405,"TÚI CANVAS GẤU TRÚC HOA HOA - HUAHUA PANDA",59000,59000,0,0
TIKI,tui-vi-nu,125100629,"Ví cầm tay ngắn Sang trọng CDVN01 (đen)",189000,189000,0,0
TIKI,voucher-dich-vu,199681840,"Money Clip Wallet - Ví kẹp tiền da nam đựng thẻ Carbon RFID tối đa đến 15 thẻ",290000,290000,0,0
TIKI,voucher-dich-vu,125100629,"Ví cầm tay ngắn Sang trọng CDVN01 (đen)",189000,189000,0,0
TIKI,tui-vi-nu,162029783,"Túi xách nữ thời trang công sở cao cấp phong cách mới",468000,520000,52000,10
TIKI,tui-vi-nu,174468915,"Ví Nữ Mini Cầm Tay PERFECT FOR YOU Dáng Vuông Xinh Xắn Chất Cực Đẹp PFY01",99000,99000,0,0
TIKI,tui-vi-nu,116776144,"Túi xách vali thời trang nhỏ gọn đựng được nhiều đồ",170000,170000,0,0
TIKI,voucher-dich-vu,116776144,"Túi xách vali thời trang nhỏ gọn đựng được nhiều đồ",170000,170000,0,0
TIKI,tui-vi-nu,172977126,"Túi vải bố, Túi vải Canvas trơn Màu Trắng - Màu Đen Màu Be Size 36cm x 31cm",25000,25000,0,0
TIKI,tui-vi-nu,58470994,"Túi xách đựng được giấy A4, túi xách laptop, máy tính bảng form rộng cực đẹp (Nhiều mẫu mã để chọn)",270000,450000,180000,40
TIKI,tui-vi-nu,118119353,"Ví nữ mini Yuumy YV40",69000,150000,81000,54
TIKI,voucher-dich-vu,172977126,"Túi vải bố, Túi vải Canvas trơn Màu Trắng - Màu Đen Màu Be Size 36cm x 31cm",25000,25000,0,0
TIKI,tui-vi-nu,81322798,"Túi đeo chéo nữ  túi xách nữ công sở thêu hoa thời trang sang trọng phong cách Hàn Quốc TN125",219000,219000,0,0
TIKI,tui-vi-nu,57049668,"Túi clutch nữ thời trang cao cấp ELLY – ECH17",629300,899000,269700,30
TIKI,tui-vi-nu,187852573,"Túi xách nữ dễ thương NASI T1045 vải cói pu cầm tay đẹp túi tote đeo vai có nút bấm thời trang cho nữ công sở, học sinh",38000,44900,6900,15
TIKI,voucher-dich-vu,67096510,"Túi đeo chéo thêu thời trang nữ - Hoa Cúc",250000,250000,0,0
TIKI,voucher-dich-vu,187852573,"Túi xách nữ dễ thương NASI T1045 vải cói pu cầm tay đẹp túi tote đeo vai có nút bấm thời trang cho nữ công sở, học sinh",38000,44900,6900,15
TIKI,tui-vi-nu,67096510,"Túi đeo chéo thêu thời trang nữ - Hoa Cúc",250000,250000,0,0
TIKI,tui-vi-nu,177060582,"Túi xách nữ thời trang cao cấp",441000,490000,49000,10
TIKI,tui-vi-nu,16052918,"Ví da bò Unisex Vinalea VUN0003E",155000,155000,0,0
TIKI,tui-vi-nu,172366798,"Ví da nữ cầm tay nhỏ gọn YUUMY Seasand YV58",75000,150000,75000,50
TIKI,voucher-dich-vu,149449628,"Túi đeo chéo - Túi xách nữ kiểu dáng yên ngựa chất mềm hai dây đeo bản to thời trang",243000,243000,0,0
TIKI,voucher-dich-vu,16052918,"Ví da bò Unisex Vinalea VUN0003E",155000,155000,0,0
TIKI,tui-vi-nu,135309816,"Túi đeo chéo vải bố canvas T0588 nữ trơn thêu chữ mềm, đẹp phong cách trẻ trung, cá tính",54000,108000,54000,50
TIKI,tui-vi-nu,149449628,"Túi đeo chéo - Túi xách nữ kiểu dáng yên ngựa chất mềm hai dây đeo bản to thời trang",243000,243000,0,0
TIKI,voucher-dich-vu,150992317,"Bóp ví nữ cầm tay mini V0514 Hi Cow bỏ túi nhiều ngăn nhỏ gọn phong cách đơn giản, thời trang, dễ thương",25000,50000,25000,50
TIKI,tui-vi-nu,190355521,"Túi xách nữ da thật thời trang cao cấp phong cách mới",621000,690000,69000,10
TIKI,tui-vi-nu,150992317,"Bóp ví nữ cầm tay mini V0514 Hi Cow bỏ túi nhiều ngăn nhỏ gọn phong cách đơn giản, thời trang, dễ thương",25000,50000,25000,50
TIKI,voucher-dich-vu,73341059,"TÚI NHỎ ĐEO CHÉO Mini Tiện Lợi SQUARE Vải Canvas Cao Cấp Chống Thấm Nước Unisex Nam Nữ Chuẩn Nome DOLANTO",98000,98000,0,0
TIKI,tui-vi-nu,192689048,"Túi xách nữ thời trang công sở cao cấp phong cách mới",351000,390000,39000,10
TIKI,tui-vi-nu,73341059,"TÚI NHỎ ĐEO CHÉO Mini Tiện Lợi SQUARE Vải Canvas Cao Cấp Chống Thấm Nước Unisex Nam Nữ Chuẩn Nome DOLANTO",98000,98000,0,0
TIKI,voucher-dich-vu,186232554,"Túi xách nữ Pu Cao Cấp Handle Bag kiểu dáng cổ điển đơn giản thời trang có thể đeo chéo hoặc xách tayTúi đeo vai - Bảo hành 1 năm",456000,456000,0,0
TIKI,tui-vi-nu,81783337,"Túi Xách Nữ Khóa Gài Da Rắn Mới HAPAS - TDC18149",469000,469000,0,0
TIKI,voucher-dich-vu,101861404,"Túi Cói Đi Biển, Túi Xách Cấm Tay Đi Chơi, Đi Picnic Xinh Xắn - Mã TUI27",49000,49000,0,0
TIKI,tui-vi-nu,197162288,"Túi đeo chéo khóa xoay Yuumy Seasand YN142",345000,650000,305000,47
TIKI,tui-vi-nu,186232554,"Túi xách nữ Pu Cao Cấp Handle Bag kiểu dáng cổ điển đơn giản thời trang có thể đeo chéo hoặc xách tayTúi đeo vai - Bảo hành 1 năm",456000,456000,0,0
TIKI,tui-vi-nu,155610646,"Túi xách đeo chéo nữ giá rẻ đẹp đi chơi phong cách thời trang hàn quốc dễ thương cute DC297 - DC297 TRẮNG",64000,64000,0,0
TIKI,voucher-dich-vu,88085617,"Túi xách nữ ,Túi đeo vai nữ da vân cao cấp khóa cúc nổi bật sang trọng và thời thượng",75000,75000,0,0
TIKI,tui-vi-nu,101861404,"Túi Cói Đi Biển, Túi Xách Cấm Tay Đi Chơi, Đi Picnic Xinh Xắn - Mã TUI27",49000,49000,0,0
TIKI,voucher-dich-vu,89220547,"Ví nữ nhỏ nhiều ngăn cầm tay mini gấp 3 thời trang cute dễ thương giá rẻ LUKAMO VD70",31000,31000,0,0
TIKI,voucher-dich-vu,71486903,"Túi kẹp nách nữ thời trang sọc Caro trẻ trung, hợp xu hướng TK0062",50000,100000,50000,50
TIKI,tui-vi-nu,148850128,"Ví đựng thẻ Arctic Hunter Q00012 thiết kế nhiều ngăn, đựng tiền giấy thời trang cho nam và nữ",175000,299000,124000,41
TIKI,tui-vi-nu,88085617,"Túi xách nữ ,Túi đeo vai nữ da vân cao cấp khóa cúc nổi bật sang trọng và thời thượng",75000,75000,0,0
TIKI,tui-vi-nu,174468945,"Ví Nữ Ngắn Mini Cầm Tay Chính Hãng TAILIAN Đựng Tiền Đựng Thẻ Kẻ Caro Xinh Xắn Da Cao Cấp TL12",119000,119000,0,0
TIKI,voucher-dich-vu,157253910,"Ví Nắp Da In SAIGON SWAGGER Eclipse Short Flap Wallet",480000,480000,0,0
TIKI,tui-vi-nu,89220547,"Ví nữ nhỏ nhiều ngăn cầm tay mini gấp 3 thời trang cute dễ thương giá rẻ LUKAMO VD70",31000,31000,0,0
TIKI,voucher-dich-vu,185927313,"[ Hàng cao cấp]- Túi cói đeo vai túi tote cói phong cách vintage",280000,280000,0,0
TIKI,tui-vi-nu,71486903,"Túi kẹp nách nữ thời trang sọc Caro trẻ trung, hợp xu hướng TK0062",50000,100000,50000,50
TIKI,tui-vi-nu,157253910,"Ví Nắp Da In SAIGON SWAGGER Eclipse Short Flap Wallet",480000,480000,0,0
TIKI,voucher-dich-vu,58796191,"Ví đựng tiền xu mini cho bé hình thú - Giao hình ngẫu nhiên",90000,90000,0,0
TIKI,voucher-dich-vu,193051873,"Ví Nữ Mini Ngắn Cầm Tay Cao Cấp Sang Trọng Phong Cách Hàn Quốc TVNN135",250000,250000,0,0
TIKI,tui-vi-nu,185927313,"[ Hàng cao cấp]- Túi cói đeo vai túi tote cói phong cách vintage",280000,280000,0,0
TIKI,tui-vi-nu,58796191,"Ví đựng tiền xu mini cho bé hình thú - Giao hình ngẫu nhiên",90000,90000,0,0
TIKI,tui-vi-nu,193051873,"Ví Nữ Mini Ngắn Cầm Tay Cao Cấp Sang Trọng Phong Cách Hàn Quốc TVNN135",250000,250000,0,0
TIKI,tui-vi-nu,110723636," VÍ DA CẦM TAY NỮ VÍ DA CẦM TAY NAM",118000,169000,51000,30
TIKI,tui-vi-nu,159725474,"Túi xách đa năng May 10 (giao màu ngẫu nhiên)",35000,35000,0,0
TIKI,tui-vi-nu,173167924,"Túi vải bố, Túi vải Canvas trơn Màu Trắng - Màu Đen không khóa kéo",19000,19000,0,0
TIKI,tui-vi-nu,54430952,"Túi xách nữ cao cấp phong cách châu âu hiện đại mới",275000,275000,0,0
TIKI,tui-vi-nu,152446331,"Túi xách nữ đeo chéo da mềm thời trang phong cách Hàn Quốc",99000,99000,0,0
TIKI,tui-vi-nu,162373758,"Túi Vải Bố Canvas Tote Trơn Grepaco Không In Màu Trắng Dạng Quai Xách Đeo Vai Có Ngăn Phụ Bên Trong Dùng Đi Học Dạy Vẻ Cho Sinh Viên Học Sinh",46000,49000,3000,6
TIKI,tui-vi-nu,68527197,"Túi xách tote vải Túi Tote Túi Vải Nữ Túi Đeo Chéo Hàn Quốc ",51300,51300,0,0
TIKI,tui-vi-nu,189832277,"Túi xách túi đeo vai nữ mini , có quai cầm ngọc  trai ,da bóng đẹp  xinh xắn đáng yêu cho phái nữ dạo phố",39000,39000,0,0
TIKI,tui-vi-nu,84229853,"Túi xách nữ thêu hoa túi xách công sở thanh lịch sang trọng phong cách Hàn Quốc",219000,219000,0,0
TIKI,tui-vi-nu,172977144,"Túi vải bố, Túi vải Canvas trơn Màu Be - Màu Đen không khóa kéo",19000,19000,0,0
TIKI,tui-vi-nu,137154030,"Túi Tote Canvas Đeo Chéo Nữ Đi Học Mèo My World Phong Cách Ulzzang",59000,59000,0,0
TIKI,tui-vi-nu,188503686,"Túi đeo chéo nữ vải dù trần trám, nhiều ngăn chống nước, phong cách Hàn Quốc Size 22cm TUI-58",139000,139000,0,0
TIKI,tui-vi-nu,160314876,"Túi Xách Đeo Chéo Nữ Kẹp Nách Chính Hãng MICOCAH Dáng Công Sở Thời Trang Da Cao Cấp Cực Đẹp MC63",369000,369000,0,0
TIKI,tui-vi-nu,187642699,"Túi Cói Merci Siêu Hot Hit ! đi biển,đi chợ,đi chơi",38000,38000,0,0
TIKI,tui-vi-nu,102399926,"Túi xách đeo chéo nữ nhỏ dạo phố xinh xắn MN105",99000,99000,0,0
TIKI,tui-vi-nu,107614755,"Túi vải bố, Túi vải Canvas trơn Màu Trắng - Màu Đen không khóa kéo",19000,19000,0,0
TIKI,tui-vi-nu,150147404,"Dầu Bôi Ấm Ngực Vicks Baby Balsam Chống Cảm Cho Bé",175000,250000,75000,30
TIKI,tui-vi-nu,58230324,"Túi bao tử nữ đeo chéo trước ngực, đeo hông",53460,73062,19602,27
TIKI,tui-vi-nu,55022823,"Túi xách nữ đeo chéo hàn quốc đẹp cao cấp Vimona TX20 in vân chìm sang chảnh",128000,128000,0,0
TIKI,tui-vi-nu,16882460,"Vỏ Bọc Hộ Chiếu Có Khe Nhét Thẻ Tiện Dụng",2999,2999,0,0
TIKI,tui-vi-nu,192033898,"Túi peekoo xanh tiện lợi",49000,49000,0,0
TIKI,tui-vi-nu,134947145,"Túi Xách Cói Dây Da Đi Biển YUUMY YTX16",155000,290000,135000,47
TIKI,tui-vi-nu,42729783,"Túi clutch nữ thời trang cao cấp ELLY – ECH31",999000,999000,0,0
TIKI,tui-vi-nu,56531143,"Ví nữ cầm tay gấp đôi nhỏ gọn, phối màu dễ thương TK0052",35000,70000,35000,50
TIKI,tui-vi-nu,86560842,"Ví bóp nữ   Ví nữ cầm tay ngắn mini cao cấp nhiều ngăn giá rẻ V042301",32000,32000,0,0
TIKI,tui-vi-nu,135545812,"Túi đeo chéo mini Fimax vài cao cấp chống thấm nước - túi đeo nữ thời trang vải cao cấp phong cách Hàn Quốc",119000,119000,0,0
TIKI,tui-vi-nu,72210939,"Móc khóa thời trang YUUMY YMK5 - Màu sắc trẻ trung - Thiết kế hiện đại - Đa chức năng sử dụng - Đựng thẻ ngân hàng, thẻ xe, chìa khóa xe - Tiên dụng mang theo bên người (Dài 7cm x Cao 10.5cm)",29000,50000,21000,42
TIKI,tui-vi-nu,176267743,"Túi đeo chéo nữ nắp phong thư Yuumy seasand YN97",299000,570000,271000,48
TIKI,tui-vi-nu,76181891,"Ví nữ cầm tay 2 ngăn kéo cao cấp, thiết kế độc đáo đẹp mắt, nhiều ngăn tiện dụng TK0073",69000,100000,31000,31
TIKI,tui-vi-nu,90113077,"Túi Cói Merci Siêu Tiện Dụng Siêu HÓT HÍT Túi đi biển",54999,54999,0,0
TIKI,tui-vi-nu,109631859,"Ví dự tiệc cưới, sự kiện, kiểu dáng trong suốt, có nút gài kim loại, ví dự tiệc sang trọng, đẳng cấp",270000,450000,180000,40
TIKI,tui-vi-nu,45268061,"Dây Túi đeo chéo da pu kết hợp với dây vải xì teen, dây đeo vai có thể điều chỉnh  có thể điều chỉnh",120000,120000,0,0
TIKI,tui-vi-nu,96311978,"Túi Cói Xách Tay Thời Trang Đi Biển 2 Lớp Quai Vải Phong Cách Vintage - Mã XT026",43000,47900,4900,10
TIKI,tui-vi-nu,66654552,"dây xích kim loại, quai túi xách, dây túi 2 loại ngắn40cm và dài 120cm",33000,33000,0,0
TIKI,tui-vi-nu,158815530,"Ví cầm tay nữ nắp gập cách điệu YUUMY Seasand YV55",165000,330000,165000,50
TIKI,tui-vi-nu,114568388,"Túi cói Merci thời trang đi biển - dạo phố - đi làm",41890,41890,0,0
TIKI,tui-vi-nu,114411570,"Móc khóa thời trang LATA MK6",95000,150000,55000,37
TIKI,tui-vi-nu,132053956,"Túi xách nữ sang chảnh 4 màu hộp vuông túi nữ có dây đeo chéo dáng hàn quốc size 20",125000,125000,0,0
TIKI,tui-vi-nu,117084931,"Túi xách đeo chéo nữ tặng dây chuyền ngọc trai dạo phố",159000,159000,0,0
TIKI,tui-vi-nu,162024663,"Túi xách nữ thời trang công sở cao cấp phong cách mới",404000,448200,44200,10
TIKI,tui-thoi-trang-nam,160818635," Cặp Da đựng tài liệu Cặp giáo viên Có ngăn Đựng laptop, tài liệu công tác nhiều ngăn phụ",699000,699000,0,0
TIKI,tui-thoi-trang-nam,116724768,"Ví Nam Mini Nhỏ Gọn, Da Bò Mềm Mại GENTLE, Thiết Kế Hiện Đại, Nhiều Ngăn Đựng Tiền và Thẻ Tiện Dụng, Dáng Ngang - Gập 2 - Hàng Chính Hãng SAIGIO",783000,799000,16000,2
TIKI,tui-thoi-trang-nam,195986500,"Túi đeo chéo Messenger vải Oxford cao cấp chống thấm nước, bền bỉ unisex nam nữ phong cách thời trang, cá tính",70000,140000,70000,50
TIKI,tui-thoi-trang-nam,70680920,"Túi Đeo Chéo Nam Unisex Thời Trang Chống Nước Yourwish TD23 Túi Bao Tử Dệt Trơn Trượt Nước Đeo Hông Lưng Bụng Màu",64350,87945,23595,27
TIKI,tui-thoi-trang-nam,75600848,"Túi đeo chéo ,đeo ngực nam phong cách mới",405000,450000,45000,10
TIKI,tui-thoi-trang-nam,168069730,"Túi Đeo Chéo Nam Chống Nước FALDO 2.1",350000,350000,0,0
TIKI,tui-thoi-trang-nam,58215166,"Cặp công sở TRITA TCA1",359000,600000,241000,40
TIKI,tui-thoi-trang-nam,7804629,"Túi Đeo Chéo Ipad Unisex Fortune Mouse C860 (20 x 24 cm)",39000,39000,0,0
TIKI,tui-thoi-trang-nam,76687028,"Ví nam da bò cao cấp phong cách mới",359000,398000,39000,10
TIKI,tui-thoi-trang-nam,188897177,"Túi Đeo Chéo Nam Nữ Thời Trang Trẻ Trung, Túi Đựng Ipad, Túi Đeo Vai Nhiều Ngăn Kéo Đựng Đồ Rất Tiện Lợi, Vải Oxford Chống Thấm Nước",140000,140000,0,0
TIKI,tui-thoi-trang-nam,73340768,"TÚI ĐEO CHÉO Mini Tiện Lợi BUMBAG Vải Canvas Cao Cấp Chống Thấm Nước Unisex Nam Nữ Chuẩn Dim DOLANTO",180000,180000,0,0
TIKI,tui-thoi-trang-nam,120469883,"Ví Nam Đứng, Da Bò Mềm Mại GENTLE, Size Lớn, Thiết Kế Cổ Điển Đơn Giản - Đẹp Mắt, Dáng Đứng - Gập 2, Ngăn Đựng Tiền Có Khóa Kéo, Nhiều Ngăn Để Giấy Tờ Tiện Dụng - Hàng Chính Hãng SAIGIO",781000,799000,18000,2
TIKI,tui-thoi-trang-nam,193005196,"Túi đeo chéo nam da bò Staurn Bụi Leather DC111 - Da bò thật cao cấp - Bảo hành 12 tháng",479000,679000,200000,29
TIKI,tui-thoi-trang-nam,73775533,"Ví nam 100% da bò thật cao cấp phong cách mới",405000,450000,45000,10
TIKI,tui-thoi-trang-nam,89786838,"Túi đeo chéo nam, túi bao tử vải dù cao cấp chống nước",147510,213070,65560,31
TIKI,tui-thoi-trang-nam,89176321,"Túi xách túi đeo chéo nam vải canvas cao cấp phong cách mới",351000,390000,39000,10
TIKI,tui-thoi-trang-nam,45018395,"Túi đeo chéo nam nữ unisex thời trang BEE GEE 063",68000,138000,70000,51
TIKI,tui-thoi-trang-nam,181523715,"Ví Nam Cao Cấp, Da Bò NAPA Láng Mịn, Mỏng Nhẹ, Size Trung, Kiểu Cổ Điển Tinh Tế - Sang Trọng, Dáng Ngang - Gập 2, Nhiều Ngăn Để Tiền Và Giấy Tờ Tiện Dụng - Hàng Chính Hãng SAIGIO",1182000,1199000,17000,1
TIKI,tui-thoi-trang-nam,193004984,"Túi đeo chéo nam Jupiter Bụi Leather DC110 - Da bò thật cao cấp - Bảo hành 12 tháng",499000,705000,206000,29
TIKI,tui-thoi-trang-nam,193004204,"Túi đeo chéo da bò thật Venus Bụi Leather DC108 - Da bò Nappa cao cấp - Bảo hành 12 tháng",349000,495000,146000,29
TIKI,tui-thoi-trang-nam,147423638,"Bao Bọc Hộ Chiếu - Passport Dẻo Trong Suốt",2999,2999,0,0
TIKI,tui-thoi-trang-nam,145748036,"Ví Nam Da Bò Mềm Mại ONE LINE, Size Lớn, Thiết Kế Nhiều Ngăn Để Giấy Tờ, Có Khóa Kéo, Đựng Tiền và Thẻ Tiện Dụng, Dáng Ngang - Gập 2 - Hàng Chính Hãng SAIGIO",782000,799000,17000,2
TIKI,tui-thoi-trang-nam,193241728,"Túi Đeo Chéo Nam Vải Nylon Cao Cấp Nhiều Ngăn Chống Thấm Nước, Túi Đeo Vai Phong Cách Thời Trang Hàn Quốc Dành Cho Người Đi Làm, Học Sinh, Sinh Viên,Người Đi Chơi, Đi Du Lịch",115000,115000,0,0
TIKI,tui-thoi-trang-nam,148811049,"Ví dài cầm tay da bò Mill cao cấp Bụi Leather C107 - Bảo hành 12 tháng",490000,778000,288000,37
TIKI,tui-thoi-trang-nam,189281858,"Túi đeo chéo nam nữ nhiều ngăn tiện lợi vải cao cấp chính hãng YVan 1202-1",325000,325000,0,0
TIKI,tui-thoi-trang-nam,117036103,"Ví Nam Cao Cấp, Da Bò NAPA Láng Mịn, Mỏng Nhẹ, Size Lớn, Kiểu Cổ Điển Tinh Tế - Sang Trọng, Dáng Ngang - Gập 2, Ngăn Đựng Tiền Có Khóa Kéo, Nhiều Ngăn Để Giấy Tờ Tiện Dụng - Hàng Chính Hãng SAIGIO",1179000,1199000,20000,2
TIKI,tui-thoi-trang-nam,59103121,"Túi đeo chéo nam da bò cao cấp T08 26x23x7cm",275000,275000,0,0
TIKI,tui-thoi-trang-nam,95004244,"Túi đeo chéo nam vải canvas cao cấp phong cách mới",269000,298000,29000,10
TIKI,tui-thoi-trang-nam,162051575,"ví nam ví nam clutch cầm tay cao cấp",441000,490000,49000,10
TIKI,tui-thoi-trang-nam,88925675,"Túi xách nam công sở cao cấp",423000,470000,47000,10
TIKI,tui-thoi-trang-nam,67175802,"Cặp da công sở đựng Laptop 14 inch da vân kèm 2 ngăn kép",275000,275000,0,0
TIKI,tui-thoi-trang-nam,148850131,"Túi đeo chéo, đeo ngực nam Arctic Hunter YB00047 chất liệu Oxford chống thấm nước, thiết kế nhiều ngăn tiện dụng",299000,550000,251000,46
TIKI,tui-thoi-trang-nam,192566295,"Bóp ví da nam cầm tay Classic vải Canvas trơn đựng thẻ nhỏ gọn phong cách đơn giản, thời trang",48000,96000,48000,50
TIKI,tui-thoi-trang-nam,149521455,"{DA CÁ SẤU THẬT} Bóp Da Cá Sấu Nam Màu Nâu Da Bụng - Ví Nam Da Cá Sấu Có Khoá Kéo Cao Cấp Dáng Ngang Thời Trang",890000,890000,0,0
TIKI,tui-thoi-trang-nam,70135041,"Túi Đeo Chéo Trước Ngực 4U Da Tổng Hợp Thời Trang BA416",199000,250000,51000,20
TIKI,tui-thoi-trang-nam,193723534,"Túi Đeo Chéo, Túi Bao Tử Đa Năng, Mẫu Thể Thao Năng Động Chống Thấm Nước, Có 4 Ngăn Đựng Đồ Tiện Dụng",60000,60000,0,0
TIKI,tui-thoi-trang-nam,96580691,"Túi đeo chéo nam da bò JEEP BULUO 26x21x6cm-EVA.STORES",179000,179000,0,0
TIKI,tui-thoi-trang-nam,148801985,"Ví dài cầm tay da bò sáp ngựa điên Crazyhorse cao cấp C102 Bụi Leather - Bảo hành 12 tháng",259000,514000,255000,50
TIKI,tui-thoi-trang-nam,195160576,"Túi Đeo Chéo Nam Nữ Size Lớn Chất Vải Polysster Cao Cấp Chống Thấm Nước 2087 End&Start  BL003",272000,320000,48000,15
TIKI,tui-thoi-trang-nam,73218453,"TÚI ĐEO CHÉO Mini Tiện Lợi RUSH BAG Nhỏ Gọn Vải Canvas Cao Cấp Chống Thấm Nước Unisex Nam Nữ Chuẩn Leonardo DOLANTO",209000,209000,0,0
TIKI,voucher-dich-vu,144333971,"Toàn Quốc [Voucher Giấy] Học online môn Toán từ lớp 1 - 12 tại nhà - TOPPY",299000,299000,0,0
TIKI,voucher-dich-vu,254139935,"Voucher App học tiếng Anh dành cho học sinh Cấp 2 ALOWINGS Mã kích hoạt online áp dụng trên toàn quốc",1500000,1500000,0,0
TIKI,voucher-dich-vu,193450374,"[EVoucher Vietravel] Trung Quốc: Thượng Hải - Chu Gia Giác - Bắc Kinh - Chinh phục Vạn Lý Trường Thành",25990000,25990000,0,0
TIKI,voucher-dich-vu,195851943,"[EVoucher Vietravel] Hà Nội - Sapa - Bản Cát Cát - Fansipan - Cổng Trời Ô Quy Hồ",7190000,7190000,0,0
TIKI,voucher-dich-vu,199958162,"[EVoucher Vietravel] Đà Nẵng – Huế - Bà Nà – Cầu Vàng – Hội An (Khách sạn 4*) – Tặng Combo Thuyền dạo sông Hoài & Show Kí ức Hội An",6990000,6990000,0,0
TIKI,voucher-dich-vu,225909092,"[EVoucher Vietravel] Thái Lan: Bangkok - Pattaya (Khách sạn 4* - Tham quan Safari World & Thưởng thức buffet tối trên Du thuyền 5 sao)",9990000,9990000,0,0
TIKI,voucher-dich-vu,202631329,"[Vietravel HN] Gói 2N1Đ - Du Thuyền 5* Stella, Vịnh Hạ Long, Lan Hạ ",3690000,3690000,0,0
TIKI,voucher-dich-vu,189135471,"[EVoucher Vietravel] Đà Nẵng - Phố cổ Hội An - Bà Nà - Cầu Vàng - Vườn Tượng Apec - Cầu Tình yêu (KS 4sao)",3590000,3590000,0,0
TIKI,voucher-dich-vu,270058423," [EVoucher Vietravel Hà Nội] Combo 3N2D KS Liberty Central Hotel Nha Trang: VMB khứ hồi Hà Nội - Nha Trang + Phòng Tiêu Chuẩn + Ăn sáng",3990000,3990000,0,0
TIKI,voucher-dich-vu,192398394,"[EVoucher Vietravel] Malaysia: Malaysia - Cao nguyên Berjaya - Singapore",9490000,9490000,0,0
TIKI,voucher-dich-vu,190335864,"VOUCHER - [TT006] - THAY ĐỔI NỘI DUNG GIẤY CHỨNG NHẬN ĐĂNG KÝ DOANH NGHIỆP - Công ty Luật Apra",2000000,2000000,0,0
TIKI,voucher-dich-vu,91373451,"[E-Voucher] Tour Hòn Sơn từ Sài Gòn 2 ngày 1 đêm – Khám phá “Hòn đảo thiên đường”",1690000,1690000,0,0
TIKI,voucher-dich-vu,254142155,"[Gói 4 năm] Combo ALOWINGS Tiếng Anh và Toán - Ứng dụng học tập chuẩn chương trình Cấp 2 chính quy",4400000,4400000,0,0
TIKI,voucher-dich-vu,254141219,"[Gói 2 năm] Ứng dụng học Toán cho Lớp 6 đến Lớp 9 ALOWINGS TOÁN Voucher online áp dụng trên toàn quốc",1400000,1400000,0,0
TIKI,voucher-dich-vu,254141990,"[Gói 1 năm] Combo ALOWINGS Tiếng Anh và Toán - App học tập dành cho Lớp 6 đến Lớp 9 Mã học online áp dụng toàn quốc",2500000,2500000,0,0
TIKI,voucher-dich-vu,254142203,"[Trọn đời] Combo ALOWINGS Tiếng Anh và Toán - Ứng dụng học tập chuẩn Sách Giáo Khoa từ Lớp 6 đến Lớp 9",8000000,8000000,0,0
TIKI,voucher-dich-vu,253227605,"[Gói 1 năm] App học Toán Tiếng Việt Tiếng Anh dành cho trẻ 6-10 tuổi ALOKIDDY TIỂU HỌC Mã kích hoạt áp dụng toàn quốc",2200000,2200000,0,0
TIKI,voucher-dich-vu,254139816,"[Gói 5 năm] ALOSTAR - Mã kích hoạt app học tiếng Anh cho trẻ 2-7 tuổi Áp dụng trên toàn quốc",5000000,5000000,0,0
TIKI,voucher-dich-vu,269959970,"[EVoucher Vietravel Hà Nội] Combo 3N2D KS The Code Đà Nẵng 4 Sao: VMB khứ hồi Hà Nội - Đà Nẵng + Phòng Tiêu Chuẩn + Ăn sáng",3990000,3990000,0,0
TIKI,voucher-dich-vu,72099107,"KHÓA HỌC GIẢI QUYẾT CÁC VẤN ĐỀ TRONG HỆ THỐNG CÓ LƯỢNG TRUY CẬP LỚN",6000000,6000000,0,0
TIKI,voucher-dich-vu,243300498,"[E-Voucher] Tour chợ nổi Cái Răng ghép đoàn",100000,100000,0,0
TIKI,voucher-dich-vu,230082708,"[E-Voucher] Sách nói Fonos: Chế Độ Ăn Trường Thọ",99000,99000,0,0
TIKI,voucher-dich-vu,162400246,"Reading Gate - ứng dụng đọc sách học tiếng anh đa nền tảng web/ Android/ IOS (Gói 1 tháng)",600000,600000,0,0
TIKI,voucher-dich-vu,192409684,"[EVoucher Vietravel] Hà Nội - Hạ Long - Yên Tử - Ninh Bình - Bái Đính - Tràng An (Khách sạn 4 sao)",6590000,6590000,0,0
TIKI,voucher-dich-vu,66761996,"[E-Voucher] Tour du lịch miền Tây 1 ngày giá rẻ | Sài Gòn – Mỹ Tho – Bến Tre",550000,550000,0,0
TIKI,voucher-dich-vu,195852104,"[EVoucher Vietravel] Đông Bắc: Hà Giang - Lũng Cú - Đồng Văn - Mã Pí Lèng - Cột Cờ Lũng Cú",7990000,7990000,0,0
TIKI,voucher-dich-vu,254141710,"[Gói 1 năm] ENGLISH4U - Khóa học tiếng Anh trực tuyến dành cho học sinh, sinh viên, người đi làm",1000000,1000000,0,0
TIKI,voucher-dich-vu,195852214,"[EVoucher Vietravel] Hà Nội - Xuân Sơn - Bắc Yên - Sống lưng khủng long Tà Xùa - Mộc Châu",6990000,6990000,0,0
TIKI,voucher-dich-vu,68564421,"[E-Voucher] Tour du lịch miền Tây 2N1Đ | Sài Gòn – Tiền Giang – Bến Tre – Cần Thơ",1500000,1500000,0,0
TIKI,voucher-dich-vu,34361850,"[HCM] Tour 3N2Đ Hà Nội - Ninh Bình - Hạ Long, Gồm Vé Máy Bay Khứ Hồi, Khởi Hành Hàng Tuần",7390000,7390000,0,0
TIKI,voucher-dich-vu,222692542,"[EVoucher Vietravel] Thái Lan: Chiangmai – Chiangrai: Khám phá Chùa Trắng & Tam Giác Vàng - Tặng vé tham quan Chiang Mai Night Safari",10490000,10490000,0,0
TIKI,voucher-dich-vu,138612749,"VOUCHER - [ST001] - DỊCH VỤ SOẢN THẢO THỎA THUẬN TRƯỚC HÔN NHÂN - Công ty Luật Apra",1000000,1000000,0,0
TIKI,voucher-dich-vu,273533931,"Trắng da căng bóng  RF-LED (Gói RF-Lifting + LED + Mặt nạ) - 1 buổi",3470000,3470000,0,0
TIKI,voucher-dich-vu,254140046,"[Gói 2 năm] Mã kích hoạt online khóa học tiếng Anh dành cho Lớp 6 đến Lớp 9 ALOWINGS Áp dụng trên toàn quốc",1500000,1500000,0,0
TIKI,voucher-dich-vu,36487743,"SỞ HỮU NỤ CƯỜI QUYẾN RŨ VỚI PHƯƠNG PHÁP PHẪU THUẬT TẠO KHÓE CƯỜI AN TOÀN, HIỆU QUẢ",6000000,6000000,0,0
TIKI,voucher-dich-vu,129587544,"[E-BOOK] i-Learn Smart Start Special Edition 4 Sách mềm sách bài tập",15000,15000,0,0
TIKI,voucher-dich-vu,75559141,"Goimon.net- Hotpot House- Mì gà tiềm ớt hiểm (Tô thường)",48000,48000,0,0
TIKI,voucher-dich-vu,254145783,"[Gói 1 năm] Combo ALOSTAR và ALOKIDDY Tiếng Anh - App học tiếng Anh cho trẻ mầm non và tiểu học",2000000,2000000,0,0
TIKI,voucher-dich-vu,158226929,"Phiếu Quà Tặng Bornga/Paik Jong Wons Kitchen 100K",100000,100000,0,0
TIKI,voucher-dich-vu,270257141,"The Imperial Hotel 5* Vũng Tàu - Buffet Sáng, Hồ Bơi, Đối Diện Biển Bãi Sau, Có Xe Đưa Đón Từ Sài Gòn Trong Tuần Và Nhiều Ưu Đãi Hấp Dẫn",2489000,2489000,0,0
TIKI,voucher-dich-vu,273533783,"Da căng bóng mịn màng (Gói Scrubber + Jet Peel) -1 buổi",1860000,1860000,0,0
TIKI,voucher-dich-vu,132196533,"[E-BOOK] CYLET Practice Tests Pre A2 Flyers File nghe Audio",10000,10000,0,0
TIKI,voucher-dich-vu,56093975,"Voucher combo du lịch hạng phòng Family dành cho 4 người (4 ngày-3 đêm) tại Mega Light Hotel Nha Trang",2800000,2800000,0,0
TIKI,voucher-dich-vu,137191213,"Phiếu Quà Tặng Marc Fashion 200K",200000,200000,0,0
TIKI,voucher-dich-vu,34476173,"Khóa học Quyết định đầu tư",600000,600000,0,0
TIKI,voucher-dich-vu,76730149,"[Red River Tour] Tour Câu Mực Đêm & Ngắm Hoàng Hôn Phú Quốc Tổ Chức Hằng Ngày",203280,231000,27720,12
TIKI,voucher-dich-vu,210165675,"Wyndham Garden Grand World Hotel 4* Phú Quốc - Bữa Sáng, Hồ Bơi, Gần Biển, Đối Diện Phố Đi Bộ, Tiện Xem Show Venice Miễn Phí",1150000,1150000,0,0
TIKI,voucher-dich-vu,252250752,"[Voucher 12 tháng] Bộ công cụ Học - Thi - Hướng nghiệp lớp 11, VitanEdu",600000,600000,0,0
TIKI,voucher-dich-vu,198750993,"[TOUR VIP] Hạ Long 1N: Du thuyền 5 Sao La Casta Daily siêu VIP thăm vịnh 8 tiếng, Khởi hành Hàng ngày",1699000,1699000,0,0
TIKI,voucher-dich-vu,149685380,"InterContinental Phú Quốc Long Beach Resort 5* - Buffet Sáng, Hồ Bơi Cực Đẹp, Miễn Phí Đón Tiễn Sân Bay, Khách Sạn",3100000,3100000,0,0
TIKI,voucher-dich-vu,176718536,"Sách nói: Bí Mật Và Thực Tế Về Tự Kỉ Ám Thị",99000,99000,0,0
TIKI,voucher-dich-vu,140300484,"VOUCHER - [LSR003] - LUẬT SƯ RIÊNG 06 THÁNG - Công ty Luật Apra",9000000,9000000,0,0
TIKI,voucher-dich-vu,199216358,"TOUR BRUNEI DARUSSALAM 4 NGÀY 3 ĐÊM",15990000,15990000,0,0
TIKI,voucher-dich-vu,176108013,"Sách nói: Triết Lý Kinh Doanh Của Inamori Kazuo",99000,99000,0,0
TIKI,voucher-dich-vu,48109321,"Vé du thuyền sông Hàn Danang Dragon",200000,200000,0,0
TIKI,voucher-dich-vu,187642480,"Sách nói: Nhân Quả Và Phật Pháp Nhiệm Màu - Tập 3",99000,99000,0,0
TIKI,voucher-dich-vu,187643013,"Sách nói: Trí Tuệ Xúc Cảm",99000,99000,0,0
TIKI,voucher-dich-vu,21775420,"Tick Edu - Dựng Hình Nhân Vật 3D Với Blender",399000,399000,0,0
TIKI,voucher-dich-vu,117434715,"Khóa hoc Cải thiện ĐAU ĐẦU và thư giãn vùng đầu - VMC",900000,900000,0,0
TIKI,voucher-dich-vu,179759046,"Sách nói: Có Ai Giữ Giùm Những Lãng Quên?",99000,99000,0,0
TIKI,voucher-dich-vu,252384185,"[Voucher 12 tháng] Bộ công cụ Học - Thi - Hướng nghiệp lớp 6, VitanEdu",375000,375000,0,0
TIKI,voucher-dich-vu,273532977,"Sạch da láng mịn kèm đắp mặt nạ (Gói Vi điện + Led + Mặt nạ) - 1 buổi",1860000,1860000,0,0
TIKI,voucher-dich-vu,249178597,"[E-Voucher] Tour Đà Lạt 4 ngày 3 đêm - Đà Lạt mộng mơ",3690000,3690000,0,0
TIKI,voucher-dich-vu,270496175,"Thẻ tập Yoga 01 tháng - Win Fitness & Yoga",460000,460000,0,0
TIKI,voucher-dich-vu,254145866,"[Gói 3 năm] Combo ALOSTAR và ALOKIDDY Tiếng Anh - Ứng dụng học tiếng Anh cho bé mầm và tiểu học",2500000,2500000,0,0
TIKI,voucher-dich-vu,273155109,"5 Phút Thuộc Bài - Gói VIP 12 năm - dành cho con từ lớp 1 đến lớp 12 Tặng Kèm Sach' Siêu Trí Nhớ 268k",1499000,1499000,0,0
TIKI,voucher-dich-vu,195655699,"TOUR DU LỊCH DUBAI - ABU DHABI - SA MẠC SAFARI",29900000,29900000,0,0
TIKI,voucher-dich-vu,73981165,"Thẩm Mỹ Ruby Beauty - Bác Sĩ Lương Ngọc|Lưu Giữ Thanh Xuân Với Dịch Vụ Căng Da Trẻ Hóa Và Tạo Má Lúm Đồng Tiền",4250000,4250000,0,0
TIKI,voucher-dich-vu,56090684,"Voucher combo du lịch hạng phòng Suite 3 ngày 2 đêm tại Alpha Bird Hotel Nha Trang",2250000,2250000,0,0
TIKI,voucher-dich-vu,187608677,"Giftpop - Phiếu Quà tặng Yakimono 500K",500000,500000,0,0
TIKI,voucher-dich-vu,213598878,"[E-Voucher] Gói học online theo môn - Lớp 6 (12 tháng) - Ứng dụng hỗ trợ học tập dành cho học sinh THCS",183000,183000,0,0
TIKI,voucher-dich-vu,207236112,"Sách nói Mở Rộng Từ Giá Trị Cốt Lõi",99000,99000,0,0
TIKI,voucher-dich-vu,204277501,"Ứng dụng giáo dục sớm tiền tiểu học Dino đi học phát triển tư duy cho trẻ 3-6 tuổi - Gói trọn đời (Tặng trọn bộ 9 quyển sách "Cùng Dino vui học" + Khóa học độc quyền "Cùng con trưởng thành với DINO))",1299000,1299000,0,0
TIKI,voucher-dich-vu,164934057,"Sinh Trắc Vân Tay Gen Talents - Bài Báo Cáo Đầy Đủ 4 Module",3850000,3850000,0,0
TIKI,voucher-dich-vu,121032629,"Tour 3 đảo Deluxe Nha Trang bao gồm cano và ăn trưa, vé tham quan",400000,400000,0,0
TIKI,voucher-dich-vu,207208715,"[EVoucher Vietravel] Singapore - Indonesia - Malaysia",12990000,12990000,0,0
TIKI,voucher-dich-vu,57804204,"TOUR ĐÀ NẴNG - HỘI AN - HUẾ(MẮT BIẾC) - BÀ NÀ - QUẢNG BÌNH 5N4Đ [TPHCM] [KHUYẾN MÃI KÍCH CẦU] [DATVIETRAVEL",310000,310000,0,0
TIKI,voucher-dich-vu,195653621,"HÀ NỘI - ĐÀ NẴNG - BÀ NÀ - HỘI AN - HÀ NỘI BAY VIETJET AIR",5700000,5700000,0,0
TIKI,voucher-dich-vu,203049726,"[EVoucher Vietravel] Nha Trang - Làng Chài Xưa Mũi Né - Biển Nhũ Tiên - Vinwonders (Xe - Khách Sạn 4 sao)",3690000,3690000,0,0
TIKI,voucher-dich-vu,196047724,"Sandals Camellia Hotel 3* Đà Lạt - Buffet Sáng - Gần Chợ Đà Lạt",977000,977000,0,0
TIKI,balo-va-vali,106391381,"GIÁ HỦY DIỆT Dây đồng hồ HUBLOT nam lót da lộn xanh dương case 42 size 19 - 25 - 22",150000,150000,0,0
TIKI,balo-va-vali,36572094,"Kiềng cổ cưới chạm rồng mạ",304000,435000,131000,30
TIKI,balo-va-vali,139277453,"Mặt dây chuyền Thiên Tâm đài sen MMD016",119000,119000,0,0
TIKI,balo-va-vali,64799522,"Combo Nhẫn cặp phong cách Châu Âu, Màu Bạch kim đính đá, kiểu dáng kim cương, kèm hộp đựng lót nỉ",167000,188000,21000,11
TIKI,balo-va-vali,7436949,"Đồng hồ Casio nam dây thép MTP-1302D-7A1VDF",1476000,1476000,0,0
TIKI,balo-va-vali,23828120,"Vòng Đá Thạch Anh Dâu Tây Xanh Cho Người Mạng Mộc Và Mạng Hỏa",220000,220000,0,0
TIKI,balo-va-vali,68354050,"Lắc Chân Nữ Cỏ 4 Lá May Mắn Bạc Hiểu Minh LC188",259000,390000,131000,34
TIKI,balo-va-vali,85668282,"Đồng hồ nam ORIENT RA-AB0E11B19B Automatic - Dây thép",3802500,5070000,1267500,25
TIKI,balo-va-vali,14437749,"Lắc tay nam mạ vàng",146000,163000,17000,10
TIKI,balo-va-vali,10603374,"Lắc tay lắc chân nữ hoa cúc nhỏ bạc s925 SUFL",59999,59999,0,0
TIKI,balo-va-vali,8293800,"Chuỗi Ngọc Trai Mặt Đá Mã Não Đỏ DB-2010 Bảo Ngọc Jewelry",1280000,1500000,220000,15
TIKI,balo-va-vali,89854650,"Dây chuyền nữ bạc ta mặt dải đá MS73",118000,118000,0,0
TIKI,balo-va-vali,11203699,"Dây đồng hồ da cá sấu 2 mặt (Màu đen)",130000,130000,0,0
TIKI,balo-va-vali,9346857,"Đồng hồ cơ nam Kinyued JYD-J018 dây da chạy full kim",699000,699000,0,0
TIKI,balo-va-vali,129438178,"Vòng đôi nam nữ (vòng tình yêu, vòng bạn thân) dễ thương",24000,24000,0,0
TIKI,balo-va-vali,42194820,"Bông Tai Nam Khuyên Tròn Thép Titan Không Rỉ TT 1037 - 1 Cặp",56000,56000,0,0
TIKI,balo-va-vali,15801394,"Vòng tay phong thủy đá đen nhám khắc kinh phật VT46",90000,90000,0,0
TIKI,balo-va-vali,51503239,"Nhẫn Bạc Nữ - Nhẫn Nữ Đính Đá Tự Nhiên N2470 (2 Màu sắc)",253000,253000,0,0
TIKI,balo-va-vali,59256972,"Bộ Trang Sức Nữ CAO CẤP SANG TRỌNG QUÝ PHÁI",180000,180000,0,0
TIKI,balo-va-vali,37331774,"Nhẫn bạc nam Đính Đá pha lê trằng - Trang sức bạc Panmila (ND.PAJ041.NAM)",120000,120000,0,0
TIKI,balo-va-vali,19843591,"Dây chuyền mặt Phật Độ Mệnh đủ các tuổi nam nữ V40",59000,59000,0,0
TIKI,balo-va-vali,25935733,"Vòng Điều Hoà Huyết Áp Taka sku02 (vòng nam)",695000,695000,0,0
TIKI,balo-va-vali,67336906,"Nhẫn Hổ Phách Baltic Cherry",2070000,2250000,180000,8
TIKI,balo-va-vali,129347327,"Đồng Hồ Nam Casio EFV-600L-2AVUDF",3610000,3610000,0,0
TIKI,balo-va-vali,248862349,"Khuyên tai BẠC nụ đá - Bông tai bạc nam nữ nụ đá BTB07 đơn giản",70000,70000,0,0
TIKI,balo-va-vali,48224481,"Dây Chuyền Bạc Nữ Hình Đuôi Cá Viên Đá Aqua - Vòng Cổ Bạc Cho Nữ DB2364 Bảo Ngọc Jewelry",375000,375000,0,0
TIKI,balo-va-vali,7331691,"Nhẫn Kim Tiền Một Hàng",44500,44500,0,0
TIKI,balo-va-vali,9876113,"Bộ Ngọc Trai Cao Cấp, Bộ Chuỗi Ngọc Trai Cao Cấp, Vòng Cổ Ngọc Trai Làm Quà Tặng Mẹ Màu Xanh Gồm Vòng Cổ Kèm Vòng Tay - BODB1910 - Bảo Ngọc Jewelry",2185000,2300000,115000,5
TIKI,balo-va-vali,37014157,"Nhẫn Trơn Màu Đen Cho Nam Nữ Chất Liệu Thép Titan Cao Cấp Không Rỉ Không Dị Ứng TT 0785",76000,76000,0,0
TIKI,balo-va-vali,89878771,"Dây chuyền nữ bằng bạc hình mặt trăng MS75g",122000,122000,0,0
TIKI,balo-va-vali,47221108,"Chuỗi Lắc Tay Ngọc Trai - Vòng Tay Ngọc Trai Thiết kế 3 Tầng - L2379 - Bảo Ngọc Jewelry",790000,790000,0,0
TIKI,balo-va-vali,8008736,"Vòng tay thạch anh lưu linh trắng charm cỏ 4 lá bạc Ngọc Quý Gemstones",999000,1890000,891000,47
TIKI,balo-va-vali,137164866,"Mặt dây chuyền phật Di Lặc phong thủy đá hổ phách",900000,900000,0,0
TIKI,balo-va-vali,158594762,"Đồng Hồ Nam Dây Thép Casio Standard MTP-VC01D-8EUDF Chính Hãng - MTP-VC01D-8E",1405500,1874000,468500,25
TIKI,balo-va-vali,60855333,"Đồng hồ nam dây da Casio Edifice chính hãng EFV-600CL-3AVUDF (43mm)",3319000,4256000,937000,22
TIKI,balo-va-vali,1655281,"Bông Tai Nụ Ngọc Trai 1863 - Bạc",34900,34900,0,0
TIKI,balo-va-vali,68355376,"Combo Vòng Đeo tay Phong Thủy Gỗ Sưa Vàng Nâu Myanma, Kèm hộp đựng lót lụa Vàng",176000,198000,22000,11
TIKI,balo-va-vali,164423729,"Đồng Hồ Lộ Máy Nam Cao Cấp, Dây Thép Không Gỉ, Mặt Kính Chống Trầy Xước, Chống Nước 3ATM, Lộ Cơ Mặt Và Đáy, Thiết Kế Nhiều Màu Sang Trọng, Nam Tính - BẢO HÀNH 1 NĂM",565000,565000,0,0
TIKI,balo-va-vali,141233572,"Vòng Trầm Hương Tròn Đơn Tốc Việt Size 6/7/8/10/12mm (Nam/Nữ) - Mix Charm Đá Lu Thống - MTH JEWELRY",429000,429000,0,0
TIKI,balo-va-vali,43043353," Nhẫn nam mạ vàng 24k rồng vàng mặt xanh dương N2",99500,99500,0,0
TIKI,balo-va-vali,126492630,"túi xách túi chống sốc cho laptop 13&14 inh cao cấp phong cách mới",297000,330000,33000,10
TIKI,balo-va-vali,20554141,"Cặp xách Laptop 14 inch chống sốc cao cấp",319000,319000,0,0
TIKI,balo-va-vali,149567731,"Balo Laptop Chống Nước Cao Cấp Thương Hiệu Mark Ryden , Balo laptop 17.3 inch  Mr8057 Size Lớn",880000,880000,0,0
TIKI,balo-va-vali,133811312,"Hộp Đựng Bàn Chải , Kem Đánh Răng ( Thân Hộp Có Thể Sử Dụng Như Ly ) - Thích Hợp Với Những Chuyến Du Lịch , Công Tác - Chính Hãng",39000,55000,16000,29
TIKI,balo-va-vali,54811391,"Hộp tiện ích du lịch ETRAVEL vật liệu TRITAN dành cho trẻ em (hộp đựng bàn chải, kem đánh răng, khăn mặt) - tặng kèm bàn chải, khăn mặt",191000,219000,28000,13
TIKI,balo-va-vali,161889273,"VALI HÌNH THÚ SIÊU DỄ THƯƠNG",295000,375000,80000,21
TIKI,balo-va-vali,2298539,"Túi bọc bảo vệ vali -Áo vỏ bọc vali - Hand Digital",250000,250000,0,0
TIKI,balo-va-vali,186638796,"Vali chống va đập hình chữ nhật size 28",1100000,1100000,0,0
TIKI,balo-va-vali,180105851,"VALI KHUNG NHÔM KHOÁ SẬP SIZE 20,24,29 MỚI 2021",690000,690000,0,0
TIKI,balo-va-vali,193087009,"Túi du lịch Mr Vui 114 chất liệu vải ngoài và vải lót cao cấp trơn mịn chống thấm nước chống bám bụi, túi nhiều ngăn phụ và có ngăn đựng giày riêng ( Kích thước 45 x 27 x 25 cm)",359200,449000,89800,20
TIKI,balo-va-vali,711126," Balo Thời Trang HARAS HRTK133 (45 x 30 cm) - Xanh Dương",130000,130000,0,0
TIKI,balo-va-vali,147118947,"Túi Chống Sốc Wiwu Pocket Sleeve Dành Cho Laptop, Ultrabook  Chất Liệu Vải Cao Cấp Canvas Và NyLon - Hàng Chính Hãng",450000,450000,0,0
TIKI,balo-va-vali,144189723,"Tuí đeo chéo, ba lô Nam Nữ thời trang UNISEX BEE GEE 5108",173000,350000,177000,51
TIKI,balo-va-vali,4015331,"Balo laptop Mikkor The Irvin Backpack",750000,750000,0,0
TIKI,balo-va-vali,124484928,"Balo đựng Laptop 15.6 inch khóa mật mã TSA007 khối đa diện vuông kèm cáp sạc ẩn",1499000,1499000,0,0
TIKI,balo-va-vali,225209486,"Balo Mini Da Nữ Tai Mèo Cute, Đeo 2 Kiểu, Tặng Móc Khóa (21x18cm) - ĐEN",169000,169000,0,0
TIKI,balo-va-vali,167953710,"Túi đeo Mikkor The Gibson",990000,990000,0,0
TIKI,balo-va-vali,162584045,"Balo Laptop AGVA Urban Denim 15.6 Black",840000,1050000,210000,20
TIKI,balo-va-vali,14960060,"Túi da thật cầm tay cho Macbook, Laptop 13.3inch - M344",2255000,2255000,0,0
TIKI,balo-va-vali,101789323," Túi xách du lịch tập gym thể thao Ditasi, túi du lịch, túi trống , túi đựng quần áo",144000,144000,0,0
TIKI,balo-va-vali,179781779,"Túi Vải Đựng Giày Dép Dây Rút Chống Bẩn Du Lịch Size Lớn Với Họa Tiết Thiết Kế Đẹp Mắt",4900,4900,0,0
TIKI,balo-va-vali,72289095,"Balo bố leo núi thể thao du lịch JUS20 Tặng móc khóa nam",100237,144787,44550,31
TIKI,balo-va-vali,12133237,"Balo dây kéo ANELLO cỡ vừa AT-B0193A - Màu",2070000,2070000,0,0
TIKI,balo-va-vali,836288,"Vali Sakos Champion 4.5 SLX055BKF (52 x 34 cm) - Đen",1671000,1969000,298000,15
TIKI,balo-va-vali,170813949,"Túi Sách Dọc Và Túi Sách Ngang WIWU ALPHA SLIM SLEEVE Dành Cho Laptop, Macbook Chất liệu Vải Sợi Nylon Cao Cấp - Hàng Chính Hãng",400000,400000,0,0
TIKI,balo-va-vali,72199512,"Balo nam thời trang phối chỉ màu cao cấp hàn quốc K-0097 Tặng móc khóa nam siêu ngầu",94050,128535,34485,27
TIKI,balo-va-vali,153978957,"Túi chống sốc AGVA Heritage 15 inch LTB323GRE (Xám) - Kích thước Cao 40 x Rộng 5 x Ngang 28 cm - Bảo hành chính hãng 2 năm",650000,650000,0,0
TIKI,balo-va-vali,2169723,"Túi bọc bảo vệ vali 3-CHU-GAU (Size L)",224000,350000,126000,36
TIKI,balo-va-vali,190519949,"Túi Du Lịch Mr Vui DL107 thời trang và thanh lịch",344250,382500,38250,10
TIKI,balo-va-vali,14994859,"Túi bọc bảo vệ vali - Áo vỏ bọc vali H12",149000,232000,83000,36
TIKI,balo-va-vali,149451727,"Vali kéo du lịch khung nhôm khoá sập,vali khóa kéo nhựa size 20, size 24",1250000,1250000,0,0
TIKI,balo-va-vali,179988888,"Túi chống sốc chính hãng UAG Shock Sleeve Lite Cho iPad Pro 12.9 inch 2021/2020/2018",1400000,1400000,0,0
TIKI,balo-va-vali,35755908,"Balo Nữ Vải Dù Thanh Lịch, Trẻ Trung Chống Trộm G1254",155000,155000,0,0
TIKI,balo-va-vali,790841,"Balo Laptop Mikkor The Edwin TEB003 - Xám đen (15.6" - Mac 17")",690000,690000,0,0
TIKI,balo-va-vali,152785729,"Ba Lô dành cho Laptop 15.6" TARGUS Sport Backpack - Hàng Chính Hãng",376000,490000,114000,23
TIKI,balo-va-vali,229726268,"Balo Classic Praza New Version BLTK140 (42 x 30 cm)",159000,199000,40000,20
TIKI,balo-va-vali,193124913,"Túi Chống Sốc Laptop Cao Cấp Vải Trơn Mịn Nhiều Màu Sắc 14 Inch - 15 Inch, Chống Thấm Nước, Thời Trang Dùng Cho iPad/ Macbook/ Surface/ Laptop",150000,150000,0,0
TIKI,balo-va-vali,20241668,"Vali Kéo Vải Du Lịch SAKOS  ELITE 6 - Size M (24inch)/ Ký Gửi (Trung) - Khóa TSA - Chống Thấm, Trượt Nước",4144000,6040000,1896000,31
TIKI,balo-va-vali,195791131,"Balo nam phong cách châu Âu - BEE GEE BLLT5534",901000,1820000,919000,50
TIKI,balo-va-vali,55967494,"Bao da , Cặp Da , Túi đựng Cao Cấp cho Macbook Air / Macbook Pro 13 / Surface Pro / Laptop 13inch",229000,229000,0,0
TIKI,tui-vi-nu,73341200,"VÍ MINI ĐỰNG THẺ Bóp Cardholder ZERO Da Saffiano Nhập Khẩu Cao Cấp Chống Thấm Nước Unisex Nam Nữ Chuẩn Nome DOLANTO",150000,150000,0,0
TIKI,tui-vi-nu,83941262,"Ví da Mini đựng card Visit - Ví đựng thẻ kiểu dáng nhỏ gọn - Ví da thật handmade - Đồ da thủ công cao cấp",399000,399000,0,0
TIKI,tui-vi-nu,144630552,"Túi xách , Túi đeo vai nữ thời trang Hàn Quốc trẻ trung KN289",125000,125000,0,0
TIKI,tui-vi-nu,183250364,"Túi Tote Đeo Vai Vải Canvas Siêu Dễ Thương Phong Cách Hàn Quốc - Con Vật Nhiều Mẫu M3",58000,58000,0,0
TIKI,tui-vi-nu,8280862,"Túi Vải Canvas - Collect Moments",121000,169000,48000,28
TIKI,tui-vi-nu,56323008,"TÚI ĐEO CHÉO NỮ CÔNG SỞ THỜI TRANG MADT113",69000,69000,0,0
TIKI,tui-vi-nu,190337006,"Túi xách nữ công sở đựng laptop dáng đứng tote thời trang Yuumy YTX18",235000,520000,285000,55
TIKI,tui-vi-nu,107276170,"Túi Vải Canvas Đeo Chéo Phong Cách Harajuku Nhật Bản Cho Nữ",81900,81900,0,0
TIKI,tui-vi-nu,100129513,"[VOUCHER 30K] Túi đeo chéo nữ thời trang LATA HN92 mang phong cách thanh lịch, sang trọng",520000,520000,0,0
TIKI,tui-vi-nu,86561480,"Túi đeo chéo   Túi vải Tote vải Canvas Phong Cách Hàn Quốc TV18",25000,25000,0,0
TIKI,tui-vi-nu,74255457,"Túi xách tote vải Túi Tote Túi Vải Nữ Túi Đeo Chéo Hàn Quốc Mèo lười",45600,45600,0,0
TIKI,tui-vi-nu,72032534,"Túi xách nữ thời trang cao cấp ELLY- EL137",899000,899000,0,0
TIKI,tui-vi-nu,43543689,"Ví bóp cầm tay da nữ mini đẹp LATIA VD220",31000,31000,0,0
TIKI,tui-vi-nu,147346886,"Vỏ bọc thẻ căn cước công dân,thẻ ngân hàng,chứng minh thư,thẻ tín dụng,bằng lái xe - K39",1499,1499,0,0
TIKI,tui-vi-nu,83673067,"Túi đeo chéo nữ Lata HN86",469000,520000,51000,10
TIKI,tui-vi-nu,145787059,"TÚI CÓI ĐI BIỂN, TÚI CÓI MERCI TÚI HOT TREND ĐI CHƠI, ĐI BIỂN, ĐI LÀM.........",36500,36500,0,0
TIKI,tui-vi-nu,160314028,"Túi Xách Nữ Đeo Vai Kẹp Nách Chính Hãng MICOCAH Dáng Công Sở Thời Trang Size Lớn Tiện Dụng Da Cao Cấp Cực Đẹp MC58",449000,449000,0,0
TIKI,tui-vi-nu,136940062,"TÚI THỔ CẨM ĐEO CHÉO ĐỰNG ĐIỆN THOẠI",15000,15000,0,0
TIKI,tui-vi-nu,193051834,"Ví Cầm Tay Nữ Dài Đeo Chéo Cao Cấp Sang Trọng Phong Cách Hàn Quốc TVNN262",259000,259000,0,0
TIKI,tui-vi-nu,32747699,"Ví bóp nữ mini cầm tay sang trọng VI-005 - Xanh dương",119000,119000,0,0
TIKI,tui-vi-nu,52671241,"Bóp Ví Nữ Cầm Tay Ngắn SVT-Vinu20 Phong Cách Châu Âu",89000,89000,0,0
TIKI,tui-vi-nu,44153043,"Túi bao tử nữ đeo chéo trước ngực, đeo hông cá tính TX00279",99000,99000,0,0
TIKI,tui-vi-nu,160314703,"Túi Xách Nữ Kẹp Nách Đeo Vai Đeo Chéo MICOCAH Dáng Công Sở Thời Trang Ulzzang Da Cao Cấp Siêu Đẹp Giá Rẻ MC75 - Micocah",439000,439000,0,0
TIKI,tui-vi-nu,53934661,"Túi xách nữ đeo chéo phong cách châu âu hiện đại",225000,250000,25000,10
TIKI,tui-vi-nu,88798763,"Túi vải canvas đeo chéo phong cách thời trang hàn quốc, túi đeo cho nữ nhỏ xinh với 2 ngăn đựng đồ tiện lợi-TẶNG KÈM GẤU BÔNG CỰC MINI DỄ THƯƠNG",125000,125000,0,0
TIKI,tui-vi-nu,195971769,"Túi xách nữ cao cấp da thật ELLY – ET142",2999000,2999000,0,0
TIKI,tui-vi-nu,193044379,"Túi xách nữ thời trang công sở cao cấp phong cách mới",477000,530000,53000,10
TIKI,tui-vi-nu,75389928,"Ví dự tiệc cưới sang trọng, kèm dây xích sang trọng, đẳng cấp (Nhiều mẫu để chọn)",240000,400000,160000,40
TIKI,tui-vi-nu,107962222,"Ví nữ đựng tiền kiểu dáng mini nhỏ gọn sang chảnh",159000,159000,0,0
TIKI,tui-vi-nu,191775112,"Túi Xách Nữ Kẹp Nách Chính Hãng MICOCAH Dáng Công Sở Thời Trang Sang Trọng Phối Vân Da Rắn Cao Cấp Cực Đẹp MC130 - Micocah",539000,539000,0,0
TIKI,tui-vi-nu,90531483,"Túi xách nữ thời trang cao cấp",327000,362700,35700,10
TIKI,tui-vi-nu,174469052,"Ví Nữ Ngắn Mini Cầm Tay BATSIOE Nhỏ Gọn Nhiều Ngăn Đựng Tiền Đựng Thẻ Chất Da Cao Cấp Giá Rẻ BS03",129000,129000,0,0
TIKI,tui-vi-nu,58046040,"Túi Đeo Chéo Bao Tử Da Hàn Quốc Nữ Thêu Chỉ Nổi Hình Quả Trám Đen",62000,79000,17000,22
TIKI,tui-vi-nu,182713607,"Ví Nữ Monogram Canvas ELLY – EV88",999000,999000,0,0
TIKI,tui-vi-nu,24733708,"Ví Bóp Cầm Tay Nữ Ngắn Thời Trang GD Khóa Bấm Đính Con Ong Nhiều Ngăn Tiện Dụng",49000,49000,0,0
TIKI,tui-vi-nu,136940154,"TÚI VÍ THỔ CẨM ĐỰNG TIỀN",15000,15000,0,0
TIKI,tui-vi-nu,73755073,"Túi xách đeo vai phiên bản Hàn Quốc  họa tiết hoạt hình cực kỳ dễ thương cho các teen girl - SB120 (Giao mẫu ngẫu nhiên)",68899,68899,0,0
TIKI,tui-vi-nu,219457402,"dây da phối xích co giãn tốt, tự điều chỉnh độ dài theo ý, dây túi đeo vai túi xách quai túi hoặc xích không kèm da",100000,100000,0,0
TIKI,tui-vi-nu,175195781,"Ví nữ dài cầm tay nhiều ngăn LOVE đẹp thời trang TK007",59000,118000,59000,50
TIKI,tui-vi-nu,183248987,"Túi Tote Đeo Vai Vải Canvas Siêu Dễ Thương Phong Cách Hàn Quốc - Ly Nước Nhiều Mẫu M2",58000,58000,0,0
TIKI,dong-ho-va-trang-suc,122311273,"Vòng tay Trầm Hương Trụ Trúc Việt Nam - Đẳng Cấp, Sang Trọng - Tốc Banh - 9 trụ 9 hạt - Thiên Mộc Hương",2371500,2790000,418500,15
TIKI,dong-ho-va-trang-suc,55014646,"Vòng tay dây đen thắt hạt đá thiên nhiên - Ngọc Quý Gemstones",159000,300000,141000,47
TIKI,dong-ho-va-trang-suc,98634341,"Vòng tay dây gút",7800,7800,0,0
TIKI,dong-ho-va-trang-suc,54751825,"Mặt dây chuyền hạt đá thiên nhiên - Ngọc Quý Gemstones",369000,730000,361000,49
TIKI,dong-ho-va-trang-suc,74306401,"Dây Chuyền Swarovski Pha Lê Trái Tim Tình Yêu",1622000,1622000,0,0
TIKI,dong-ho-va-trang-suc,16931722,"Nhẫn nam quân đội Mỹ mạ Vàng 24k mặt đá đỏ N10",99000,99000,0,0
TIKI,dong-ho-va-trang-suc,159730187,"Đồng Hồ Nam Dây Da Casio Standard MTP-VD02BL-2EUDF Chính Hãng - MTP-VD02BL-2E",962250,1283000,320750,25
TIKI,dong-ho-va-trang-suc,102602552,"VÒNG TAY LU THỐNG ĐÁ PHONG THUỶ VẠN SỰ HANH THÔNG",240000,240000,0,0
TIKI,dong-ho-va-trang-suc,46209581,"Bộ Trang Sức 3 Món Đính Đá Saphire Cao Cấp Cho Nữ - BNT613 - Bảo Ngọc Jewelry [THIẾT KẾ ĐỘC QUYỀN]",1150000,1150000,0,0
TIKI,dong-ho-va-trang-suc,11338157,"Cặp nhẫn Bạc Panmila - Nhẫn đôi tình yêu (TS-ND-A3)",149000,149000,0,0
TIKI,dong-ho-va-trang-suc,177787632,"Vòng tay inox nam trơn hở hai đầu bản 6mm",120000,120000,0,0
TIKI,dong-ho-va-trang-suc,19728992,"Đồng Hồ Nam Citizen Dây Da NH8360-12A - Mặt Trắng",5585000,5585000,0,0
TIKI,dong-ho-va-trang-suc,214825094," Vòng cổ dài hình chiếc lá đính hạt lấp lánh cho nữ",57000,60000,3000,5
TIKI,dong-ho-va-trang-suc,22782187,"Vòng tay nữ đính xoàn dát",259000,259000,0,0
TIKI,dong-ho-va-trang-suc,25408070,"Vòng Tay May Mắn Hạt Đá Phong Thủy Đá Núi Lửa Obsidian",31000,31000,0,0
TIKI,dong-ho-va-trang-suc,191281267,"Đồng hồ nữ dây da Julius Ja-925",589000,589000,0,0
TIKI,dong-ho-va-trang-suc,64037934,"Đồng hồ Casio Nữ Baby G BA-130-7A2DR",4407000,4407000,0,0
TIKI,dong-ho-va-trang-suc,194432931,"Đồng Hồ Điện Tử Đeo Tay F-91W Huyền Thoại (Đen)",42750,45000,2250,5
TIKI,dong-ho-va-trang-suc,12114220,"Vòng Tay Tỳ Hưu Đá Mã Não Tự Nhiên 9mm",153000,153000,0,0
TIKI,dong-ho-va-trang-suc,103809048,"(6.5 LÍT ) Máy Rửa bằng Sóng Siêu Âm, Máy Rửa Trang Sức, Linh Kiện Điện Tử, Linh Kiện Cơ Khí, Nha Khoa Bằng Sóng Siêu ÂM",4500000,4500000,0,0
TIKI,dong-ho-va-trang-suc,147782522,"Đồng hồ nam Orient RE-AU0001S00B - Đồng hồ cơ hiển thị dự trữ năng lượng, lên dây cót bằng tay, mặt kính sapphire chống xước, mức chống nước 5 ATM, dây da thời trang cao cấp, chính hãng, bảo hành quốc tế 1 năm, phân phối độc quyền Galle Watch",20854000,23160000,2306000,10
TIKI,dong-ho-va-trang-suc,192329351,"CECI - Khuyên tai nữ dạng kẹp một bên tai cá tính CC1-04000036",49000,250000,201000,80
TIKI,dong-ho-va-trang-suc,177497222,"Dây chuyền vàng 14k Huy Thanh Jewelry DCMAMD535",4131000,4131000,0,0
TIKI,dong-ho-va-trang-suc,68144509,"Vòng Tay Chuỗi Hạt Trầm Hương 108 Hạt Size 6mm, Mùi thơm vĩnh viễn",160000,160000,0,0
TIKI,dong-ho-va-trang-suc,58185905,"Bông tai nữ Bạc Quang Thản dáng dài treo hình trái tim gắn đá màu trắng chất liệu bạc thật không xi mạ  - QTBT43",175000,175000,0,0
TIKI,dong-ho-va-trang-suc,11897663,"Đồng Hồ Mix Đá Mắt Hổ Đen Đỏ DHN28 Bảo Ngọc Jewelry",493000,690000,197000,29
TIKI,dong-ho-va-trang-suc,16836619,"Vòng tay nam nữ bện chỉ đỏ tròn đính 2 hạt ngọc CD19",22000,22000,0,0
TIKI,dong-ho-va-trang-suc,173426064,"Đồng Hồ Nam Dây Nhựa Casio G-Shock GBD-200RD-4DR Chính Hãng - GBD-200RD-4 Bluetooth",4349000,5441000,1092000,20
TIKI,dong-ho-va-trang-suc,180105022,"Pin đồng hồ chính hãng Maxell 377 SR626SW AG4 dành cho đồng hồ, thiết bị điện tử - 1 Viên",15000,15000,0,0
TIKI,dong-ho-va-trang-suc,144531539,"Vòng Cổ (Dây Chuyền) Thạch Anh Hồng Madagascar, Pink Quartz 8MM Tự Nhiên,Trang Sức Phong Thuỷ, Chuỗi Hạt, Hoả, Thổ - Bead Art",120000,120000,0,0
TIKI,balo-va-vali,190119237,"Sách nói: Hành Lý Hư Vô",99000,99000,0,0
TIKI,dong-ho-va-trang-suc,174536458,"Vòng Tay Hạt Bồ Đề Kim Cang (Rudraksha) Từ Tibet, Mệnh Mộc, Hoả, Chuỗi Hạt , Vòng Tay Phong Thuỷ - Bead Art",496000,496000,0,0
TIKI,balo-va-vali,179952283,"[Giftpop] Phiếu Quà Tặng TOUS les JOURS 500K",500000,500000,0,0
TIKI,dong-ho-va-trang-suc,106390694,"Combo dây đồng hồ, dụng cụ cắt dây, thay dây",190000,190000,0,0
TIKI,dong-ho-va-trang-suc,19275615,"CUỘN DÂY THUN CO GIÃN TO DẦY 1MM ĐỂ XỎ VÒNG TAY BẰNG GỖ MÀU ĐEN",64500,64500,0,0
TIKI,balo-va-vali,249262111,"Khóa thông minh nhận diện khuôn mặt Face ID 3D , vân tay, thẻ từ, mật khẩu công nghệ Đức Demax SL918 PB",15032000,15032000,0,0
TIKI,balo-va-vali,250070936,"Sách - Bùng nổ tiếng Anh – 27 giới từ hữu ích trong tiếng Anh giao tiếp - Thái Hà",169150,199000,29850,15
TIKI,dong-ho-va-trang-suc,26449087,"Bông tai đá cẩm thạch 10mm mệnh hỏa , mộc - Ngọc Quý Gemstones",309000,605000,296000,49
TIKI,balo-va-vali,189201599,"Sách nói: Những Bá Chủ Không Gian",99000,99000,0,0
TIKI,dong-ho-va-trang-suc,10781909,"Vòng tay nữ mã não đỏ may mắn nhiều kích thước VT31A",100000,100000,0,0
TIKI,balo-va-vali,274181930,"[Red River Tour] Đi Bộ Dưới Đáy Biển "Seawalker" Tại Công Viên San Hô Phú Quốc Hằng Ngày",1215000,1350000,135000,10
TIKI,balo-va-vali,199630798,"Trò chơi vận động 3in1 Game Bull Track Cả Nhà Cùng Vui (Full Option) ",468000,468000,0,0
TIKI,balo-va-vali,155109972,"Sách nói: Những Gã Khổng Lồ Trung Quốc",99000,99000,0,0
TIKI,balo-va-vali,131137801,"Bài giảng trực tuyến Kỹ năng chuẩn bị lịch và nội dung chương trình",50000,50000,0,0
TIKI,balo-va-vali,119947168,"[E-BOOK] Tiếng Anh 6 Right on! Sách giáo viên điện tử Bài học",15000,15000,0,0
TIKI,balo-va-vali,221701804,"Phiếu Quà Tặng Cân - Taiwanese Street Hotpot 500K",475000,500000,25000,5
TIKI,dong-ho-va-trang-suc,195862815,"NHẪN CHIM CÔNG - KHỔNG TƯỚC MẠ BẠC - BIỂU TƯỢNG QUYẾN RŨ , QUYỀN LỰC",110000,110000,0,0
TIKI,balo-va-vali,183348319,"Sách nói: 5 Phương Thức Ghi Nhận Sự Nỗ Lực Của Nhân Viên",99000,99000,0,0
TIKI,balo-va-vali,203477303,"Tẩy trắng răng phương pháp Laser Whitening 5P - Nha khoa BeDental (5 chi nhánh)",899000,899000,0,0
TIKI,balo-va-vali,247936680,"ELSA Speak Pro 1 năm- Phần mềm tiếng Anh Online chất lượng cao",945000,945000,0,0
TIKI,dong-ho-va-trang-suc,116142575,"Vòng đeo tay, lắc tay phong thủy quấn 3 vòng đá aquamarine",350000,350000,0,0
TIKI,balo-va-vali,176025212,"Sách nói: Phương Pháp Ăn Uống Cải Thiện Lưu Thông Máu",99000,99000,0,0
TIKI,balo-va-vali,197107344,"Đèn Led Softlight SL-288A dùng quay phim và chụp ảnh KingMa ",2868000,2868000,0,0
TIKI,balo-va-vali,182834070,"Sách nói: Ngợi Ca Tình Yêu Thương",99000,99000,0,0
TIKI,balo-va-vali,187643720,"Sách nói: 50 Bài Học Cơ Bản Để Trở Thành Người Lịch Thiệp",99000,99000,0,0
TIKI,balo-va-vali,207345000,"Sách nói Những Lời Giáo Huấn Của Epictetus",99000,99000,0,0
TIKI,dong-ho-va-trang-suc,75728547,"Dây Da Đồng Hồ Julius Hàn Quốc Size 10 - Chọn Màu",129000,129000,0,0
TIKI,balo-va-vali,188897976,"Sách nói: Điểm đến của cuộc đời",99000,99000,0,0
TIKI,balo-va-vali,273902078,"Toàn quốc [E-Voucher] Phiếu quà tặng trị giá 500k, áp dụng cho mọi sản phẩm tại web/app Potico.vn",400000,400000,0,0
TIKI,balo-va-vali,221701776,"Phiếu Quà Tặng Cân - Taiwanese Street Hotpot 100K",95000,100000,5000,5
TIKI,balo-va-vali,211927114,"Phiếu Quà Tặng Au Lac Do Brazil 1000K",1000000,1000000,0,0
TIKI,balo-va-vali,177128197,"Sách nói: Sức Khỏe Trong Tay Bạn - Tập 1",99000,99000,0,0
TIKI,balo-va-vali,152663509,"Sách nói: Nho Giáo",99000,99000,0,0
TIKI,dong-ho-va-trang-suc,469035,"Đồng Hồ Nữ Dây Da Julius JA-766L-Hồng",515000,515000,0,0
TIKI,balo-va-vali,200822866,"Sách nói: Việt Nam Phong Tục",99000,99000,0,0
TIKI,balo-va-vali,178068944,"Sách nói: Khởi Nghiệp Kinh Doanh Online - Bán Hàng Hiệu Quả Trên F.a.c.e.b.o.o.k",99000,99000,0,0
TIKI,balo-va-vali,270834157,"Evoucher Phiếu Quà Tặng Jeonbok - BaoYu 50K ",47500,50000,2500,5
TIKI,balo-va-vali,260803635,"Evoucher - Phiếu Quà Tặng Nha Khoa Smile Beauty 100K",95000,100000,5000,5
TIKI,balo-va-vali,177253548,"Sách nói: Kẻ Khôn Đi Lối Khác",99000,99000,0,0
TIKI,balo-va-vali,274274717,"Tour trong ngày Rừng Dừa Bảy Mẫu (DAVTC07)",300000,300000,0,0
TIKI,dong-ho-va-trang-suc,192711875,"Khuyên Tai Phối Đá Opal Phong Cách Hàn Quốc Thanh Lịch",9089,14900,5811,39
TIKI,balo-va-vali,274192065,"Tour Đà Nẵng – Hội An – Huế 3N2D (VTC04)",2350000,2350000,0,0
TIKI,balo-va-vali,274241177,"Tour trong ngày Cù Lao Chàm (DAVTC04)",550000,550000,0,0
TIKI,balo-va-vali,178572168,"Sách nói: Cho Đời Bớt Muộn Phiền",99000,99000,0,0
TIKI,balo-va-vali,179722135,"Sách nói: Lẽ Phải Của Phi Lý Trí",99000,99000,0,0
TIKI,balo-va-vali,274182655,"[Red River Tour] Cano 4 Đảo Phú Quốc Hằng Ngày",515200,560000,44800,8
TIKI,balo-va-vali,186312660,"Sách nói: Phụ Nữ Thông Minh Không Ở Góc Văn Phòng",99000,99000,0,0
TIKI,balo-va-vali,191651830,"Phiếu Quà Tặng Mắt Kính Tâm Đức 500K",475000,500000,25000,5
TIKI,balo-va-vali,177978212,"Sách nói: Phố Đàn Bà",99000,99000,0,0
TIKI,balo-va-vali,186305131,"Sách nói: Pháp Môn Hạnh Phúc: Gia Đình",99000,99000,0,0
TIKI,tui-thoi-trang-nam,19729892,"Túi đeo chéo vải bố nam TX0003",327600,455000,127400,28
TIKI,tui-thoi-trang-nam,141009896,"Túi đeo chéo nam cao cấp, vải Oxford chống nhăn,chống thấm nước,chống bám bụi, túi đeo vai phong cách thời trang Châu Âu",399000,399000,0,0
TIKI,tui-thoi-trang-nam,4699077,"Cặp đa năng văn phòng chỉ xéo",184115,251624,67509,27
TIKI,tui-thoi-trang-nam,94038063,"Túi đeo hông nam nữ Túi đeo chéo chạy bộ Túi thể thao dã ngoại Sport TTC1 kích thước 31 x11 x 19 cm",34303,49549,15246,31
TIKI,tui-thoi-trang-nam,78950876,"Túi xách nam công sở 100% da bò thật cao cấp phong cách mới",899000,998000,99000,10
TIKI,tui-thoi-trang-nam,56512790,"Ví nam cầm tay cao cấp",129000,129000,0,0
TIKI,tui-thoi-trang-nam,37938772,"Cặp Xách Da Công Sở P073",375250,395000,19750,5
TIKI,tui-thoi-trang-nam,54001669,"Đeo chéo hông bụng nam nữTĐ 5528 dạng lớn hàn quốc HGF01",118057,161345,43288,27
TIKI,tui-thoi-trang-nam,51662045,"Túi Đeo Chéo Nam Da Cá Sấu CS1",219000,219000,0,0
TIKI,tui-thoi-trang-nam,125097857,"Ví nam, bóp nam da bò sáp Bụi Leather V105 - Bảo hành 12 tháng",209000,370000,161000,44
TIKI,tui-thoi-trang-nam,186210607,"Túi xách nam công sở, cặp da nam đựng laptop và tài liệu cao cấp CGL10",3400000,3400000,0,0
TIKI,tui-thoi-trang-nam,68658966,"Túi đeo chéo vải bố thời trang 2001",170000,170000,0,0
TIKI,tui-thoi-trang-nam,38050388,"Túi Đeo Chéo Phản Quang Phát Sáng Thời Trang Hàn Quốc FALDO",219000,219000,0,0
TIKI,tui-thoi-trang-nam,103887358,"Bóp Da Cá Sấu Ví Nam Cá Sấu Phần Bụng Cao Cấp Giá Rẻ Màu Nâu ST04 Tặng Kèm Hộp Tặng Móc Khóa Cá Sấu",750000,750000,0,0
TIKI,tui-thoi-trang-nam,147799009,"Ví Da Nam Bò Sáp Nhiều Ngăn Tiện Dụng Kiểu Dáng Sang Trọng Nam Tính",168000,336000,168000,50
TIKI,tui-vi-nu,25962563,"Nhẫn Nam Chạm Rồng Mẫu 04",88500,88500,0,0
TIKI,tui-vi-nu,17930027,"Đồng hồ Nữ Halei  HL 465 + Tặng Combo TẨY DA CHẾT APPLE WHITE PELLING GEL BEAUSKIN chính hãng",190000,200000,10000,5
TIKI,tui-thoi-trang-nam,13565884,"Túi bao tử đeo chéo nam",180000,180000,0,0
TIKI,tui-thoi-trang-nam,122911181,"Túi bao tử chính hãng thương hiệu Simplecarry Credo Sling 3",440000,440000,0,0
TIKI,tui-thoi-trang-nam,89837896,"Ví nam cầm tay da bò Gianni Conti VP0169DBR",4100000,4100000,0,0
TIKI,tui-vi-nu,203959089,"Hoa Tai Bông Tai Khuyên Tai Nữ - Bảo Hành Vĩnh Viễn ( Hàng Chính Hãng ) Bạc Hiểu Minh HT324",330000,330000,0,0
TIKI,tui-thoi-trang-nam,771415,"Túi Đeo Chéo Nam Haras HRTK083 (26 x 17 cm) - Xanh",65000,65000,0,0
TIKI,tui-thoi-trang-nam,70846687,"Túi đeo chéo nam nữ unisex thời trang Hàn quốc BEE GEE 098 để được laptop và áo quần",99000,199000,100000,50
TIKI,tui-vi-nu,46692821,"Đồng Hồ Nữ Thời Trang Dây Vàng Mặt Tròn",284000,299000,15000,5
TIKI,tui-vi-nu,84547349,"Vòng tay đá phong thuỷ nam nữ dạ quang phát sáng trong đêm phong cách Hàn Quốc",119000,119000,0,0
TIKI,tui-thoi-trang-nam,130070341," Túi đeo chéo nam nữ phong cách lính",137000,137000,0,0
TIKI,tui-thoi-trang-nam,176130327,"Bóp ví nam có khóa kéo thời trang tiện lợi kiểu dáng hàn quốc ví nam cầm tay cao cấp Mã: MB21",178000,178000,0,0
TIKI,tui-vi-nu,73333316,"Bộ Trang sức mạ vàng 18K, Phong cách châu Âu, Kiểu xoắn, cỡ dây 3li, kèm hộp đựng lót nhung gấm",88000,99000,11000,11
TIKI,tui-thoi-trang-nam,125280023,"Ví nam, bóp nam da bò Saffiano Bụi Leather V128 - Bảo hành 12 tháng",229000,412000,183000,44
TIKI,tui-thoi-trang-nam,75319988,"Túi đeo chéo unisex thời trang HARAS HR276",80000,80000,0,0
TIKI,tui-thoi-trang-nam,3282989,"Túi đeo chéo da nam [HÀNG NHẬP] DTN12-2TI",76000,76000,0,0
TIKI,tui-vi-nu,58299215,"Nhẫn nam đá cẩm thạch phỉ thúy ni 20 mệnh hỏa, mộc - Ngọc Quý Gemstones",999000,1430000,431000,30
TIKI,tui-vi-nu,116142873,"Vòng đeo tay, lắc tay phong thủy quấn 3 vòng đá beryl",380000,380000,0,0
TIKI,tui-thoi-trang-nam,146987945," Ví Da Nam Nhiều Ngăn VD04 Kiểu Đứng Đơn Giản Cá Tính",38000,50000,12000,24
TIKI,tui-thoi-trang-nam,193201445,"Túi Đeo Vai, Túi Đeo Chéo Da PU, Túi Đeo Hông Cao Cấp Nhiều Ngăn Tiện Lợi Thời Trang Nam Phong Cách Hàn Quốc",95000,95000,0,0
TIKI,tui-thoi-trang-nam,190514895,"Túi đeo chéo nam nữ thể thao chạy bộ Haosua cao cấp Shalla",128828,186085,57257,31
TIKI,tui-vi-nu,76086288,"Combo Nhẫn Nam Nữ Kiểu cổ, Khắc đúc hình đầu Sư Tử, đính đá Zircorn, Chất liệu hợp kim titanium, Kèm túi đựng Nhẫn bằng Nhung mềm",87000,98000,11000,11
TIKI,tui-thoi-trang-nam,190514977,"Túi đeo chéo Chống nước PVC cao cấp đường xéo góc HÀNG NHẬP VB67",128066,184984,56918,31
TIKI,tui-vi-nu,13743146,"Dây chuyền bạc - Dây chuyền nữ hình chiếc giày Cinderella [TS-DC-A8]",195000,195000,0,0
TIKI,tui-vi-nu,73763380,"Nhẫn bạc yên ngựa đá ngọc bích",250000,250000,0,0
TIKI,tui-vi-nu,56209259,"Charm bạc tỳ hưu xỏ ngang - Ngọc Quý Gemstones",100000,160000,60000,38
TIKI,tui-thoi-trang-nam,107962047,"Ví Nam Da Bò Thật Dáng Đứng Đẳng Cấp Quý Ông",259000,259000,0,0
TIKI,tui-vi-nu,57772671,"VÒNG TAY ĐÁ CẨM THẠCH CAO CẮP ĐẸP XANH LÝ SƠN THỦY A 49 NỮ 49KG ĐẾN 58KG ",2500000,5000000,2500000,50
TIKI,tui-thoi-trang-nam,157254213,"Túi Mini SAIGON SWAGGER SGS Mini Bag",200000,200000,0,0
TIKI,tui-thoi-trang-nam,189491562,"Túi đeo chéo nam DA THẬT cao cấp phong cách mới – BEE GEE DCN9071",1238000,2500000,1262000,50
TIKI,tui-vi-nu,10197373,"Bông tai nữ bông tai Bạc cao cấp 925 đính đá xanh Hàn Quốc - Bông tai bạc thật s925 tự nhiên B1448 bảo Ngọc Jewelry",219000,257000,38000,15
TIKI,tui-vi-nu,19557897,"Dây chuyền nam Rồng vàng mạ Vàng 24k MD11",201000,227000,26000,11
TIKI,tui-vi-nu,55129835,"Lắc Tay Nữ | Lắc Tay Nữ Bạc S925 Trái Tim Nhẹ Nhàng L2528 - Bảo Ngọc Jewelry",257000,257000,0,0
TIKI,tui-vi-nu,53973989,"Đồng hồ nam chính hãng Lobinni No.1023LT-4 ( Phiên bản Đặc biệt )",4150000,6071429,1921429,32
TIKI,tui-vi-nu,92627280,"DÂY ĐỒNG HỒ DA BÒ THẬT NÂU ĐẤT DÀNH CHO APPLE WATCH - HÀNG CHÍNH HÃNG",169000,169000,0,0
TIKI,tui-vi-nu,182603379,"Vòng Mới đá ngọc cẩm thạch tự nhiên TR Lý A SAO 50 Size vòng 50mm x 7,2mm Màu Xanh ngọc lý trắng bóng nhẹ nhàng đẹp bóng xinh đẹp nữ 50kg - 55kg đeo đẹp ạ Món Quà Ý nghĩa Anh Chị tặng Mẹ, Vợ, người thân yêu ạ",1850000,3700000,1850000,50
TIKI,tui-vi-nu,1812213,"Vòng Tay Đá Mã Não Đỏ Liền Khối Ngọc Quý Gemstones VT152",306000,360000,54000,15
TIKI,tui-vi-nu,91471707,"Combo Nhẫn Xoàn, Kiểu dáng Ruby, Hợp Nam Nữ Phong Phong cách Châu Âu, chất liệu hợp kim tráng Platin, đính 95 viên đá,  Kèm túi đựng Cung Hỷ",185000,208000,23000,11
TIKI,tui-vi-nu,169577681,"Đồng hồ nam thời trang cao cấp DEYROS dây thép mành chạy lịch ngày cao cấp mẫu ST225",278000,278000,0,0
TIKI,tui-vi-nu,72517753,"Đồng Hồ Điện Tử Trẻ Em Đèn Led Họa Tiết Hoạt Hình 3D Xinh Xắn DH109",24199,24199,0,0
TIKI,tui-vi-nu,213731018,"Vòng tay phong thủy đá mắt hổ MDJ VIP 10 và 12 li đeo tay nam nữ đẹp hợp mệnh kim thủy mộc hỏa thổ",284000,299000,15000,5
TIKI,tui-vi-nu,89854824,"Nhẫn nam bạc ta cao cấp MS35c",519000,519000,0,0
TIKI,tui-vi-nu,46717543,"Vòng tay đá cẩm thạch thiên nhiên bản tròn mệnh mộc hỏa",1599000,2000000,401000,20
TIKI,tui-thoi-trang-nam,68887596,"Túi đeo chéo nam vải Oxford chống thấm",699000,699000,0,0
TIKI,tui-vi-nu,77093035,"Vòng tay phong thủy Thạch anh tím 12 ly, vòng tay chuỗi hạt đá",118750,125000,6250,5
TIKI,tui-vi-nu,16862540,"Vòng Tay Đá Tourmaline 10MM Kèm Giấy Kiểm Định PNJ",2459000,2459000,0,0
TIKI,tui-vi-nu,14340382,"Dây đồng hồ da bò cho Seiko 5 quân đội bản 37mm",99000,99000,0,0
TIKI,tui-vi-nu,46336972,"Vòng tay mã não đen bản vuông mệnh thủy, kim - Ngọc Quý Gemstones",299000,590000,291000,49
TIKI,tui-thoi-trang-nam,164338780,"Bóp Nam, Ví Nam P016 – Thiết Kế Độc Đáo – Sang trọng – Tiện Dụng",47000,58000,11000,19
TIKI,tui-vi-nu,49734127,"Nhẫn Nữ Đính Đá Titan Ko Đen TT 2235",121000,121000,0,0
TIKI,voucher-dich-vu,247798421,"Voucher Buffet Chay Buổi Trưa - Khách sạn Viễn Đông",189000,189000,0,0
TIKI,tui-vi-nu,17974023,"Nhẫn nam nữ Bát Nhã Tâm Kinh Trì Chú N6",74598,74598,0,0
TIKI,tui-vi-nu,8283104,"Chuỗi Ngọc Trai Nuôi Nước Ngọt Tự Nhiên Kết Hợp Đá Mã Não - DB1910 (49cm) - Bảo Ngọc Jewelry",1520000,1600000,80000,5
TIKI,voucher-dich-vu,59075944,"Gói 1 Năm_Ứng dụng Đọc sách dành cho trẻ em Umbalena",699000,699000,0,0
TIKI,tui-thoi-trang-nam,138802053,"Túi bao tử nam đeo chéo nam nữ du lịch tiện ích unisex thời trang Bee Gee 130 siêu đẹp chống thấm nước",69000,140000,71000,51
TIKI,tui-vi-nu,25059174,"Nhẫn nam titanium khắc số la mã BHN79",37000,83000,46000,55
TIKI,voucher-dich-vu,149412349,"NGHỈ DƯỠNG 2N1Đ MERPERLE HÒN TẰM RESORT 5* - Bao Gồm Ăn Ba Bữa. Miễn Phí Vé Khu Vui Chơi Sparkling Waves.  Tặng Vé Tắm Bùn",2775000,2775000,0,0
TIKI,voucher-dich-vu,189162597,"TOUR THÁI LAN 5N4Đ THÁNG KHỞI HÀNH THÁNG 8 - BUFFET BAIYOKE SKY 5 SA0 - MASSAGE CỔ TRUYỀN THÁI",6390000,6390000,0,0
TIKI,voucher-dich-vu,209913974,"[Bến Thành] Liveshow Cẩm Vân - Khắc Triệu - Cece Trương",250000,250000,0,0
TIKI,tui-vi-nu,46158435,"Đồng hồ nam đeo tay cao cấp dây kim loại Modiya siêu hot DH104",83000,69000,-14000,17
TIKI,voucher-dich-vu,252399897,"[EVoucher Vietravel] Mệnh giá 4.000.000VND áp dụng cho tour Thái từ 6.990.0000",4000000,4000000,0,0
TIKI,voucher-dich-vu,63831727,"Buffet Chay 60 Món, Mùa Vu Lan 2022 tại Capella ParkView",320000,320000,0,0
TIKI,tui-thoi-trang-nam,83830072,"Túi xách nam 100% da bò thật cao cấp phong cách mới 15.6inh",621000,690000,69000,10
TIKI,tui-thoi-trang-nam,160406240,"Ví da nam da bò thật 100% loại nhỏ có khe để thẻ phía ngoài",149000,149000,0,0
TIKI,voucher-dich-vu,53448048,"InterContinental Nha Trang Hotel 5* - Đối Diện Biển, Buffet Sáng, Hồ Bơi, Khách Sạn Chuẩn 5 Sao Quốc Tế",2650000,2650000,0,0
TIKI,voucher-dich-vu,203783738,"Swandor Cam Ranh Resort 5*. Bao Gồm Ăn Ba Bữa. Miễn Phí Mini Bar Dành Cho 02 Khách",3098000,3098000,0,0
TIKI,voucher-dich-vu,163881865,"Tour Châu Đốc 1N1Đ - Chùa Bà Núi Sam - Núi Cấm - Rừng Tràm - Lăng Thoại Ngọc Hầu - Chùa Hang - Chùa Phật Nằm - Chợ Cửa Khẩu Tịnh Biên",635000,635000,0,0
TIKI,voucher-dich-vu,8039294,"Dịch Vụ Massage Body + Massage Foot (100 phút)",250000,250000,0,0
TIKI,voucher-dich-vu,197972897,"Tour du lịch Miền Bắc 4N3D: Nội Bài - Hà Nội - Ninh Bình - Sapa - Fansipan, Khởi hành hằng ngày",3290000,3290000,0,0
TIKI,tui-thoi-trang-nam,130440816,"Ví nam AD09, ví da nam gấp 3 nhỏ gọn, bóp nam da bò thật nhiều ngăn đựng tiền đựng thẻ, bóp da nam cao cấp bảo hàng 12 tháng",185000,289000,104000,36
TIKI,voucher-dich-vu,36462494,"Lấy Cao Răng Và Đánh Bóng Công Nghệ Siêu Âm Mới - Nha khoa Gia Hân",99000,99000,0,0
TIKI,voucher-dich-vu,10085222,"Combo Massage Body Nhật + Thái + Foot (70') Kết Họp  Ngâm Chân Đắp Paraffin Thư Giãn Tại Thanh Thanh Spa ( Miễn Tip)",249000,249000,0,0
TIKI,tui-vi-nu,3245291,"Đồng Hồ Đôi Dây Da SKMEI 9058 - DHA278",568000,598000,30000,5
TIKI,voucher-dich-vu,56217995,"GÀ NƯỚNG MẮC KHÉN",234000,234000,0,0
TIKI,tui-thoi-trang-nam,111869000,"Túi đeo chéo Arctic Hunter XB00105 chất liệu Oxford chống thấm nước, unisex nam nữ,trang bị cổng sạc USB tiện dụng",359000,635000,276000,43
TIKI,voucher-dich-vu,118518052,"[E-VOUCHER]- Monkey Junior - Tiếng Anh cho trẻ mới bắt đầu (Trọn đời/ 1 năm/ 2 năm)",832000,832000,0,0
TIKI,voucher-dich-vu,39963886,"Trọn Gói 3N2Đ Cho 06 Người Tại Vinpearl Phú Quốc, Villa 03 PN, 06 Bữa Buffet, Vui Chơi VinWonders, Safari",33000000,33000000,0,0
TIKI,voucher-dich-vu,170631897,"[Phan Thiết  2N1Đ] Centara Mirage Resort 5* Mũi Né - Ăn sáng + Vui chơi công viên nước",2400000,2400000,0,0
TIKI,tui-vi-nu,2869891,"Nhẫn nam phong cách Hàn Quốc NN049",35000,35000,0,0
TIKI,voucher-dich-vu,242178859,"Gói 4N3Đ Crowne Plaza Phú Quốc Starbay Resort 5* - Buffet Sáng, Hồ Bơi, Đón Tiễn Sân Bay, Gần Grand World, Dành Cho 02 Người Lớn 02 Trẻ Em Dưới 12 Tuổi",5950000,5950000,0,0
TIKI,voucher-dich-vu,147410114,"Sách Oxford Business Result ELEMENTARY",139000,139000,0,0
TIKI,voucher-dich-vu,197333425,"Meliá Vinpearl Condotel Riverfront 5* Đà Nẵng - Buffet Sáng, Hồ Bơi, Ngay Trung Tâm, Sát Sông Hàn, Thuận Tiện Tham Quan",1450000,1450000,0,0
TIKI,voucher-dich-vu,36455222,"[2024] Combo Phú Quốc 3N2Đ Vé Máy Bay + Best Western Premier Sonasea Resort 5* Phú Quốc, Có Bao Gồm Hành Lý Ký Gửi, Bay Từ Hà Nội Hoặc Sài Gòn",4990000,4990000,0,0
TIKI,voucher-dich-vu,271278555,"[Ưu Đãi Đặt Sớm] Marina Bay Vũng Tàu Resort & Spa 5* - Bên Bờ Biển, Buffet Sáng, Phòng Cao Cấp, Hồ Bơi Vô Cực Đẹp Xuất Sắc",2015000,2015000,0,0
TIKI,tui-vi-nu,112206234,"Dây Chuyền Mặt Đá Xanh Lá Titan Ko Đen TT 2549",154000,154000,0,0
TIKI,tui-vi-nu,161522918,"Dây Đeo SILICON dành Cho Samsung Galaxy watch 3 45 mm Chất Lượng cao",84000,84000,0,0
TIKI,voucher-dich-vu,207207715,"[EVoucher Vietravel] Trung Quốc: Trương Gia Giới, Phượng Hoàng Cổ Trấn, Thiên Môn Sơn, Viên Gia Giới",16490000,16490000,0,0
TIKI,tui-vi-nu,87898797,"Đồng hồ điện tử thời trang nam nữ m42 dây silicon chống nước tốt",40000,40000,0,0
TIKI,voucher-dich-vu,145371616,"Gói 3N2Đ Swiss-Bel Resort Tuyền Lâm 5* Đà Lạt - Bữa Sáng, Hồ Bơi Ngoài Trời View Cực Đẹp, Hồ Bơi Trong Nhà, Xe Đưa Đón Sân Bay Và Trung Tâm, Nhiều Ưu Đãi Hấp Dẫn",2780000,2780000,0,0
TIKI,voucher-dich-vu,271367853,"[Hồ Tràm 2N1D] Dhawa Resort | Ăn Sáng & Xe Đưa Đón dành cho 02 người",2200000,2200000,0,0
TIKI,voucher-dich-vu,58495336,"Tuyệt đỉnh VBA - Viết code trong tầm tay",499000,499000,0,0
TIKI,voucher-dich-vu,32843760,"TOUR SINH THÁI CẦN GIỜ - RỪNG SÁT 1 NGÀY",670000,670000,0,0
TIKI,voucher-dich-vu,189946702,"Tour Thái Lan 5N4Đ- Khám Phá BangKok - Pattaya Khởi Hành Từ Hồ Chí Minh",7200000,7200000,0,0
TIKI,voucher-dich-vu,262799141,"The Cliff Resort 4* Mũi Né - Buffet Sáng, Hồ Bơi, Bãi Biển Riêng, Không Gian Xanh Mát, Nghỉ Dưỡng Đẳng Cấp Phan Thiết",1950000,1950000,0,0
TIKI,voucher-dich-vu,171327071,"Dịch Vụ Massage Body Aroma / Stella Beauty & Spa",350000,350000,0,0
TIKI,voucher-dich-vu,205538928,"Tour Núi Thần Tài 1 ngày - khởi hành Đà Nẵng",450000,450000,0,0
TIKI,voucher-dich-vu,248986460,"Le Viva Resort 4* Mũi Né - Buffet Sáng, Hồ Bơi Lớn, Bãi Biển Riêng, Ngay Trung Tâm Huỳnh Thúc Kháng, Thuận Tiện Tham Quan",1445000,1445000,0,0
TIKI,voucher-dich-vu,270779787,"Gói 4N3Đ Sunset Sanato Resort 4* Phú Quốc - Buffet Sáng, Xe Đón Tiễn Sân Bay, Hồ Bơi, Bãi Biển Riêng, Check In Thoải Thích Điểm Ngắm Hoàng Hôn Đẹp Nhất Đảo Ngọc",4660000,4660000,0,0
TIKI,voucher-dich-vu,200779874,"Khoá học phân tích dữ liệu kinh doanh",100000,100000,0,0
TIKI,tui-thoi-trang-nam,133619399,"Cặp da công sở thời trang REDPIS 1101",2950000,2950000,0,0
TIKI,voucher-dich-vu,174162621,"Sách nói: Nhượng Quyền Khởi Nghiệp - Con Đường Ngắn Để Bước Ra Thế Giới",99000,99000,0,0
TIKI,voucher-dich-vu,273155179,"5 Phút Thuộc Bài - Gói VIP 1 Năm - dành cho con từ lớp 1 đến lớp 12 ",599000,599000,0,0
TIKI,voucher-dich-vu,16138577,"Vé Thuyền Rồng Sông Hàn Đà Nẵng Về Đêm",150000,150000,0,0
TIKI,voucher-dich-vu,152783832,"Sách nói: Vượt Qua Bản Ngã",99000,99000,0,0
TIKI,voucher-dich-vu,184316762,"[EVoucher Vietravel] Phú Quốc: Đệ Nhất Tứ Đảo - Phú Quốc United Center - Bãi Sao (Khách sạn 3 sao) | Kích cầu du lịch",3990000,3990000,0,0
TIKI,dong-ho-va-trang-suc,33722509,"Đồng hồ nam dây kim loại Casio Edifice chính hãng EFV-540D-1AVUDF",2752000,3529000,777000,22
TIKI,dong-ho-va-trang-suc,21517141,"Vòng Tay Ngọc Trai Xinh Xắn",180000,180000,0,0
TIKI,dong-ho-va-trang-suc,26335399,"Vòng chuỗi hạt đeo tay 2 line nữ đá aquamarine charm trụ 6mm mệnh thủy , mộc - Ngọc Quý Gemstones",1289000,1841000,552000,30
TIKI,dong-ho-va-trang-suc,27927407,"Vòng chuỗi hạt đeo tay 2 line đá thạch anh tóc đen 6mm mệnh thủy , mộc - Ngọc Quý Gemstones",1779000,2220000,441000,20
TIKI,dong-ho-va-trang-suc,23836927,"Dây chuyền inox trái châu không đen",55000,55000,0,0
TIKI,dong-ho-va-trang-suc,170835632,"Vòng ximen chạm bộ 7 chiếc mạ 18k khóa lưỡi gà cao cấp 4 li",199000,375000,176000,47
TIKI,dong-ho-va-trang-suc,155639931,"Vòng tay gỗ Huyết Long hạt tròn mix tỳ hưu bạc loại hàng thân gỗ huyết long",285000,285000,0,0
TIKI,dong-ho-va-trang-suc,143362764,"Đồng Hồ Nam Dây Nhựa Casio G-Shock GAX-100B-7ADR Chính Hãng - GAX-100B-7A",3684000,4912000,1228000,25
TIKI,dong-ho-va-trang-suc,89878685,"Bông tai bạc nụ đá tròn MS38",71000,71000,0,0
TIKI,dong-ho-va-trang-suc,141233507,"Vòng Tay Trầm Tốc Bông Size 18mm Trầm Tốc Việt Tự Nhiên",529000,529000,0,0
TIKI,dong-ho-va-trang-suc,23240630,"Dây chuyền titan bướm xinh",54000,98000,44000,45
TIKI,dong-ho-va-trang-suc,10393020,"Mặt dây chuyền Phật Bà Quan Âm Ngọc Bích tự nhiên VietGemstones",1250000,1250000,0,0
TIKI,dong-ho-va-trang-suc,73859577,"Charm Pha Lê Swarovski Hình Con Cá",580000,580000,0,0
TIKI,dong-ho-va-trang-suc,137372948,"Vòng cổ dây chuyền dù 3ly bền đẹp đính đá thời trang - phụ kiện dây dù đeo cổ MS041120211",35000,35000,0,0
TIKI,dong-ho-va-trang-suc,97451716,"Vòng đeo tay, lắc tay từ ngọc trai nuôi tự nhiên cho nữ",230000,230000,0,0
TIKI,dong-ho-va-trang-suc,17000300,"Nhẫn nam nữ mạ vàng 24k đá mắt hổ nâu N12",105000,105000,0,0
TIKI,dong-ho-va-trang-suc,157507209,"Nhẫn nam nữ, cảm biến nhiệt độ cơ thể, Phong cách âu mỹ, kèm túi Nhung Hồng phát và vòng tay Luminous",68000,76000,8000,11
TIKI,dong-ho-va-trang-suc,56905169,"Đồng hồ nam dây nhựa Casio G-Shock chính hãng GM-5600-1DR",4243000,5441000,1198000,22
TIKI,dong-ho-va-trang-suc,27922701,"Nhẫn đá ngọc bích ni16 mệnh hỏa , mộc - Ngọc Quý Gemstones",879000,1255000,376000,30
TIKI,dong-ho-va-trang-suc,138674692,"Dây Samsung Watch Active 1/ Active 2 size 40/ 44mm",90000,90000,0,0
TIKI,dong-ho-va-trang-suc,188119811,"Vòng tay Mã Não đen 6 li kiểu đeo quấn 3 vòng phối charm tiền vàng hợp mệnh Thủy Mộc | Hoa Minh Gem",320000,320000,0,0
TIKI,dong-ho-va-trang-suc,176073716,"Dây đồng hồ cao su silicon Sikai cao cấp dành cho Samsung galaxy watch 3 41 và 45mm",135000,135000,0,0
TIKI,dong-ho-va-trang-suc,458326,"Đồng Hồ Nam Citizen Dây Vải Nato BM8475-00F - Mặt Xám",6885000,6885000,0,0
TIKI,dong-ho-va-trang-suc,145230941,"[1 Hạt] 9MM Thạch Anh Tóc Vàng Tự Nhiên Dạng Tròn Loại AA, Đá Phối Vòng Tay Phong Thuỷ, Trang Sức, Chuỗi Hạt, Mệnh Thổ, Kim - Bead Art",304000,304000,0,0
TIKI,dong-ho-va-trang-suc,141233084,"Vòng tay Chuỗi Tràng Hạt 108 4mm Trầm Sánh Chìm - Trầm Hương Tự Nhiên",1490000,1490000,0,0
TIKI,dong-ho-va-trang-suc,31216557,"KIM CƯƠNG NHÂN TẠO Heart & flower  giác cắt 9 trái tim, 1 bông hoa ở giữa",445000,445000,0,0
TIKI,dong-ho-va-trang-suc,42562858,"Vòng tay hoa khô màu hồng",32900,32900,0,0
TIKI,tui-thoi-trang-nam,19707058,"Túi đeo hông, túi đeo bụng nam nữ",65000,65000,0,0
TIKI,dong-ho-va-trang-suc,179777373,"Đồng Hồ Casio W-218HC-4A2VDF Dây Nhựa - Mặt Vuông - WR50M",678400,848000,169600,20
TIKI,dong-ho-va-trang-suc,148824306,"Đồng Hồ Nam Dây Nhựa Casio Standard W-219H-1AVDF Chính Hãng - W-219H-1A",670500,894000,223500,25
TIKI,dong-ho-va-trang-suc,76387664,"DÂY ĐỒNG HỒ DA SÁP NGỰA – RAM BAUHAUS 1950 DÀNH CHO APPLE WATCH - HÀNG CHÍNH HÃNG",249000,249000,0,0
TIKI,dong-ho-va-trang-suc,80468391,"Đồng hồ dây kim loại thời trang nữ D7 Dây kim loại mặt tròn, có 3 màu vàng,bạc,demi",76000,76000,0,0
TIKI,tui-thoi-trang-nam,116877991,"Ví Cá Sấu Gù To 2 Mặt, Ví Nam Cá Sấu Dáng Ngang, Màu Đen, Nâu Cafe",650000,650000,0,0
TIKI,tui-thoi-trang-nam,22145346,"Túi hộp đeo chéo nam vải dù chống thấm nước T1084",169000,169000,0,0
TIKI,tui-thoi-trang-nam,75832656,"Ví dài cầm tay mẫu mới nam nữ Lesin cao cấp N56 Tặng móc khóa hình búa siêu ngầu",139705,201796,62091,31
TIKI,dong-ho-va-trang-suc,92905407,"Hộp Đựng Đồng Hồ 6 Ngăn",125000,125000,0,0
TIKI,tui-thoi-trang-nam,111537503,"Ví nam da bò cao cấp phong cách mới",351000,390000,39000,10
TIKI,tui-thoi-trang-nam,193104706,"Ví nam đứng da bò cao cấp TRITA RVN18",199000,390000,191000,49
TIKI,dong-ho-va-trang-suc,28729788,"Vòng tay phong thủy nữ đá thạch anh ưu linh trắng charm cỏ 4 lá 8mm mệnh thủy , kim - Ngọc Quý Gemstones",949000,1356000,407000,30
TIKI,tui-thoi-trang-nam,109479028,"Túi đeo chéo nam cao cấp phong cách mới",359000,398000,39000,10
TIKI,tui-thoi-trang-nam,153265039,"Túi đeo chéo Vui Nhộn Hoạt Hình Mstaly-MBCR Mẫu mới Shalla",38610,52767,14157,27
TIKI,tui-thoi-trang-nam,102498855,"Bóp ví Alan Walker cầm tay đựng đồ nhỏ gọn, nhiều ngăn thời trang cá tính trẻ trung",109000,109000,0,0
TIKI,tui-thoi-trang-nam,146618296,"Bóp Da Đựng Thẻ ATM Nhỏ Gọn, Chất Da Pull-Up Mềm Mại, Trẻ Trung - Cá Tính, Thiết Kế Hiện Đại, Nhiều Ngăn Tiện Dụng, Đựng Thẻ Ngân Hàng, Card Danh Thiếp, Căn Cước Công Dân, Hình Lưu Niệm, Dáng Đứng - Gập 2 - Hàng Chính Hãng SAIGIO",779000,799000,20000,3
TIKI,tui-thoi-trang-nam,97729163," Ví nam PIDENGBAO tiện ích nhỏ gọn",137800,137800,0,0
TIKI,dong-ho-va-trang-suc,12726951,"Cặp Đồng Hồ Nam Nữ Halei HL552 (Tặng pin Nhật sẵn trong đồng hồ + Móc Khóa gỗ Đồng hồ 888 y hình + hộp chính hãng + thẻ bảo hành)",394000,415000,21000,5
TIKI,tui-thoi-trang-nam,147993769,"Ví Da Nam VD02 Kiểu Ngang Trẻ Trung Phong Cách",168000,336000,168000,50
TIKI,tui-thoi-trang-nam,72888449,"Ví bọc hộ chiếu Passport chất liệu da cover hoạt hình "I Love You"",55000,75000,20000,27
TIKI,tui-thoi-trang-nam,90519788,"Túi đeo chéo đeo ngực nam cao cấp phong cách châu âu",585000,650000,65000,10
TIKI,tui-thoi-trang-nam,50491493,"Túi đeo ngực,đeo chéo nam đã tích hợp công nghệ 4.0",621000,690000,69000,10
TIKI,tui-thoi-trang-nam,191376194,"Bao da dành cho Chìa Khóa Honda Lead 2022, AirBlade 2023, Winner X 2022, PCX 160, Vario 160, AB 125, AB 160 2023 handmade da thật",99000,99000,0,0
TIKI,dong-ho-va-trang-suc,40398326,"Nhẫn Nữ Đính1 Viên Đá Chìm Chất Liệu Thép Titan Ko Rỉ Ko Dị Ứng TT 0411",55000,55000,0,0
TIKI,dong-ho-va-trang-suc,10309882,"Bộ trang sức Ngọc Trai Thiên Nhiên T4 Mix Bảo Ngọc Jewelry  (Freesize) ",1598000,1950000,352000,18
TIKI,tui-thoi-trang-nam,59234311,"Ví nam vuông cao cấp hình mắt cú thời thời trang",55687,76106,20419,27
TIKI,dong-ho-va-trang-suc,52065093,"Vòng tay chỉ đỏ may mắn",109000,109000,0,0
TIKI,tui-thoi-trang-nam,158610488,"CITIZEN Business Card Holder, Ví Đựng Thẻ ATM Cao Cấp, Dành Cho Doanh Nhân, Thiết Kế Hiện Đại - Sang Trọng, Chất Liệu Da Bò Vachetta Thuộc Thảo Mộc, Nhập Khẩu Từ Châu Âu, Hoàn Thiện Tỉ Mỉ - Tinh Tế Từng Chi Tiết - Hàng Chính Hãng SAIGIO ",2479000,2499000,20000,1
TIKI,dong-ho-va-trang-suc,49731897,"Nhẫn Nữ Đính 1 Viên Đá Titan Ko Đen TT 1968",105000,105000,0,0
TIKI,tui-thoi-trang-nam,711036,"Túi Đeo Chéo Nam HARAS HRTK105 (27 x 17 cm) - Đen",65000,65000,0,0
TIKI,tui-thoi-trang-nam,83691185,"Túi xách cặp da đựng laptop công sở",365000,365000,0,0
TIKI,dong-ho-va-trang-suc,9848332,"Đồng Hồ Nam Dây Vải ORIENT FUNG2004F0 (42mm)",2445000,3260000,815000,25
TIKI,tui-thoi-trang-nam,9803160,"Túi đeo chéo TROY YM01",127000,150000,23000,15
TIKI,tui-thoi-trang-nam,59282088,"Túi đeo chéo đa năng LATA TN16",450000,450000,0,0
TIKI,tui-thoi-trang-nam,84774464,"Túi bao tử - túi đeo chéo - túi đeo bụng nam nữ da bò thật SEAGLE SGB01",434500,434500,0,0
TIKI,tui-thoi-trang-nam,193607571,"Túi đeo chéo nam đa năng cao cấp phong cách mới",180000,199000,19000,10
TIKI,tui-thoi-trang-nam,47992489,"Túi bao tử đeo hông nhiều ngăn TROY MS1",118000,139000,21000,15
TIKI,dong-ho-va-trang-suc,15671713,"Nhẫn  Nam Bạc Thái 925 cao cấp (hàng chính hãng)",890000,890000,0,0
TIKI,tui-thoi-trang-nam,252795368,"[Da thật] Clutch cầm tay nam da bò thật CL126LS (Đen/Nâu sáng/Nâu sẫm) - 100% da bò thật, BH 3 năm",539000,539000,0,0
TIKI,tui-thoi-trang-nam,121334938,"Ví da namecard LATA Luxdeli LVN102",180000,180000,0,0
TIKI,tui-thoi-trang-nam,75478590,"Túi Đeo Chéo Nam Nữ Chất Da Pu Cao Cấp Phong Cách Cá Tính Năng Động, Cá Tính",119790,163713,43923,27
TIKI,tui-thoi-trang-nam,177017362,"Túi đeo chéo đeo vai nam vải canvas cao cấp phong cách mới",387000,430000,43000,10
TIKI,tui-thoi-trang-nam,137997996,"Cặp da thời trang công sở",550000,550000,0,0
TIKI,tui-thoi-trang-nam,108850884,"Ví nam da bò thật cao cấp TRITA RVN08 ví ngang đựng tiền và thẻ card",199000,380000,181000,48
TIKI,tui-thoi-trang-nam,105618769,"Túi đeo chéo đeo ngực nam cao cấp phong cách mới",603000,670000,67000,10
TIKI,tui-thoi-trang-nam,130471908,"Túi Đeo Chéo Nam Vải CanVas Chống Thấm Nước, Nhiều Ngăn Chứa Đồ, Túi Đeo Vai Nam Vải Bố Bền Đẹp_Túi Đi Chơi, Đi Làm Phong Cách Thời Trang Hiện Đại",325000,325000,0,0
TIKI,tui-thoi-trang-nam,151460338,"[Da thật] Túi đeo chéo nam da bò thật TD115LEA (Đen/ Vàng bò) - 100% da thật",430000,430000,0,0
TIKI,tui-thoi-trang-nam,149180017,"Túi xách da công sở cao cấp JEEP BULUO T05-2 (KT 39x29x8cm)",666000,666000,0,0
TIKI,tui-thoi-trang-nam,74854470,"Túi xách nam da thật cao cấp phong cách mới",441000,490000,49000,10
TIKI,tui-thoi-trang-nam,107962265,"Ví Nam Mini Da Bò SÁP Dáng Đứng SVN Leather Fullbox",189000,189000,0,0
TIKI,tui-thoi-trang-nam,93712433,"ví nam - ví nam cầm tay cao cấp",269000,298000,29000,10
TIKI,tui-thoi-trang-nam,109103074,"Túi đeo chéo bao tử thời trang nam chống thấm nước cao cấp",73260,100122,26862,27
TIKI,tui-thoi-trang-nam,149765324,"Túi Xách, Cặp Da Thời Trang Công Sở Nam Cao Cấp Khóa Số CGL07",3200000,3200000,0,0
TIKI,balo-va-vali,7858026,"Túi xách du lịch thời trang HARAS HR230",250000,250000,0,0
TIKI,balo-va-vali,106659492,"Túi kéo đi chợ gấp gọn chống thấm 2 trong 1 có bánh xe xếp gọn thành túi đa năng KDR-NC310",65747,89855,24108,27
TIKI,balo-va-vali,22614015,"Túi đựng giày thể thao trơn HKT02 ",59400,81180,21780,27
TIKI,balo-va-vali,15340812,"Balo Alan Walker vải chống nhăn chống mốc, độ bền cao",239000,239000,0,0
TIKI,balo-va-vali,31689613,"Balo Cóc Da Pu Mềm Chất Đẹp Móc Khóa Gấu",106000,129487,23487,18
TIKI,balo-va-vali,98576691,"Sét 3 túi đựng mỹ phẩm trong suốt",51986,51986,0,0
TIKI,balo-va-vali,170347981,"Túi chống sốc laptop, macbook chống thấm, siêu mỏng, siêu bảo vệ thời trang BUBM cao cấp",116100,129000,12900,10
TIKI,balo-va-vali,125100689,"Bộ 6 túi du lịch chống thấm bags in bag (xanh dương đậm)",79000,79000,0,0
TIKI,balo-va-vali,148932218,"Balo Thời Trang Nam Đựng Laptop Máy Tính Xách Tay Nhiều Ngăn Có Cổng Sạc Usb Thông Minh BL13 SUNO STORE",39000,39000,0,0
TIKI,balo-va-vali,171765620,"Thẻ ghi chú (name tag) ghi thông tin hành lý, đánh dấu chìa khóa",1000,1000,0,0
TIKI,balo-va-vali,171554622,"Bộ chiết mỹ phẩm du lịch 7 món nhỏ gọn tiện lợi túi dây rút gồm bình xịt phun sương, lọ nhỏ, túi đựng nhỏ",44400,44400,0,0
TIKI,balo-va-vali,153978993,"Túi chống sốc Laptop 13 inch AGVA Urban Denim - Kích thước Ngang 34 x Rộng 1.5 x Cao 25 cm - Mã LTB262GRE (Xám) - Túi chính hãng bảo hành 2 năm",420000,420000,0,0
TIKI,balo-va-vali,4049037,"Túi xách laptop Cartinoe Laptop Fit Series",540000,540000,0,0
TIKI,balo-va-vali,34237014,"Balo laptop 15.6 inch Mikkor Kalino Backpack Mouse Grey",649000,649000,0,0
TIKI,balo-va-vali,4306879,"Balo học sinh Simplecarry Issac1",540000,540000,0,0
TIKI,balo-va-vali,71701236,"Balo Nữ Đi Học, Balo Chống Nước Thời Trang Hàn Quốc Trẻ Trung Cá Tính Ba lô thời trang học sinh, sinh viên",99000,99000,0,0
TIKI,balo-va-vali,43511266,"Balo Lenovo Legion 15.6 inch Recon Gaming Backpack B8270 GX40L16533 | Hàng Chính Hãng",650000,650000,0,0
TIKI,balo-va-vali,116857451,"Balo cao cấp đựng Laptop Nam phong cách Hàn Quốc 2020 80675",171800,188000,16200,9
TIKI,balo-va-vali,10169434,"Balo laptop Kim Long KL025",501750,669000,167250,25
TIKI,balo-va-vali,194114612,"Balo nữ chần bông phối ngăn kéo YUUMY Seasand YBA50 - Xanh nhạt",245000,550000,305000,55
TIKI,balo-va-vali,3491735,"Balo Laptop Hasun HS 654",460000,460000,0,0
TIKI,balo-va-vali,144509819,"LỌ CHIẾT MỸ PHẨM / CHAI CHIẾT/ ỐNG CHIẾT NƯỚC HOA TỰ ĐỘNG DẠNG XỊT (5ML)",24000,24000,0,0
TIKI,balo-va-vali,151488467,"Balo Thời Trang Ulzzang Nam Nữ , Balo Đi Học, Balo học Sinh ULZZANG Giá Rẻ Yikes Balo",56500,56500,0,0
TIKI,balo-va-vali,54511383,"Vali thông minh ngồi lái được",10800000,10800000,0,0
TIKI,balo-va-vali,115564256,"Vali kéo du lịch thời trang SUNNY SV05 ( 2 size 5 màu)",449000,800000,351000,44
TIKI,balo-va-vali,19748017,"Túi Bọc Bảo Vệ Vali -Túi Trùm Vali H01 - HPVali",149000,232000,83000,36
TIKI,balo-va-vali,54716817,"Ba lô nam thời trang cao cấp chứa laptop 15,6 inh phong cách châu âu",405000,450000,45000,10
TIKI,balo-va-vali,42090891,"Túi du lịch thời trang YUUMY YMTR04",415000,820000,405000,49
TIKI,balo-va-vali,170469621,"Cuộn dây thừng dài 30 mét làm đồ handmade, quấn lọ hoa",39000,39000,0,0
TIKI,balo-va-vali,195569940,"Tay cầm, quai xách nổi 20cm,  đã bao gồm ốc vít, dùng cho vali Sony, Baravia, Lusetti, lock&lock, Kakashi, Lojel, American Tourister, sakos, samso",45000,45000,0,0
TIKI,balo-va-vali,20824965,"BAO DA, TÚI DA, CẶP DA CHỐNG SỐC CHO MACBOOK, LAPTOP, SURFACE KÈM VÍ ĐỰNG PHỤ KIỆN",332500,350000,17500,5
TIKI,balo-va-vali,49634383,"Balo nữ thời trang đa năng LATA BAL37",399000,460000,61000,13
TIKI,balo-va-vali,32402337,"Balo Simplecarry Mattan 3",699000,699000,0,0
TIKI,balo-va-vali,188969931,"ba lô nữ đa chức năng cao cấp phong cách cá tính mới",513000,570000,57000,10
TIKI,balo-va-vali,195676922,"Balo nữ sinh đi học đi chơi đi làm không thấm nước cao cấp phong cách mới",423000,470000,47000,10
TIKI,balo-va-vali,45842346,"Balo thời trang nhỏ xinh , da PU bền đẹp , thiết kế thời trang hàn quốc , hợp xu hương TK0027",49000,75000,26000,35
TIKI,balo-va-vali,78611589,"Balo laptop Wenger WindWalker Thụy Sỉ: Dây đeo vai công thái học có đệm",1198000,1500000,302000,20
TIKI,balo-va-vali,167472202,"Balo nam nữ thời trang hàng cao cấp phong cách mới 15,6",315000,350000,35000,10
TIKI,balo-va-vali,112085286,"Balo nam thông minh đa năng cao cấp phong cách mới",405000,450000,45000,10
TIKI,balo-va-vali,161944256,"Balo nam thông minh đa năng kiêm túi xách thông minh đa năng cao cấp",801000,890000,89000,10
TIKI,dong-ho-va-trang-suc,190591006,"Vòng Đá Thiên nhiên thiết kế phối charm - MOON Jewelry",1150000,1250000,100000,8
TIKI,dong-ho-va-trang-suc,192909331,"Đồng hồ Casio Nữ Baby-G BGA-250-7A2DR",3321000,3321000,0,0
TIKI,dong-ho-va-trang-suc,191421883,"Đồng Hồ Nam Dây Nhựa Casio Standard AE-1300WH-8A Chính Hãng - AE-1300WH-8AVDF Pin 10 Năm",938250,1251000,312750,25
TIKI,dong-ho-va-trang-suc,46260879,"Bông Tai Nam Loại Kẹp Ko Cần Bấm Lỗ Tai Titan Không Đen TT 2440 – 1 cái",65000,65000,0,0
TIKI,dong-ho-va-trang-suc,178027025,"Dụng cụ mở nắp đáy đồng hồ hai chân - Dụng cụ sửa chữa đồng hồ",21000,21000,0,0
TIKI,dong-ho-va-trang-suc,117490581,"Cuộn chỉ ngũ sắc to",150000,150000,0,0
TIKI,dong-ho-va-trang-suc,97904171,"Dây chuyền khắc tên hạt gạo",23400,23400,0,0
TIKI,dong-ho-va-trang-suc,90719611," Lắc tay nam inox kiểu lặc kép cá tính thép không gỉ 10mm- QuynhChi 79",83600,83600,0,0
TIKI,dong-ho-va-trang-suc,51110116,"Dây chuyền nam dù",75000,75000,0,0
TIKI,dong-ho-va-trang-suc,74527368,"Dây chuyền nam inox thời trang kiểu dây mì dẹp trangsucpt kích cỡ 3mm màu trắng thép không gỉ PTDCNA43",95000,95000,0,0
TIKI,dong-ho-va-trang-suc,74006823,"Dây Chuyền Tropicana Phối Charm Swarovski Pha Lê Mặt Cắt 3 Màu",1120000,1120000,0,0
TIKI,dong-ho-va-trang-suc,106392036,"GIÁ HỦY DIỆT Dây đồng hồ HUBLOT nam lót da lộn Xám Tối Case 42 size dây 19 - 25 - 22",150000,150000,0,0
TIKI,dong-ho-va-trang-suc,159027192,"Hoa tai, Khuyên tai, Bông tai mạ bạc S925 cao cấp cho Nữ (Màu Vàng)",55000,55000,0,0
TIKI,dong-ho-va-trang-suc,154180162,"Nhẫn đeo tay nữ titan cá tính dễ thương Phụ kiện trang sức sang trọng",48015,48015,0,0
TIKI,dong-ho-va-trang-suc,102131956,"Vòng Tay Trầm Hương Charm Mặt Phật | Trầm Tốc Lào",199000,199000,0,0
TIKI,dong-ho-va-trang-suc,74952724,"Cuộn dây vải thun đan vòng đường kính dây 1mm, dài 100m - Ngọc Quý Gemsontes",65000,120000,55000,46
TIKI,dong-ho-va-trang-suc,179555644,"Khuyên tai nữ Hàn Quốc chất liệu bạch thật đeo sát tai kết đá trắng cao cấp trang sức",115000,115000,0,0
TIKI,dong-ho-va-trang-suc,8293928,"Chuỗi Ngọc Trai Mặt Đá Mã Não Đen DB-2110 Bảo Ngọc Jewelry",1363000,1500000,137000,9
TIKI,dong-ho-va-trang-suc,172501281,"Mặt dây chuyền Thiên Tâm đài sen 3cm may mắn (trắng) MMD023T",116000,116000,0,0
TIKI,dong-ho-va-trang-suc,100018204,"Đồng Hồ Nam Casio Chính Hãng W-217H-1AV Dây Nhựa",666400,784000,117600,15
TIKI,dong-ho-va-trang-suc,208645629,"miếng dán màn hình dành cho Huami Amazfit GTR4 / GTS4",25000,25000,0,0
TIKI,dong-ho-va-trang-suc,100461378,"BỘ TRANG SỨC ĐÁ VUÔNG CAO CẤP",114400,114400,0,0
TIKI,dong-ho-va-trang-suc,11384785,"Vòng Tay Mã Não Đen Liền Khối Ngọc Quý Gemstones",369000,724000,355000,49
TIKI,dong-ho-va-trang-suc,195929285,"[1 Cái] Charm Khoá Bạc 925, Phối Vòng Tay Phong Thuỷ, Trang Sức, Chuỗi Hạt, Dây Chuyền, Lắc Tay - Bead Art",33600,33600,0,0
TIKI,dong-ho-va-trang-suc,46209642,"Bộ Trang Sức Bạc Nữ Đẹp Đính Đá Topaz Xanh Cao Cấp 3 Món Bảo Ngọc Jewelry [THIẾT KẾ ĐỘC QUYỀN]",1113000,1113000,0,0
TIKI,dong-ho-va-trang-suc,129347108,"Đồng Hồ Casio Nữ Baby - G BGA-270-1ADR",3495000,3495000,0,0
TIKI,dong-ho-va-trang-suc,47342655,"Nhẫn nam Chạm Ông Hổ Xi Vàng - Phong thủy - cá tính",88000,88000,0,0
TIKI,dong-ho-va-trang-suc,18007484,"Nhẫn nam mạ Vàng 24k đá mắt hổ N14",350000,350000,0,0
TIKI,dong-ho-va-trang-suc,37546109,"Vòng đá đeo tay Tỳ Hưu VT191",65000,65000,0,0
TIKI,dong-ho-va-trang-suc,31513782,"Nhẫn tỳ hưu đá cẩm thạch xanh lục, size 20mm",289500,289500,0,0
TIKI,dong-ho-va-trang-suc,1816737,"Mặt Dây Chuyền Đá Cẩm Thạch Phong Thuỷ Ngọc Quý Gemstones DC9",297500,350000,52500,15
TIKI,dong-ho-va-trang-suc,98978181,"Bông tai hoa tuyết chất liệu bạc s925 MS03a",56000,56000,0,0
TIKI,dong-ho-va-trang-suc,59289809,"Vòng tay phong thủy đá Thạch Anh Dâu Tây Hồng mix Charm Bạc",650000,650000,0,0
TIKI,dong-ho-va-trang-suc,176447420,"Vòng Tay Thắt Dây (Chỉ) Đỏ Handmade Đá Diopside Tự Nhiên, Vòng Tay Phong Thuỷ, Chuỗi Hạt, Trang Sức, Mộc, Hoả - Bead Art",134800,134800,0,0
TIKI,dong-ho-va-trang-suc,36268380,"Dây chuyền Chữ Thập PANMILA - Dây chuyền nữ mặt chữ thập đính pha lê (DC.XOO8.B)",128000,128000,0,0
TIKI,dong-ho-va-trang-suc,88779170,"Đồng hồ điện tử nam nữ dây hoa cúc mặt tròn Sgv15",19000,19000,0,0
TIKI,dong-ho-va-trang-suc,19739598,"Đồng hồ  Nam SKMEI 9097 Cao Cấp + Tặng Combo TẨY DA CHẾT APPLE WHITE PELLING GEL BEAUSKIN chính hãng",493000,519000,26000,5
TIKI,dong-ho-va-trang-suc,91325216,"Đồng hồ thể thao Nam SKMEI 1260 bằng thép không gỉ sáng tạo thời trang chống nước",170000,265000,95000,36
TIKI,dong-ho-va-trang-suc,9670825,"Đồng hồ nữ dây silicon TZKM01",55000,55000,0,0
TIKI,dong-ho-va-trang-suc,98634119,"Vòng tay cặp đôi ổ khoá chìa khoá",58500,58500,0,0
TIKI,balo-va-vali,144404327,"Balo kiêm Túi đeo Du lịch VLQUE, Đa năng, Chống thấm Nước, Có Ngăn để Giày, Đựng đồ ướt, Dày dặn, Thời trang",250000,250000,0,0
TIKI,balo-va-vali,264018910,"Vascara Balo Du Lịch Phối Vải Dù - BAC 0189",977000,977000,0,0
TIKI,balo-va-vali,271396032,"Túi du lịch nam da bò sáp cao cấp 1219-1",3090000,3090000,0,0
TIKI,balo-va-vali,113151412,"Balo denim",180000,180000,0,0
TIKI,balo-va-vali,106757212,"Túi xách du lịch thể thao nam công suất lớn chất lượng cao cấp",513000,570000,57000,10
TIKI,balo-va-vali,790958,"Cặp Đựng Laptop Dell 15.6inch G&B 01 CAPLDELL01 - Đen",98000,98000,0,0
TIKI,balo-va-vali,6998659,"Balo Minecraft",239000,239000,0,0
TIKI,balo-va-vali,98053964,"Túi chống sốc Laptop, Macbook viền da kèm khe cắm bút và khe sạc cao cấp",249000,249000,0,0
TIKI,balo-va-vali,172192390,"Túi đeo ngực thời trang du lịch phong cách Quân đội Mỹ 208128 3(kaki)",90000,90000,0,0
TIKI,balo-va-vali,26340527,"Balo Sakos HERO",1332000,1332000,0,0
TIKI,balo-va-vali,34273743,"Balo laptop 15.6 inch Mikkor Lewie Backpack Light Grey",750000,750000,0,0
TIKI,balo-va-vali,31811041,"Balo Mèo Vải Bố Cao Cấp AT12",169000,169000,0,0
TIKI,balo-va-vali,179945833,"Vali hợp kim nhôm nguyên khối MS1318 Macsim cao cấp màu đen , Màu bạc, màu Ti-gold cỡ 28inches",10164000,10164000,0,0
TIKI,balo-va-vali,129147528,"Balo Laptop Chống Nước 16 Inch Cao Cấp Nam Nữ Kim Long Kl032 - Thời Trang Ti Ti",435000,580000,145000,25
TIKI,balo-va-vali,95395106,"Túi Đựng Hành Lý Du Lịch Cỡ Đại Cho Nam Và Nữ Đồ Da Thành Long TLG 208139",100000,153400,53400,35
TIKI,balo-va-vali,119696670,"Túi bạt dứa đựng chăn quần áo mọi kích thước siêu to, siêu rẻ, siêu bền chống thấm nước. Vật dụng cần thiết trong mỗi gia đình",10000,10000,0,0
TIKI,balo-va-vali,4902563,"Balo Du Lịch Phượt Cao Cấp 35L - BL23",102960,148720,45760,31
TIKI,balo-va-vali,32436424,"Cặp xách Laptop 15.6 inch chống sốc nhiều ngăn tiện lợi",349000,349000,0,0
TIKI,balo-va-vali,198223485,"Balo Mini Nhỏ Xinh Chim Cánh Cụt Bl25 Da Trơn Mới",56000,85000,29000,34
TIKI,balo-va-vali,15512269,"Túi Chống Sốc Tomtoc A13 (Usa) 360° Protective Surface, Laptop, Macbook Pro 13” Light Blue",800000,800000,0,0
TIKI,balo-va-vali,185242745,"Túi xách du lịch thể thao nam đa năng cao cấp phong cách châu âu",1215000,1350000,135000,10
TIKI,balo-va-vali,195960879,"Cặp Da Công Sở Nam Đựng Vừa Laptop 14 inch Jusendaisu",289000,289000,0,0
TIKI,balo-va-vali,147896554,"Set Balo 4 Món, Balo Combo 4 Món, Balo Nữ, Balo Nam, Balo Thời Trang, Balo Đi Học - Set Balo 4 Món Gâu Cute",121000,121000,0,0
TIKI,balo-va-vali,174665640,"Túi xách chính hãng TOMTOC (USA) Spill-Resistant - A22-E02 cho Macbook Pro 16 inch",949000,949000,0,0
TIKI,balo-va-vali,78889340,"Túi du lịch BUNKER NG00 (Đen)",945000,945000,0,0
TIKI,balo-va-vali,254092530,"Balo Nữ Thời Trang Cao Cấp Elly EBH13",1499000,1499000,0,0
TIKI,balo-va-vali,85376332,"Ba lô Mikkor The Ace - Navy",950000,950000,0,0
TIKI,balo-va-vali,173856961,"Set balo 4 món sư tử",99000,99000,0,0
TIKI,balo-va-vali,269902465,"TÚI DÂY RÚT HÌNH DORAEMON VẢI MỘC THÔ ĐỰNG VỚ VÀ PHỤ KIỆN",12000,12000,0,0
TIKI,balo-va-vali,7430633,"Balo Mikkor The Nomad Premier Charcoal 15.6inch",590000,590000,0,0
TIKI,balo-va-vali,78487645,"Balo laptop Sakos Carbon I15 (Tặng túi Festival Mini để điện thoại)",1385000,1385000,0,0
TIKI,balo-va-vali,12020808,"Ba Lô Laptop Campus Cao Cấp PRAZA - BLTK174",149000,149000,0,0
TIKI,balo-va-vali,131144692,"Balo Laptop 13 - 14 inch cỡ nhỏ SimpleCarry M-city, siêu bền, siêu nhẹ",550000,550000,0,0
TIKI,balo-va-vali,86159369,"Túi Đựng Mỹ Phẩm Vật Dụng Du Lịch Washbag Cỡ Trung Kích Thước 26x10x15cm Chất Liệu PU TPU Chống Thấm",79000,79000,0,0
TIKI,balo-va-vali,242452549,"Cặp đựng laptop, cặp da công sở Huabups nhiều ngăn tiện dụng rất thanh lịch và sang trọng_0906",755000,755000,0,0
TIKI,balo-va-vali,121329361,"Hàng Hót Balo thời trang balo nam nữ dáng to",159000,159000,0,0
TIKI,balo-va-vali,164346152,"Túi xách du lịch thể thao nam công suất lớn chất lượng cao cấp",531000,590000,59000,10
TIKI,balo-va-vali,11423361,"Túi Trùm Vali Cao Cấp KOS, Vải Thun Co Giãn 4 Chiều, Bọc Vali Chống Trầy, Chống bụi - Áo trùm Vali Size S",250000,250000,0,0
TIKI,balo-va-vali,81436803,"Túi Xách Thời Trang Công Sở Nữ Dành Cho Các Dòng Laptop 13.3''-M401 - Hàng Nhập Khẩu",1050000,1050000,0,0
TIKI,balo-va-vali,76551330,"Bao da Cặp da Túi da đựng dành cho Macbook Air / Macbook Pro / Surface Pro / Surface Laptop / Laptop Asus / Laptop HP / Laptop Dell XPS / Laptop Acer / Laptop Lenovo / Laptop 13 inch",369000,369000,0,0
TIKI,tui-thoi-trang-nam,186243889,"Túi đeo chéo nam vải canvas cao cấp phong cách mới",333000,370000,37000,10
TIKI,tui-thoi-trang-nam,106053325,"Bóp da nam, ví nam, ví da bò thật 100%, chuẩn đẹp xịn xò A142V",125000,125000,0,0
TIKI,tui-thoi-trang-nam,75727517,"Túi đeo chéo nam tích hợp khóa chống trộm chống nước cao cấp phong cách mới",297000,330000,33000,10
TIKI,tui-thoi-trang-nam,11586535,"Túi Đeo Chéo, Túi Đeo Chéo Nam Da Bò Jeep (26 x  23 cm)",152000,152000,0,0
TIKI,tui-thoi-trang-nam,188997107,"Bao da dành cho chìa khoá toyota Camry, Fortuner, Land Cruiser, Hilux handmade da thật 009",200000,200000,0,0
TIKI,tui-thoi-trang-nam,205232933,"Bao da dành cho bọc ốp chìa khoá xe ô tô Toyota Camry 2019 2022 da bò nhiều màu khâu thủ công To28CR",170000,170000,0,0
TIKI,tui-thoi-trang-nam,113760273,"Ví nam da bò cao cấp phong cách mới",387000,430000,43000,10
TIKI,tui-thoi-trang-nam,96243197,"Túi xách cặp da công sở vân cá sấu đựng laptop 14inch T80 35x29x6cm(Nâu-Đen)",329000,329000,0,0
TIKI,tui-thoi-trang-nam,93843376,"Túi đeo chéo đeo ngực nam cao cấp phong cách châu âu",783000,870000,87000,10
TIKI,tui-thoi-trang-nam,191044555,"ví nam ví nam clutch cầm tay cao cấp",288000,320000,32000,10
TIKI,tui-thoi-trang-nam,103534782,"Ví móc khóa cầm tay đa năng 4U nhiều màu FMK06",25000,50000,25000,50
TIKI,tui-thoi-trang-nam,155776132,"Túi đeo chéo nam nữ unisex phong cách ulzzang sợi polyesster cao cấp chống thấm nước Haoshuai S2",145000,145000,0,0
TIKI,tui-thoi-trang-nam,183330035,"Túi đeo chéo đeo vai nam 100% da bò  thật cao cấp phong cách châu âu",675000,750000,75000,10
TIKI,tui-thoi-trang-nam,185946011,"Túi đeo chéo nam đa chức năng cao cấp phong cách cá tính mới",621000,690000,69000,10
TIKI,tui-thoi-trang-nam,161954755,"Túi Xách Nam Công Sở Gence Da Bò Cao Cấp CTS12 Khóa Số",3200000,3200000,0,0
TIKI,tui-thoi-trang-nam,41664315,"Cặp công sở thời trang YUUMY CAYUUMY 11",255000,490000,235000,48
TIKI,tui-thoi-trang-nam,711402,"Túi Đeo Chéo Nam HARAS HRTK127 (32 x 18 cm) - Đen",150000,150000,0,0
TIKI,tui-thoi-trang-nam,47477869,"Túi xách đeo chéo nam nữ phản quang phong cách Hàn Quốc Mituza TX36",32670,44649,11979,27
TIKI,tui-thoi-trang-nam,54420877,"Túi đeo chéo,đeo ngực nam đã tích hợp công nghệ 4.0",621000,690000,69000,10
TIKI,tui-thoi-trang-nam,73361438,"VÍ NGẮN GẬP DA Bóp COSMOS Da Saffiano Nhập Khẩu Cao Cấp Chống Thấm Nước Unisex Nam Nữ Chuẩn Leonardo DOLANTO",220000,220000,0,0
TIKI,tui-thoi-trang-nam,58227879,"Ví nam da thật TRITA RVN002",199000,380000,181000,48
TIKI,tui-thoi-trang-nam,145413858,"Túi đeo chéo da nam đa năng LATA TN21",369000,390000,21000,5
TIKI,tui-thoi-trang-nam,179207900,"Túi Đeo Chéo Nam TK07 - Túi Đeo Chéo Hàn Quốc - Túi Đeo Trước Ngực - Túi Bao Tử",99000,99000,0,0
TIKI,tui-thoi-trang-nam,143384978,"Ví Nam Cao Cấp, Da Bò PEBBLE Mềm Mại - Bền Bỉ, Size Lớn, Chống Xước - Chống Nhăn Tốt,  Thiết Kế Cổ Điển, Dáng Ngang - Gập 2, Ngăn Đựng Tiền Có Khóa Kéo, Nhiều Ngăn Để Giấy Tờ Tiện Dụng - Hàng Chính Hãng SAIGIO",1132000,1149000,17000,1
TIKI,tui-thoi-trang-nam,155340658,"Ví mini nam da bò sáp ngựa điện Crazyhorse V125 cao cấp, bóp đựng thẻ da thật, đường chỉ tinh tế, ví nam nhỏ gọn dáng đứng, fullbox, thương hiệu Bụi leather chuyên đồ da thật",180000,200000,20000,10
TIKI,tui-thoi-trang-nam,193004750,"Túi đeo chéo nam, túi bao tử nam Mars Bụi Leather DC109 - Da bò thật cao cấp - Bảo hành 12 tháng",429000,605000,176000,29
TIKI,tui-thoi-trang-nam,159631049,"Túi đeo chéo DIVOOM Pixoo Slingbag-V hiển thị màn hình LED, có thể đựng Laptop/iPad 11 inch - Hàng chính hãng",2300000,2300000,0,0
TIKI,tui-thoi-trang-nam,150545045,"Cặp Da Nam , Túi Xách Nam Công Sở Cao Cấp 8012-3, Thiết kế Sang Trọng, Lịch Lãm",695000,695000,0,0
TIKI,tui-thoi-trang-nam,78946196,"Ví nam cầm tay 100% da bò thật cao cấp phong cách mới",513000,570000,57000,10
TIKI,tui-thoi-trang-nam,271887160,"Clutch da bò cao cấp MARRANT - BHM8986 Ví da cầm tay cao cấp. Hàng chính hãng",899000,899000,0,0
TIKI,tui-thoi-trang-nam,193308675,"Túi Đeo Chéo Vải Nylon Nhiều Ngăn Chứa Cho Nam Nữ Cao Cấp Đi Chơi Chống Nước, Túi Đựng Điện Thoại, Túi Đeo Vai Thời Trang Sang Trọng Thời Thượng",125000,125000,0,0
TIKI,tui-thoi-trang-nam,183046677,"Ví nam 100% da bò thật  cao cấp phong cách mới",171000,190000,19000,10
TIKI,tui-thoi-trang-nam,197879894,"Bóp Đứng Nam Nhỏ Gọn, Chất Liệu Da Bò PULL-UP Mềm Mại, Mỏng Nhẹ, Phong Cách Hiện Đại - Cá Tính, Size Trung, Dáng Đứng - Gập 2, Nhiều Ngăn Để Tiền Và Giấy Tờ Tiện Dụng",982000,999000,17000,2
TIKI,tui-thoi-trang-nam,119132514,"Ví đựng namecard Trita Liberal RVN11",59000,150000,91000,61
TIKI,tui-thoi-trang-nam,146223397,"Túi đeo chéo nam Da bò thật Bụi Leather DC106 - Nhiều ngăn tiện dụng, Unisex - Bảo hành 12 tháng",469000,530000,61000,12
TIKI,tui-thoi-trang-nam,145978003,"Túi đeo chéo nam, túi xách tay da bò thật Bụi Leather DC104 - Da bò Mill cao cấp, Unisex - Bảo Hành 12 tháng",525000,850000,325000,38
TIKI,tui-thoi-trang-nam,100320879,"Ví Handmade Nam KEIO NIPPON Da Bò Epsom Cao Cấp / Bóp Nam Da Bò May Thủ Công",249000,249000,0,0
TIKI,tui-thoi-trang-nam,59086244,"Túi xách cặp da đựng laptop da bò công sở T03 38x28x6cm",329000,329000,0,0
TIKI,tui-thoi-trang-nam,187621731,"Ví Passport Da Bò PEBBLE Mềm Mại - Bền Bỉ, Chống Xước - Chống Nhăn Tốt, Thiết Kế Hiện Đại - Đa Năng, Đựng Được Nhiều Loại Hộ Chiếu, Nhiều Ngăn Thẻ ATM, Đựng Tiền, Vé Máy Bay, Tiện Dụng Khi Đi Du Lịch, Công Tác - Hàng Chính Hãng SAIGIO",1229000,1249000,20000,2
TIKI,tui-thoi-trang-nam,121173964,"Bóp Nam Da Bò VINTAGE Hoài Cổ, Chất Da Mềm Mại - Vân Tự Nhiên, Size Lớn, Thiết Kế Cổ Điển, Đơn Giản - Mỏng Nhẹ, Dáng Ngang - Gập 2, Ngăn Đựng Tiền Có Khóa Kéo, Nhiều Ngăn Để Giấy Tờ Tiện Dụng - Hàng Chính Hãng SAIGIO",879000,899000,20000,2
TIKI,tui-vi-nu,68298067,"Dây Và Mặt Dây Chuyền bạc 925  hình Phật Bà Quan Thế Âm Bồ Tát DMD162 Bạc Hiểu Minh",368000,480000,112000,23
TIKI,tui-vi-nu,30030012,"Dây chuyền nữ xi mạ",265000,265000,0,0
TIKI,tui-vi-nu,1816547,"Vòng Tay Đá Mã Não Đen Liền Khối Ngọc Quý Gemstones U21",255000,300000,45000,15
TIKI,tui-vi-nu,85384559,"Mặt dây chuyền phật Bà Quan Thế Âm Bồ Tát đá ngọc phỉ thúy",230000,230000,0,0
TIKI,tui-vi-nu,22367146,"Vòng Tay Nam Đá Mắt Hổ Nâu Đỏ 14ly",195000,195000,0,0
TIKI,tui-vi-nu,167427088,"Đồng Hồ Nữ 2 trong 1 Julius Ja-1242 (gồm 1 dây da và 1 dây Kim loại)",989000,989000,0,0
TIKI,tui-vi-nu,36335533,"Nhẫn Nam Mặt Tròn Chất Liệu Titan Không Đen Không Dị Ứng TT 2227",142000,142000,0,0
TIKI,tui-vi-nu,10933534,"Vòng cổ choker tattoo V48",16000,16000,0,0
TIKI,tui-vi-nu,54365663,"Dây chuyền | Dây chuyền nữ | Dây Chuyền Bạc | Dây Chuyền Bạc Nữ S925 Đơn Giản DB2478 Bảo Ngọc Jewelry",272000,272000,0,0
TIKI,tui-vi-nu,154073615,"Set Dây Chuyền Vàng 14K Đính Đá CZ",8050000,8750000,700000,8
TIKI,tui-vi-nu,881892,"Bộ 2 Bông Tai Hình Ngôi Sao Winwinshop88 BT184 - Đen",39500,39500,0,0
TIKI,tui-vi-nu,154240057,"Vòng tay đá mã não tứ quý may mắn 8mm cho các bạn Nữ công sở làm trang sức",149000,149000,0,0
TIKI,tui-vi-nu,111121473,"Mặt Dây Chuyền Hổ Phách Baltic Cognac - Tulip",506000,550000,44000,8
TIKI,tui-vi-nu,157076798,"Đồng Hồ Nam Dây Nhựa Casio G-Shock GA-2100-7ADR Chính Hãng - GA-2100-7A",2860500,3814000,953500,25
TIKI,tui-vi-nu,25056696,"Bông tai ngọc nụ BHBT248",56000,87000,31000,36
TIKI,tui-vi-nu,14035850,"Đồng hồ thể thao nam nữ trẻ trung, năng động phong cách Hàn Quốc",164000,164000,0,0
TIKI,tui-vi-nu,44152821,"Vòng Tay Trầm Hương Nam - 108 Hạt",149000,149000,0,0
TIKI,tui-vi-nu,58918404,"Dây chuyền nữ phụng mặt xoàn mạ 18k cao cấp P2015",309000,309000,0,0
TIKI,tui-vi-nu,137341096,"Vòng đeo cổ dây chuyền dây dù bện thủ công - dây dù 3ly đeo cổ MS04112021",35000,35000,0,0
TIKI,tui-vi-nu,55549481,"Vòng ximen chạm bộ 7 chiếc mạ 18k cao cấp H61",171000,180000,9000,5
TIKI,tui-vi-nu,13862282,"Nhẫn nữ ximen trơn  mạ vàng 18k mã EK3094",104500,104500,0,0
TIKI,tui-vi-nu,11395984,"Vòng cổ choker tattoo hoa lỗ đính hạt đen V52 thời trang",16000,16000,0,0
TIKI,tui-vi-nu,43815348,"Đồng hồ đeo tay thời trang vesi nữ cực đẹp DH70",31399,31399,0,0
TIKI,tui-vi-nu,15345917,"Vòng Tay Phong Thủy Thạch Anh Tóc Xanh - Hợp Mệnh Mộc, Mệnh Hỏa - Viên Đá Của Sự Che Chở - Xua Đi Cái Xấu",1200000,1200000,0,0
TIKI,tui-vi-nu,188131521,"Vòng cẩm thạch xanh nhẹ nhàng bản tròn PQ6034 ni 51-52",4600000,4600000,0,0
TIKI,tui-vi-nu,183701081,"Đồng Hồ Nam Dây Nhựa Casio Standard AEQ-120W-1AVDF Chính Hãng - AEQ-120W-1A Pin 10 Năm",1292250,1723000,430750,25
TIKI,tui-vi-nu,117490679,"Dây Chú Lăng Nghiêm Pha lê",165000,165000,0,0
TIKI,tui-vi-nu,48726282,"Nhẫn bạc nữ kim tiền trơn tài lộc - Trang sức bạc Panmila (NN.K2)",115000,115000,0,0
TIKI,tui-vi-nu,129347495,"Đồng Hồ Casio Nam G Shock DW-5600BB-1DR",3528000,3528000,0,0
TIKI,tui-vi-nu,194039628,"Đồng Hồ Nam Citizen Dây Thép Không Gỉ Mặt Đính Đá - Hiển Thị Lịch Ngày",599000,599000,0,0
TIKI,tui-vi-nu,87093189,"Nhẫn đá mã não tự nhiên dành cho cả nam và nữ (Thái Lan)",66000,66000,0,0
TIKI,tui-vi-nu,77119000,"Lắc Tay Nữ | Lắc Tay Nữ Ngọc Trai Kết Hợp Đá Mã Não L0910 - Bảo Ngọc Jewelry",720000,720000,0,0
TIKI,tui-vi-nu,115099487,"Nhẫn nữ freesize chất liệu bạc s925 MS05b",85000,85000,0,0
TIKI,tui-vi-nu,71059933,"Đồng hồ nữ chính hãng Lobinni No.027-4",3190000,5071429,1881429,37
TIKI,tui-vi-nu,90725426,"Lắc tay nam inox kiểu lặc kép xéo cá tính thép không gỉ 13mm- QuynhChi Store",99750,99750,0,0
TIKI,tui-vi-nu,25746334,"Lắc Tay Nam Bằng Bạc Ta LTN006 5,5 Chỉ",690000,720000,30000,4
TIKI,tui-vi-nu,49736721,"Nhẫn Nữ Zic Zac Titan Ko Đen TT 0732",88000,88000,0,0
TIKI,tui-vi-nu,58059223,"Đồng hồ nam chính hãng Lobinni No.5025-1",4720000,7542857,2822857,37
TIKI,tui-vi-nu,50273910,"Dây Chuyền Đeo Cổ Nam inox Đẹp Mạ Vàng + TẶNG LÁ BỒ ĐỀ MAY MẮN TÀI LỘC ĐỂ VÍ ĐIỆN THOẠI",232750,245000,12250,5
TIKI,tui-vi-nu,21035473,"Vòng Tay Phong Thủy Đá Mắt Hổ Nâu Đỏ Phối Charm Tỳ Hưu Bạc (10mm) Mệnh Hỏa, Thổ Ngọc Quý Gemstones",519000,741000,222000,30
TIKI,tui-vi-nu,147264971,"Ví Đựng Thẻ ATM Cao Cấp Slim CITIZEN, Da Bò Tự Nhiên Cao Cấp, Da Thuộc Thảo Mộc, Nhập Khẩu Từ Châu Âu, Nhỏ Gọn - Hiện Đại - Chuyên Nghiệp, Đựng Tiền, Thẻ Ngân Hàng, Card Danh Thiếp - Hàng Chính Hãng SAIGIO",2079000,2099000,20000,1
TIKI,tui-vi-nu,8173385,"Ví bóp tiền nữ Nút bấm hoa nhiều cánh phong cách cổ kính",155000,155000,0,0
TIKI,tui-vi-nu,109710949,"Túi cói merci loại 1 màu sáng, có đệm đáy giữ form túi, có lót",45000,51930,6930,13
TIKI,tui-vi-nu,180720264,"Túi Xách Thời Trang Nữ Da Thật Cao Cấp Gence TX04",1650000,1650000,0,0
TIKI,tui-vi-nu,132078384,"Túi Đeo Chéo Khóa Gài T22 Caro Trắng",136000,195600,59600,30
TIKI,tui-vi-nu,25110038,"Vỏ Bọc Hộ Chiếu Du Lịch Có Khe Nhét Thẻ Tiện Dụng",2999,2999,0,0
TIKI,tui-vi-nu,148967272,"Túi cói Merci sang chảnh",39499,39499,0,0
TIKI,tui-vi-nu,171648720,"Túi Xách Nữ Đeo Chéo Hình Gấu Dễ Thương, Túi Đeo Vai Nữ Học Sinh Đi Học, Đi Chơi Nhiều Màu - OTV118 - Ope Store",193000,193000,0,0
TIKI,tui-vi-nu,120538387,"HC6255-56-57-58 - Túi đeo nữ da cá sấu Huy Hoàng màu đen, nâu đỏ, vàng bò, nâu đất",3499000,3499000,0,0
TIKI,tui-vi-nu,114697216,"Túi đeo chéo nữ cao cấp, đựng điện thoại tiện dụng, túi đeo chéo nữ mini 2 ngăn nhỏ gọn đẹp, thời trang, cá tính giá rẻ",159000,159000,0,0
TIKI,tui-vi-nu,182713289,"Ví nữ Monogram Canvas ELLY – EV89",599400,999000,399600,40
TIKI,tui-vi-nu,160314498,"Ví Nữ Mini Cầm Tay Hàng Hiệu TAILIAN Đựng Tiền Đựng Thẻ Da Cao Cấp Nhiều Ngăn Tiện Dụng Đẹp Giá Rẻ TL04 - Micocah Mall",99000,99000,0,0
TIKI,tui-vi-nu,176661865,"Túi xách đính đá thời trang nữ",439000,439000,0,0
TIKI,tui-vi-nu,114119921,"Túi Xách Nữ Công Sở thời trang hàn quốc 2021 - TÚI TOTE - TÚI A4 -TÚI BIGSIZE",199500,199500,0,0
TIKI,tui-vi-nu,176535891,"[SGFS-T55] Túi tote Vải canvas mềm Đẹp Cực Hot đựng vừa a4 [CÓ SẴN][XINH XẮN] Túi vải xinh hình",85000,85000,0,0
TIKI,tui-vi-nu,149449531,"Túi CEEKAY 2021 - Túi xách nữ cao cấp hàng chính hãng Fullbox",546000,546000,0,0
TIKI,tui-vi-nu,181096767,"Túi xách nữ MONOGRAM CANVAS ELLY – EL204",999500,1999000,999500,50
TIKI,tui-vi-nu,176453886,"Túi xách đính đá thời trang nữ",329000,329000,0,0
TIKI,tui-vi-nu,32454277,"Túi bao tử đeo chéo hip hop, sành điệu cao cấp cho bạn nam và nữ",120000,120000,0,0
TIKI,tui-vi-nu,79844409," Khăn Turban (Khăn Quấn Túi Xách) Cao Cấp Chất Lụa Satin - 5x90cm - Mã TD000",20900,20900,0,0
TIKI,tui-vi-nu,161964666,"Túi đeo nữ thời trang cao cấp",225000,225000,0,0
TIKI,tui-vi-nu,102576041,"Túi Đeo Chéo Thời Trang Hàn Quốc HARAS HR281",100000,100000,0,0
TIKI,tui-vi-nu,137154005,"Túi Tote Vải Canvas Stay At Home Có Khóa Miệng Túi",35000,35000,0,0
TIKI,tui-vi-nu,200651557,"Túi đeo chéo da nữ khóa nhấn hình thoi Lata HN97",590000,590000,0,0
TIKI,tui-vi-nu,200016856,"Ví vải thổ cẩm/vải thêu dây cầm gắn hạt xinh xắn (ảnh thật)",20000,20000,0,0
TIKI,tui-vi-nu,34943636,"Túi vải Bơ đi mà sống",140000,140000,0,0
TIKI,tui-vi-nu,248715249,"Túi đeo chéo mini nữ trẻ trung thời trang phong cách Hàn Quốc",119000,119000,0,0
TIKI,tui-vi-nu,56421161,"Túi đeo chéo vai nữ nhiều mẫu hình thời trang cao cấp KS51",53460,73062,19602,27
TIKI,tui-vi-nu,160315109,"Ví Bóp Nữ Dài Cầm Tay FOREVER YOUNG Phong Cách Hàn Quốc Siêu Đẹp Nhiều Ngăn Tiện Dụng FY54 - Micocah Mall",149000,149000,0,0
TIKI,tui-vi-nu,69470828,"Túi Xách Nữ Đẹp Đeo Chéo Kiểu Dáng Đơn Giản Basic, Túi Vải Canvas Đeo Chéo Kích Thước Lớn Tiện Dụng - OTV064 - Ope Store",144000,144000,0,0
TIKI,tui-vi-nu,129819243,"Túi đeo chéo, túi đeo vai nữ vải canvas TV11, chất vải canvas siêu bền đẹp, hàng nhập Quảng Châu",50000,50000,0,0
TIKI,tui-vi-nu,53782142,"Túi đeo chéo chống shock để ipad nam nữ unisex Hàn quốc thời trang BEE GEE 078 hot trend 2020",45000,90000,45000,50
TIKI,tui-vi-nu,149449660,"( MỚI) Túi xách nữ đeo chéo ô Trám khóa xoay - Hàng cao cấp da sịn",464000,464000,0,0
TIKI,tui-vi-nu,249914629,"Ví cầm tay nữ gấp nhiều ngăn da bò Epsom nhập khẩu, vừa GPLX cũ, thẻ BHYT - Pink Ohara",650000,650000,0,0
TIKI,tui-vi-nu,160314394,"Ví Bóp Nữ Mini Cầm Tay FOREVER YOUNG Đựng Tiền Nhiều Ngăn Tiện Dụng Chất Da Xước Cao Cấp Cực Đẹp FY49 - Micocah Mall",149000,149000,0,0
TIKI,tui-vi-nu,172192207,"Túi nữ thời trang phong cách Hàn Quốc Thành Long TLG  208111 3(xám)  Tặng túi đựng bút tiện lợi",30000,30000,0,0
TIKI,tui-vi-nu,13407051,"Túi Bao Tử Đeo Chéo Apehlic Phong Cách Hàn P948 Parisa",77000,77000,0,0
TIKI,tui-vi-nu,144065762,"túi xách nhung hộp mần xui cao cấp- túi cầm tay nhung hộp đính hoa đá đi tiệc cao cấp( ảnh thật )",399000,399000,0,0
TIKI,tui-vi-nu,86561311," Túi xách nữ    Túi đeo chéo mini dây xích SANG CHẢNH TD18",78000,78000,0,0
TIKI,tui-vi-nu,273205303,"Vascara Túi Tote Minimalism Nhấn Quai Bản Dài - TOT 0146",1026000,1026000,0,0
TIKI,tui-thoi-trang-nam,104293958,"Bóp Ví Nam Da Bò Mini Đựng Thẻ Card, Tiền Mặt Tiện Lợi DAVANTI DFC01",149000,170000,21000,12
TIKI,tui-thoi-trang-nam,82984240,"Ví Da Nam Cầm Tay Sang Trọng - Phong Cách - Đẳng Cấp",143550,207350,63800,31
TIKI,tui-thoi-trang-nam,77741652,"Túi đeo chéo cao cấp phong cách châu âu",585000,650000,65000,10
TIKI,tui-thoi-trang-nam,52528468,"Túi đeo chéo nam phong cách châu âu",225000,250000,25000,10
TIKI,tui-thoi-trang-nam,166227487,"[VOUCHER 30K] Túi da nam đeo chéo dáng ngang LATA TN27",620000,620000,0,0
TIKI,tui-thoi-trang-nam,70882597,"Bóp Nam Ví Nam Cao Cấp Đa Năng (VI-009)",109500,109500,0,0
TIKI,tui-thoi-trang-nam,173542482,"Ví Da Bò Nam Bóp Da Nam Cao Cấp Hàng Hiệu POLO MEISDO (Da Thật 100%) Full Hộp Phù Hợp Làm Quà Biếu Tặng Sinh Nhật",1300000,1300000,0,0
TIKI,tui-thoi-trang-nam,5077161,"Ví nam cầm tay Timall BLR23 phong cách châu Âu",99000,99000,0,0
TIKI,tui-thoi-trang-nam,184316710,"Túi đeo chéo nam vải canvas cao cấp phong cách mới",360000,399000,39000,10
TIKI,tui-thoi-trang-nam,93842772,"Túi đeo chéo đeo ngực nam cao cấp phong cách mới",621000,690000,69000,10
TIKI,tui-thoi-trang-nam,189703069,"Túi đeo chéo nam thời trang chính hãng YVan 1503",385000,385000,0,0
TIKI,tui-thoi-trang-nam,43395324,"Túi Đeo Chéo Nam Bằng Da Cao Cấp Retro (27 x 15cm) _ Tặng Kèm Móc Khóa Dây da",55000,55000,0,0
TIKI,tui-thoi-trang-nam,176939287,"Ví nam 100% da bò thật cao cấp phong cách mới",387000,430000,43000,10
TIKI,tui-thoi-trang-nam,68244501,"Túi Đeo Chéo Nam Da Cá Sấu SPot1",175000,175000,0,0
TIKI,tui-thoi-trang-nam,43872903,"Cặp da công sở LATA CA27",569000,690000,121000,18
TIKI,tui-thoi-trang-nam,161538053,"Ví Cầm Tay Nam Gence Da Bò Cao Cấp RB06 Khóa Vân Tay",2750000,2750000,0,0
TIKI,tui-thoi-trang-nam,145918249,"Túi đeo chéo nam da bò Mill cao cấp Bụi Leather DC103 - Nhiều ngăn, tiện lợi - Bảo hành 12 tháng",579000,971000,392000,40
TIKI,tui-thoi-trang-nam,594977,"Ví Dài Nam Baellerry Sang Trọng Đẳng Cấp GL WL1006",90090,123123,33033,27
TIKI,tui-thoi-trang-nam,26613767,"Túi Đeo Chéo, Túi Bao Tử Nam Nữ Thời Trang Cao Cấp SAKOS PICO",999000,1100000,101000,9
TIKI,tui-thoi-trang-nam,148850134,"Túi đeo hông, đeo ngực Arctic Hunter YB00029 chất liệu Oxford chống thấm nước, nhiều ngăn đa năng, phù hợp chạy bộ",279000,500000,221000,44
TIKI,tui-thoi-trang-nam,193614818,"Túi đeo chéo nam đa năng cao cấp phong cách mới",207000,230000,23000,10
TIKI,tui-thoi-trang-nam,149969160,"Túi đeo chéo đeo ngực nam cao cấp phong cách châu âu",801000,890000,89000,10
TIKI,tui-thoi-trang-nam,181561656,"Bóp Nam Cao Cấp, Chất Liệu Da Bò PULL-UP Mềm Mại, Mỏng Nhẹ, Phong Cách Hiện Đại - Cá Tính, Size Trung, Dáng Ngang - Gập 2, Nhiều Ngăn Để Tiền Và Giấy Tờ Tiện Dụng - Hàng Chính Hãng SAIGIO",981000,999000,18000,2
TIKI,tui-thoi-trang-nam,170523409,"Ví dài cầm tay nam The Zipper Wallet chính hãng NATOLI đựng thẻ điện thoại nhiều ngăn cao cấp",489000,698000,209000,30
TIKI,tui-thoi-trang-nam,215531382,"Túi Đeo Chéo Chần Bông SAIGON SWAGGER NOIR PUFFER BAG",441000,490000,49000,10
TIKI,tui-thoi-trang-nam,112218056,"Túi đeo chéo nam đa năng cao cấp phong cách mới",269000,298000,29000,10
TIKI,tui-thoi-trang-nam,13642459,"Túi đeo vai nam BEE GEE 06 XAM",78000,158000,80000,51
TIKI,tui-thoi-trang-nam,74864406,"Ví Nam Cao Cấp Da Bò Thật LATA LVN71 Nhiều Màu (Gấp lại: Dài 11cm x Cao 8cm)",309000,420000,111000,26
TIKI,tui-thoi-trang-nam,190109508,"Ví Nam Mini Nhỏ Gọn Cao Cấp, Da Bò SMALL PEBBLE Mềm Mại - Bền Bỉ, Chống Xước - Chống Nhăn Tốt, Thiết Kế Đơn Giản, Dáng Ngang - Gập 2, Đựng Tiền và Thẻ ATM Tiện Dụng",882000,899000,17000,2
TIKI,tui-thoi-trang-nam,53771061,"Túi đeo chéo nam nữ thời trang Hàn quốc BEE GEE 082 chống thấm nước hot trend 2020",69000,140000,71000,51
TIKI,tui-thoi-trang-nam,192398346,"Túi đeo chéo đeo trước ngực nam đa năng cao cấp phong cách mới",297000,330000,33000,10
TIKI,tui-thoi-trang-nam,128315948,"Túi bao tử nam BHL032 Túi đeo chéo. Da bò nguyên tấm",680000,680000,0,0
TIKI,tui-thoi-trang-nam,116785351,"Ví Da Nam Mềm Mại GENTLE, Size Lớn, Da Bò 100%, Thiết Kế Nhiều Ngăn, Đựng Giấy Tờ Xe, Đựng Tiền và Thẻ Tiện Dụng, Dáng Ngang - Gập 2 - Hàng Chính Hãng SAIGIO",782000,799000,17000,2
TIKI,tui-thoi-trang-nam,44085748,"Túi Đeo bao tử, nịt bụng đeo chéo đa năng ngang kéo tian l21",78210,106887,28677,27
TIKI,tui-thoi-trang-nam,195767534,"Ví Đứng Nam Size Lớn, Da Bò PEBBLE Mềm Mại - Bền Bỉ, Chống Xước - Chống Nhăn Tốt, Thiết Kế Cổ Điển, Dáng Đứng - Gập 2, Ngăn Đựng Tiền Có Khóa Kéo, Nhiều Ngăn Để Giấy Tờ Tiện Dụng",1133000,1149000,16000,1
TIKI,tui-thoi-trang-nam,192129582,"Túi xách nam công sở da PU màu trơn thanh lịch có khóa số chính hãng YVan F80175-5",620000,620000,0,0
TIKI,tui-thoi-trang-nam,11720488,"Cặp đeo chéo TROY phối nắp khóa cài và dây kéo xéo",168000,199000,31000,16
TIKI,tui-thoi-trang-nam,193395604,"Clutch, Ví Cầm Tay Thời Trang Nam Da Bò Epsom Cao Cấp HT19",1490000,1490000,0,0
TIKI,tui-thoi-trang-nam,193106908,"Ví nam da bò thật dáng ngang cao cấp TRITA RVN21",199000,390000,191000,49
TIKI,tui-thoi-trang-nam,924532,"Túi Đeo Chéo Nam HARAS HRTK147VN (26 x 17 cm) - Xám",65000,65000,0,0
TIKI,voucher-dich-vu,20903068,"Tour Huế 1 ngày từ Đà Nẵng",400000,400000,0,0
TIKI,voucher-dich-vu,34589880,"Khóa Học Ứng Dụng Data Science Và Machine Learning",15010000,15010000,0,0
TIKI,tui-vi-nu,248991514,"XI MÚT ĐÁNH BÓNG GOLDCARE",70000,70000,0,0
TIKI,tui-vi-nu,131338262,"Túi vải bố, Túi vải Canvas trơn Màu Trắng",29000,29000,0,0
TIKI,voucher-dich-vu,195856964,"[EVoucher Vietravel] Đà Nẵng - Hội An - KDL Bà Nà - Cầu Vàng - Huế - Thưởng thức Ca hò Huế trên sông Hương",5190000,5190000,0,0
TIKI,voucher-dich-vu,72101230,"KHÓA HỌC THIẾT KẾ HỆ THỐNG MICROSERVICE CĂN BẢN",6000000,6000000,0,0
TIKI,voucher-dich-vu,121225216,"[E-VOUCHER] - BABILALA - Tiếng Anh chất lượng cao cho trẻ từ 3 -8 tuổi",890000,890000,0,0
TIKI,tui-vi-nu,67087965,"Túi xách nữ GGTT -67",129000,129000,0,0
TIKI,tui-vi-nu,95063187," Túi đeo chéo nữ vải canvas nút bấm hình com bướm đựng vừa a4 - 2 màu",89900,89900,0,0
TIKI,tui-vi-nu,113404169,"Túi Ngang Đeo Hông, Đeo Chéo Spost",48400,48400,0,0
TIKI,voucher-dich-vu,204673897,"Vé Du Thuyền Sông Hàn - Ngắm Cảnh Đà Nẵng Về Đêm - Xem Cầu Rồng Phun Lửa, Phun Nước Thứ 6 & Thứ 7 & Chủ Nhật Hằng Tuần",100000,100000,0,0
TIKI,voucher-dich-vu,105707950,"Centara Mirage Resort 5* Mũi Né - Buffet Sáng, Hồ Bơi Công Viên Nước Rộng Lớn, Đối Diện Biển Mũi Né",1700000,1700000,0,0
TIKI,voucher-dich-vu,117570607,"Khóa học Trị liệu VIÊM MŨI dị ứng, VIÊM XOANG mãn tính - VMC",400000,400000,0,0
TIKI,voucher-dich-vu,53827433,"Lotus Mũi Né Resort & Spa 4* - Buffet Sáng, Hồ Bơi Lớn, Bãi Biển Riêng, Gần Phan Thiết & Các Điểm Tham Quan",1330000,1330000,0,0
TIKI,tui-vi-nu,184223381,"Túi xách túi đeo vai nữ vải canvas thời trang cao cấp phong cách mới",333000,370000,37000,10
TIKI,voucher-dich-vu,99443885,"Villa Vinpearl Nha Trang Bay 2N1Đ | Ăn sáng & Vui chơi Vinwonders không giới hạn",6150000,6150000,0,0
TIKI,voucher-dich-vu,152667673,"Sách nói: Sự Va Chạm Giữa Các Nền Văn Minh Và Sự Tái Lập Trật Tự Thế Giới",99000,99000,0,0
TIKI,voucher-dich-vu,179757499,"Sách nói: Doanh Nghiệp Của Thế Kỷ 21",99000,99000,0,0
TIKI,voucher-dich-vu,164551501,"Phiếu Quà Tặng Việt Talents 300.000đ ",300000,300000,0,0
TIKI,tui-vi-nu,44580877,"Ví cầm tay nữ cao cấp 2 ngăn khóa BA04",143550,207350,63800,31
TIKI,voucher-dich-vu,221710057,"[E-Voucher] Vietourist - Tour Du Lịch Đà Lạt 3 Ngày 3 Đêm - Khám Phá Thành Phố Sương Mù",990000,990000,0,0
TIKI,voucher-dich-vu,152814757,"Sách nói: Bàn Về Cách Sống - Đối Thoại Giữa Triết Gia, Bác Sỹ Và Nhà Sư",99000,99000,0,0
TIKI,tui-vi-nu,139468542,"Túi xách đeo vai túi xách tay công sở size lớn chất đẹp NK14",96000,96000,0,0
TIKI,tui-vi-nu,72025526,"Túi Xách Nữ V20",129000,129000,0,0
TIKI,voucher-dich-vu,196929331,"[Phú Quốc 2N1Đ] Wyndham Grand Resort Phú Quốc - Buffet sáng dành cho 02 người",1650000,1650000,0,0
TIKI,voucher-dich-vu,174849433,"Villa Movenpick Cam Ranh Resort 5* Nha Trang - Hướng Biển, Buffet Sáng, Công Viên Nước, Thưởng Thức Chocolate, Nhiều Hoạt Động Hấp Dẫn",3800000,3800000,0,0
TIKI,tui-vi-nu,56093264,"Túi Xách Nữ Đeo Chéo Mẫu Mới Nhất (Size 23)",75000,75000,0,0
TIKI,tui-vi-nu,96312652,"Túi Xách Niche Rento (Túi Kẹp Nách) Mini Da Mềm Xếp Li Đeo Vai Hot Trend Phong Cách Châu Âu - Mã XT036",104500,104500,0,0
TIKI,tui-vi-nu,176535717,"[SGFS56] Túi tote Vải canvas mềm Đẹp Cực Hot đựng vừa a4 [CÓ SẴN][XINH XẮN]Túi vải thời trang",75000,75000,0,0
TIKI,voucher-dich-vu,214784524,"Gói 3N2Đ The Arena Cam Ranh Resort 5* Khánh Hòa - Buffet Sáng, Hồ Bơi Rộng Lớn, Biển Bãi Dài, Nhiều Hoạt Động Giải Trí Hấp Dẫn",2590000,2590000,0,0
TIKI,tui-vi-nu,86560832,"Ví nữ    Ví cầm tay nữ mini cao cấp ngắn cute nhỏ gọn bỏ túi thời trang giá rẻ V091111",16900,16900,0,0
TIKI,tui-vi-nu,102143682,"Túi đeo chéo/ Túi xách nữ thời trang phong cách Hàn Quốc",119000,219000,100000,46
TIKI,tui-vi-nu,193186934,"Ví Nữ Thời Trang cao cấp phong cách mới – VNU1001",200000,400000,200000,50
TIKI,voucher-dich-vu,73473132,"Phòng chờ thương gia  Lotus Lounge - Sân bay Cam Ranh",400000,400000,0,0
TIKI,tui-vi-nu,165760938,"Túi Xách Nữ Đeo Chéo Quai Lụa Cao Cấp NUTUSHOP - NT45",289000,289000,0,0
TIKI,voucher-dich-vu,164543556,"Phiếu Quà Tặng Việt Talents 500.000đ ",500000,500000,0,0
TIKI,voucher-dich-vu,9944105," Liệu Trình Massage Cổ, Vai, Lưng + Ấn Huyệt Trị Liệu Tại Ann Beauty Clinic",199000,199000,0,0
TIKI,tui-vi-nu,185079603,"Túi xách nữ Oscar - OCWHBSG 058",690000,1890000,1200000,63
TIKI,tui-vi-nu,73260559,"Ví tay Nữ mini sang trọng siêu năng kẹp nút Bi Tròn LL4 Tặng móc khóa cá heo",117810,161007,43197,27
TIKI,voucher-dich-vu,152670819,"Sách nói: Khỏe Hơn 10 Tuổi Nhờ Uống Nước Đúng Cách",99000,99000,0,0
TIKI,voucher-dich-vu,164055091,"Tour Nam Du 3N3Đ - Khám Phá Quần Đảo Nam Du - Tàu cao tốc Superdong khứ hồi Rạch Giá - Nam Du - Hòn Củ Tron - Bãi Đá Sỏi - Bãi Ngự - Giếng Ngự - Bãi Mến - Bãi Đá Đen - Bãi Chướng - Hòn Ngang - - Xe Giường Nằm Tầng Trên",2190000,2190000,0,0
TIKI,tui-vi-nu,193007974,"Túi đựng tiền, túi thời trang phong cách Châu Âu mã 6077",219000,399000,180000,45
TIKI,voucher-dich-vu,188688102,"[EVoucher Vietravel] Singapore 03 ngày 02 đêm (khách sạn 3 sao)",8990000,8990000,0,0
TIKI,voucher-dich-vu,15679309,"Gói 3N2Đ Best Western Premier Sonasea Resort 5* Phú Quốc - Dành Cho 02 Người Lớn & 02 Trẻ Em Dưới 16 Tuổi, Không Phụ Thu Noel, Tết Dương Lịch, Tết Âm Lịch",3280000,3280000,0,0
TIKI,tui-vi-nu,31885528,"Túi Xách Nữ 3 Ngăn 30x25x13cm DM267",299000,299000,0,0
TIKI,voucher-dich-vu,263060617,"[e-Voucher] 200K Dịch vụ Nha Khoa (áp dụng tất cả các dịch vụ tại 5 chi nhánh)",59000,59000,0,0
TIKI,tui-vi-nu,86561593,"Túi đeo chéo nữ    Túi xách nữ mini phối màu Fashion & Bag TD13",48000,48000,0,0
TIKI,tui-vi-nu,172801348,"Ví da nữ cầm tay nắp gập YUUMY Seasand YV61",159000,330000,171000,52
TIKI,tui-vi-nu,185964455,"Túi xách nữ vải canvas thời trang cao cấp phong cách cá tính mới",315000,350000,35000,10
TIKI,tui-vi-nu,98151817,"Túi đeo chéo, túi xách nữ công sở nữ họa tiết phong cách Hàn Quốc TN200",132000,132000,0,0
TIKI,voucher-dich-vu,10075832,"Combo Massage Body Thư Giãn Kiểu Thái Kết Hợp Tắm Bùn Khoáng Tại Thanh Thanh Spa (Miễn Tip)",229000,229000,0,0
TIKI,tui-vi-nu,52539642,"Túi xách nữ đeo chéo vân cá sấu",99000,99000,0,0
TIKI,tui-vi-nu,89261198,"Túi đeo chéo mini nữ Fimax FTDCMINI vải Oxford chống nước, túi nhỏ đeo chéo giá rẻ đựng điện phụ kiện đi dạo phố siêu cute  – BH 12 tháng",155000,155000,0,0
TIKI,voucher-dich-vu,130469465,"WeStudy - Xây dựng nhân vật hoạt hình [Tặng kèm khoá Vẽ thế giới Động vật]",199000,389000,190000,49
TIKI,tui-vi-nu,249669622,"Túi Đeo Chéo Nữ, Túi Xách Nữ Vuông Họa Tiết Da Cá Sấu Cao Cấp Phong Cách Hàn Quốc",85000,85000,0,0
TIKI,voucher-dich-vu,72215864,"KHÓA HỌC HCM - PRODUCT UX/UI DESIGN",4500000,4500000,0,0
TIKI,voucher-dich-vu,179733738,"Tour Thái Lan 5N4D. Hành Trình Khám Phá Bangkok - Pattaya. ",8199000,8199000,0,0
TIKI,tui-vi-nu,194461788,"Ví nhỏ cầm tay nữ da thật 9x17 VN111",247000,247000,0,0
TIKI,tui-vi-nu,191259116,"Ví Da Mini Cầm Tay 10 Ngăn Họa Tiết Chú Gấu 9 Mẫu Trà Sữa Ngộ Nghĩnh Bóp Nữ Da PU Cute Hot Trend( giao ngẫu nhiên)",50000,50000,0,0
TIKI,voucher-dich-vu,195462372,"Babilala (3 Tháng, 1 năm,Trọn đời)-EVOUCHER-Tiếng Anh chất lượng cao cho trẻ từ 3-8 tuổi",399000,399000,0,0
TIKI,voucher-dich-vu,113032111,"Quà Tặng Sách Nói: Không Bao Giờ Là Thất Bại! Tất Cả Là Thử Thách - Kèm Dịch Vụ Sinh Trắc Vân Tay – Phân Tích Tính Cách Hành Vi Cơ Bản",40000,40000,0,0
TIKI,tui-vi-nu,117294385,"Túi cói size lớn đi Tết đi chơi phối dây thổ cẩm 3 màu cực sang (hàng có sẵn)",93000,93000,0,0
TIKI,tui-vi-nu,86134461,"Túi xách nữ da dù chống nước túi xách công sở túi đeo vai thời trang phong cách Hàn Quốc TN67",139000,139000,0,0
TIKI,tui-vi-nu,262800445,"Túi Xách Nữ Thời Trang Cao Cấp Elly EL124",1399000,1399000,0,0
TIKI,voucher-dich-vu,11796673,"Gói Khám Tổng Quát Nâng Cao Cho Nam - Phòng Khám Careplus",4100000,4100000,0,0
TIKI,voucher-dich-vu,178057986,"Sách nói: Gian Nan Chồng Chất Gian Nan",99000,99000,0,0
TIKI,voucher-dich-vu,242618127,"Combo 3N2Đ VinOasis Phú Quốc 5* + Vé Máy Bay, 06 Bữa Buffet, VinWonders & Vinpearl Safari Không Giới Hạn, Đón Tiễn Sân Bay",8600000,8600000,0,0
TIKI,voucher-dich-vu,48313693,"Lobster Bay - Voucher 500g Crawfish Sốt Tự Chọn ",360000,360000,0,0
TIKI,tui-vi-nu,177254516,"Túi xách nữ thời trang công sở cao cấp phong cách mới",351000,390000,39000,10
TIKI,voucher-dich-vu,179952310,"[Giftpop] Phiếu Quà Tặng TOUS les JOURS 100K",100000,100000,0,0
TIKI,tui-vi-nu,161864224,"Túi xách nữ công sở đeo chéo hoạ tiết kẻ sọc sang trọng",75000,75000,0,0
TIKI,voucher-dich-vu,208103164,"Combo BABILALA EDUPIA Trọn Đời - Phần mềm Tiếng Anh chất lượng cao",1390000,1390000,0,0
TIKI,voucher-dich-vu,173224852,"Tour Ngũ Hành Sơn - Hội An (Gồm Ăn Tối, Đón Tận Nơi Từ Đà Nẵng, Vé Tham Quan, HDV) Khởi Hành 15h30-21h Hằng Ngày",225000,225000,0,0
TIKI,tui-vi-nu,72863522,"Túi vải tote nữ Canvas trơn trắng Gady",34000,34000,0,0
TIKI,tui-vi-nu,108830940,"VÍ MINI ĐỰNG THẺ NỮ Bóp Nhỏ Gọn Cardholder LUCY Da Saffiano Nhập Khẩu Cao Cấp Chống Thấm Nước",180000,180000,0,0
TIKI,tui-vi-nu,47965302,"Túi xách đựng A4, chất liệu vải bố, thấm nước, kết hợp dây đeo là dây thừng, không đau vai (Nhiều phiên bản để chọn)",79000,130000,51000,39
TIKI,tui-vi-nu,108253891,"Túi Đeo Chéo Nữ Hình Sao Biển Dễ Thương Lông Mềm Mịn",55000,55000,0,0
TIKI,tui-vi-nu,86561568,"Túi Xách Nữ /  50K - TÚI ĐEO CHÉO NỮ MINI HOA CÚC SIÊU XINH HOT TREND TV03",51000,51000,0,0
TIKI,voucher-dich-vu,86418158,"IELTS Prep",1175000,1175000,0,0
TIKI,tui-vi-nu,190170113,"Túi đeo chéo nữ thời trang công sở phong cách mới – DCNU1004",317000,640000,323000,50
TIKI,tui-thoi-trang-nam,154207423,"Cặp Xách Nam Công Sở Gence Da Bò Thật CDT04",2000000,2000000,0,0
TIKI,tui-thoi-trang-nam,56404583,"Túi đeo chéo nam đa năng phong cách châu âu",159000,159000,0,0
TIKI,tui-thoi-trang-nam,50260943,"Túi đeo ngực,đeo chéo nam phong cách châu âu hiện đại tích hợp sẵn công nghệ 4.0",531000,590000,59000,10
TIKI,tui-thoi-trang-nam,56959406,"Túi da đeo chéo kẻ caro cực chất cho nam - Hàng cao cấp",106733,145869,39136,27
TIKI,tui-thoi-trang-nam,126765534,"Túi đeo chéo da cao cấp unisex nam nữ chống nước thời trang hot trend",57500,115000,57500,50
TIKI,tui-thoi-trang-nam,155339575,"Ví sen 3 da bò Pullup V122, bóp mini nam nhỏ gọn hai màu đen và nâu, đường chỉ may tinh tế, đựng thẻ kẹp tiền tiện lợi,fullbox, thương hiệu Bụi leather chuyên đồ da thật",140000,227000,87000,38
TIKI,tui-thoi-trang-nam,44014184,"Cặp Da Công Sở LATA CA21",690000,690000,0,0
TIKI,tui-thoi-trang-nam,126973701,"Túi đeo chéo nam BHL144 Da bò thật dập nổi vân da cá sấu",650000,650000,0,0
TIKI,tui-thoi-trang-nam,150877234,"Clutch, Ví Cầm Tay Thời Trang Nam Khóa Số Da Bò Mill Cao Cấp RB07 Đen, Nâu",1300000,1300000,0,0
TIKI,tui-thoi-trang-nam,108635756,"Túi xách nam công sở 100% da bò thật cao cấp phong cách mới",702000,780000,78000,10
TIKI,tui-thoi-trang-nam,50709932,"Cặp Da Công Sở Nam  P077",325000,325000,0,0
TIKI,tui-thoi-trang-nam,57939413,"Cặp da công sở LATA CA31",750000,750000,0,0
TIKI,tui-thoi-trang-nam,146366136,"Ví nam ngang mini BHM816 Mỏng gọn, Da bò thật, chống quét RFID",279720,279720,0,0
TIKI,tui-thoi-trang-nam,138543600,"Cặp da nam công sở TRITA TCA17",269000,440000,171000,39
TIKI,tui-thoi-trang-nam,89786100,"Túi đeo chéo túi bao tử Sport Canvas unisex nhỏ gọn tiện dụng - Túi chéo TC70-D",56501,77218,20717,27
TIKI,tui-thoi-trang-nam,149179677,"Ví cầm tay, bóp cầm tay, ví đựng thẻ card nam nữ thời trang da bò cao cấp 2 ngăn khóa BA04 KT:21x13x4cm (Nâu - Đen)",143550,207350,63800,31
TIKI,tui-thoi-trang-nam,197864356,"Ví Đứng Nam Nhỏ Gọn, Da Bò SMALL PEBBLE Mềm Mại - Bền Bỉ, Size Trung, Chống Xước - Chống Nhăn Tốt, Thiết Kế Đơn Giản, Dáng Đứng - Gập 2, 3 Ngăn Lớn Đựng Tiền Và 8 Ngăn Nhỏ Để Thẻ ATM, Giấy Tờ Tùy Thân - Hàng Chính Hãng SAIGIO",983000,999000,16000,2
TIKI,tui-thoi-trang-nam,81224272,"Túi Đeo Chéo Bao Tử Chống Nước FALDO",166000,166000,0,0
TIKI,tui-thoi-trang-nam,50422433,"Túi Đeo Chéo Nam Phong Cách Lịch Lãm P088",245000,245000,0,0
TIKI,tui-thoi-trang-nam,66912745,"Cặp da công sở đựng Laptop 14 inch họa tiết ông già cao cấp",325000,325000,0,0
TIKI,tui-thoi-trang-nam,58472895,"Túi đeo chéo da nam LATA BALC24",360000,360000,0,0
TIKI,tui-thoi-trang-nam,105628957,"Túi xách nam công sở da thật chất lượng cao cấp phong cách mới",351000,390000,39000,10
TIKI,tui-thoi-trang-nam,125181251,"Ví da nam, bóp da nam Bụi Leather V110 - Da bò Pullup cao cấp - Bảo hành 12 tháng",209000,370000,161000,44
TIKI,tui-thoi-trang-nam,157254039,"Túi Bao Tử Flexible SAIGON SWAGGER SGS Flexible Bumbag",360000,360000,0,0
TIKI,tui-thoi-trang-nam,193389984,"Túi Đeo Chéo Nam Nữ Thời Trang Trẻ Trung, Túi Đựng Ipad, Túi Đeo Vai Có Túi Bố Nhiều Ngăn Kéo Đựng Đồ Rất Tiện Lợi, Vải Oxford Chống Thấm Nước",135000,135000,0,0
TIKI,tui-thoi-trang-nam,125149562,"Ví nam, bóp nam da bò sáp Bụi Leather V108 - Bảo hành 12 tháng",209000,370000,161000,44
TIKI,tui-thoi-trang-nam,93145566,"Ví kẹp tiền cho nam leather carbon",585000,585000,0,0
TIKI,tui-thoi-trang-nam,241816882,"Bóp ví nam đựng thẻ tín dụng, GPLX, CCCD, Card,... có lẫy tự động tích hợp công nghệ chống trộm thông minh RFID",278000,278000,0,0
TIKI,tui-thoi-trang-nam,135053359,"Túi đeo chéo đeo vai thời trang nam vải canvas hiệu Moyyi TDC005",324000,450000,126000,28
TIKI,tui-thoi-trang-nam,78954023,"Túi xách nam công sở 100% da bò thật cao cấp phong cách mới",900000,999000,99000,10
TIKI,tui-thoi-trang-nam,90469917,"Túi xách nam công sở da bò thật cao cấp ",900000,999000,99000,10
TIKI,tui-thoi-trang-nam,153021062,"Túi đeo chéo nam cao cấp phong cách HÀN QUỐC BEE GEE DCN9018A (Tặng quà tặng ngẫu nhiên trong BEEGEE GILF COLLECTION)",238000,480000,242000,50
TIKI,tui-thoi-trang-nam,163574482,"Ví nam cao cấp CaecnKoen- Ví ngắn -Full hộp đựng cao cấp",650000,1300000,650000,50
TIKI,tui-thoi-trang-nam,32172674,"Túi xách da công sở nam có dây đeo chéo cao cấp chống thấm nước DH1803 - Nâu",329000,329000,0,0
TIKI,tui-thoi-trang-nam,58842555,"Túi Đeo Chéo, Đeo Ngang Dành Cho Nam Chất Da PU Cao Cấp Thời Trang Phong Cách",66330,95810,29480,31
TIKI,tui-thoi-trang-nam,50490304,"Túi đeo ngực,đeo chéo nam đã tích hợp công nghệ 4.0",711000,790000,79000,10
TIKI,tui-thoi-trang-nam,111868791,"Túi đeo chéo, đeo hông Arctic Hunter chất liệu Oxford chống nước - Y00020",335000,635000,300000,47
TIKI,tui-thoi-trang-nam,149521232,"{DA CÁ SẤU THẬT} Bóp Da Cá Sấu Nam Màu Đen Da Bụng - Ví Nam Da Cá Sấu Có Khoá Kéo Cao Cấp Dáng Ngang Thời Trang",890000,890000,0,0
TIKI,tui-thoi-trang-nam,76748874,"Cặp Sakos Phối Da Legend 04",1924000,2189000,265000,12
TIKI,tui-thoi-trang-nam,143789937,"Combo ví Nam Thương hiệu Oscar - Muỗng xỏ giày Pierre",845000,1690000,845000,50
TIKI,tui-vi-nu,189953379,"Túi Xách _Túi Đeo Vai Nữ CNK Mini Khóa Gập Da Trần Siêu Xinh Size 18 cm",129000,129000,0,0
TIKI,tui-vi-nu,154881116,"(Ảnh thật)Túi Cói Merci Loại 1 Màu Sáng, Có Đệm Đáy Giữ Form Túi, Có Lót, Túi Du Lịch",43000,54900,11900,22
TIKI,tui-vi-nu,178007821,"Túi Tote Xách Vải Bố Canvas Grepaco Thời Trang Nữ Đeo Vai Màu Đen Size To (Lớn) In Chữ Có Ngăn Phụ Bên Trong, Dành Cho Công Sở Đi Làm, Sinh Viên Đi Học, Chơi Du Lịch, Picnic, Gym, Shopping - Hàng Chính Hãng",75050,79000,3950,5
TIKI,tui-vi-nu,188940966,"Túi xách túi đeo vai nữ thời trang cao cấp phong cách mới",477000,530000,53000,10
TIKI,tui-vi-nu,44010126,"Túi dự tiệc cưới, túi cầm tay nữ nhỏ, hoa tiết nhỏ nhắn, sang trọng (Nhiều mẫu mã để chọn)",175000,250000,75000,30
TIKI,tui-vi-nu,175811879,"Ví Nữ Cầm Tay Thời Trang JUNO Kèm Khoá Trang Trí  VI171",544000,544000,0,0
TIKI,tui-vi-nu,90529784,"Túi xách nữ thời trang cao cấp",423000,470000,47000,10
TIKI,tui-vi-nu,160314806,"Túi Xách Nữ Đeo Chéo Chính Hãng FORERVER YOUNG Dáng Công Sở Thời Trang Da Sần Cao Cấp Nhiều Ngăn Tiện Dụng FY24",489000,489000,0,0
TIKI,tui-vi-nu,146945565,"Túi xách đeo chéo nữ đẹp đi chơi phong cách thời trang hàn quốc giá rẻ dễ thương cute DC257",60870,60870,0,0
TIKI,tui-vi-nu,160058433,"Túi tote thời trang May 10",189000,189000,0,0
TIKI,tui-vi-nu,185955256,"Túi xách nữ vải canvas thời trang cao cấp phong cách cá tính mới",288000,320000,32000,10
TIKI,tui-vi-nu,149400848,"TÚI VẢI NHUNG ĐEO VAI HÌNH GẤU XINH XẮN ĐI HỌC ĐI CHƠI TOTE CÓ TÚI CON DV10",75900,75900,0,0
TIKI,tui-vi-nu,193568721,"Túi Xách Nữ Đeo Chéo Đeo Vai Cao Cấp NUTUSHOP - NT88",299000,299000,0,0
TIKI,tui-vi-nu,53026947,"Túi đeo chéo bụng bao tử da loại 1 thời trang dạo phố  SKT20 Shalla",94333,136259,41926,31
TIKI,tui-vi-nu,86560855,"Túi xách nữ    Túi Retro sang chảnh TD10",135000,135000,0,0
TIKI,tui-vi-nu,186860436,"Ví Đựng Hộ Chiếu Passport Nam Nữ Cao Cấp, Da Bò PULL-UP Mềm Mại, Thiết Kế Hiện Đại - Đa Năng, Đựng Được Nhiều Loại Hộ Chiếu, Nhiều Ngăn Thẻ ATM, Đựng Tiền, Vé Máy Bay, Tiện Dụng Khi Đi Du Lịch, Công Tác - Hàng Chính Hãng SAIGIO",1181000,1199000,18000,2
TIKI,tui-vi-nu,117579068,"Túi xách đeo chéo nữ đẹp-CD08",68000,68000,0,0
TIKI,tui-vi-nu,126512059,"Túi đeo chéo nữ LATA HN88",450000,450000,0,0
TIKI,tui-vi-nu,67451622,"Túi đeo chéo nữ cúc họa mi nhỏ xinh TX38",60000,60000,0,0
TIKI,tui-vi-nu,97875867,"Ví đựng thẻ, đựng giấy tờ, thẻ ATM loại đẹp TK0087",14900,15000,100,1
TIKI,tui-vi-nu,87100259,"Balo thời trang, balo đi học, đựng laptop Túi Tote Mèo Mắt Long Lanh Mèo Cute balo nữ vải",68100,68100,0,0
TIKI,tui-vi-nu,144637552,"Túi xách , túi đeo vai nữ CG219 thời trang Hàn Quốc trẻ trung",129000,129000,0,0
TIKI,tui-vi-nu,167682901,"Túi đeo chéo nữ mini đựng điện thoại YUUMY YN120",165000,270000,105000,39
TIKI,tui-vi-nu,191775236,"Túi Xách Nữ Kẹp Nách Chính Hãng MICOCAH Dáng Công Sở Thời Trang Chất Da Lộn Cao Cấp Phối Màu Vintage Sang Trọng MC141 - Micocah",449000,449000,0,0
TIKI,tui-vi-nu,7939593,"Túi đựng điện thoại đeo chéo nữ thời trang mini bag",79101,108104,29003,27
TIKI,tui-vi-nu,5003323,"Túi Xách Nữ Cao Cấp Da Thật Elly ET54",1624350,2499000,874650,35
TIKI,tui-vi-nu,77445739,"Túi Xách Nữ - Túi Cầm Tay Nữ - Clutch Dự Tiệc (TX-063-1)",359000,359000,0,0
TIKI,tui-vi-nu,172977342,"Túi vải bố, Túi vải Canvas trơn Màu Trắng",25000,25000,0,0
TIKI,tui-vi-nu,209414557,"Ví túi dự tiệc cầm tay dạ hội sinh nhật khai trương lễ cưới sang trọng VDT10",341000,341000,0,0
TIKI,tui-vi-nu,172374525,"Ví nữ mini nắp cách điệu YUUMY Seasand YV59",75000,150000,75000,50
TIKI,tui-vi-nu,125757916,"Túi xách nữ kẹp nách khoá vuông phối vải kẻ sọc️freeship️",55000,55000,0,0
TIKI,tui-vi-nu,196573813,"Ví nữ cầm tay  Hàn Quốc nhiều ngăn nhỏ gọn , đáng yêu( shop giao ngẫu nhiên)",19800,22000,2200,10
TIKI,tui-vi-nu,160314545,"Túi Xách Nữ Đeo Chéo Chính Hãng MICOCAH Dáng Công Sở Thời Trang Chất Da Cao Cấp Cực Đẹp MC79 - Micocah Mall",429000,429000,0,0
TIKI,tui-vi-nu,185468231,"túi ví đeo chéo nữ với 2 dây đeo họa tiết thổ cẩm dáng đứng đựng vừa điện thoại - N8605",198000,269000,71000,26
TIKI,tui-vi-nu,177187685,"Túi xách nữ thời trang công sở cao cấp phong cách mới",441000,490000,49000,10
TIKI,tui-vi-nu,192064404,"Túi Xách Nữ Kẹp Nách Chính Hãng MICOCAH Dáng Công Sở Thời Trang Sang Trọng Đeo Vai Đeo Chéo Da Cao Cấp Cực Đẹp MC131 - Tukado",469000,469000,0,0
TIKI,tui-vi-nu,206661343,"Túi xách TOKYO JAPAN, mã G34. Quà tặng cao cấp cho gia đình, nam nữ cặp đôi, hội nhóm, doanh nghiệp",109000,109000,0,0
TIKI,tui-vi-nu,205819383,"Túi xách nữ cao cấp thời trang da mềm phong cách Hàn Quốc thanh lịch và sang trọng",219000,219000,0,0
TIKI,tui-vi-nu,97707630,"Túi xách nữ thời trang công sở cao cấp phong cách mới",441000,490000,49000,10
TIKI,tui-vi-nu,136940145,"Ví tiền vải canvas mini xinh xắn cho nữ",15000,15000,0,0
TIKI,tui-vi-nu,4982335,"Túi Đeo Chéo Nữ Ulzzang Trong Suốt Kèm Ví Nhỏ",57420,82940,25520,31
TIKI,tui-vi-nu,25293202,"Túi đeo chéo hình chú chuột Hamster siêu đáng yêu",62370,85239,22869,27
TIKI,tui-vi-nu,75414164,"Ví nữ cầm tay 2 ngăn kéo họa tiết hoa văn sang trọng, thiết kế nhiều ngăn tiện dụng TK0070",76000,150000,74000,49
TIKI,tui-vi-nu,15237390,"Túi đeo điện thoại M001",119000,119000,0,0
TIKI,tui-vi-nu,48655157,"Túi Đeo Chéo Nữ 2 Ngăn Đựng  Được Điện Thoại  Có Móc Gấu SK11810",75000,75000,0,0
TIKI,tui-vi-nu,74603963,"Túi đeo chéo in hình vui nhộn Mstaly Tặng móc khóa cá heo",38610,52767,14157,27
TIKI,tui-vi-nu,248990474,"KHÓA SẬP MỎ VỊT 2-3CM",42000,42000,0,0
TIKI,tui-vi-nu,133775928,"Túi đeo chéo nữ, túi đựng điện thoại mini dáng dọc thời trang. Phong cách thiếu nữ Hàn Quốc trẻ trung, năng động. Sang chảnh, cá tính- Màu Hồng nhạt",129000,129000,0,0
TIKI,tui-vi-nu,173856972,"Túi đeo vai đi làm, đi học đẹp giá rẻ, form to, 2 lớp, vải canvas - CON CÁ Heo",69000,69000,0,0
TIKI,tui-vi-nu,186229908,"Túi xách nữ Pu Cao Cấp Handle Bag chính VÀ kiểu dáng cổ điển đơn giản thời trang có thể đeo chéo hoặc xách tayTúi đeo vai - Bảo hành 1 năm",592800,592800,0,0
TIKI,tui-vi-nu,185073370,"Túi xách nữ Oscar - OCWHBSG 055",2490000,2490000,0,0
TIKI,tui-vi-nu,157254165,"Ví Nam, Nữ Ngắn Logo SAIGON SWAGGER Nhiều Ngăn, Chống Thấm",280000,280000,0,0
TIKI,tui-vi-nu,56993030,"Túi đeo chéo nữ Hàn Quốc cao cấp họa tiết kẻ caro",149000,149000,0,0
TIKI,tui-vi-nu,191309776,"Marhen.J - Túi đeo vai nữ chữ nhật Milly Nano MJ21AMLYNA-BK",2890000,2890000,0,0
TIKI,tui-vi-nu,86560930," Túi đeo chéo nữ    Túi xách nữ mini dây xích SANG CHẢNH TD18",65000,65000,0,0
TIKI,tui-vi-nu,206662997,"Túi xách tote RUN, mã G26. Quà tặng cao cấp cho gia đình, nam nữ cặp đôi, hội nhóm, doanh nghiệp",109000,109000,0,0
TIKI,tui-vi-nu,82880369,"TÚI VÍ  NỮ DA PHONG CÁCH HÀN QUỐC ĐỂ ĐIỆN THOẠI – SIÊU XINH – NĂNG ĐỘNG VÀ TIỆN ÍCH",53000,53000,0,0
TIKI,tui-vi-nu,13633710,"Túi Vải Tote Cực Xinh G015",69000,69000,0,0
TIKI,tui-vi-nu,132079713,"Túi Chuồn Chuồn Màu Đen",99000,240000,141000,59
TIKI,tui-vi-nu,84103250,"túi ngọc trai mini thời trang dành cho nữ",169000,169000,0,0
TIKI,tui-vi-nu,169600256,"Túi Xách Nam, Nữ, Túi Đeo Chéo Unisex Dành Cho Nam Nữ, Túi Vải Canvas Đeo Chéo Phong Cách Cá Tính - OTV120 - Ope Store",160000,160000,0,0
TIKI,tui-vi-nu,8237398,"Ví cầm tay thời trang cho nữ TM-VinuCK63 kiểu dáng sang trọng",209000,209000,0,0
TIKI,tui-vi-nu,93291302,"Marhen.J - Túi đeo vai chữ nhật vải bố Rico Mini MJ19BRCOMN-WI",2290000,2290000,0,0
TIKI,tui-vi-nu,125100953,"Túi cầm tay Kim Sa",59000,59000,0,0
TIKI,tui-vi-nu,209414504,"Ví nữ cầm tay , dự tiệc phong cách hàn quốc hót nhất 2022",282000,282000,0,0
TIKI,tui-vi-nu,117208903,"Ví dài cầm tay nữ phong cách hàn Quốc, mãi mãi trẻ trung, cá tính, ví dài cầm tay nhiều ngăn siêu tiện dụng, phù hợp cho mọi lứa tuổi. Màu Đỏ đô",159000,159000,0,0
TIKI,tui-vi-nu,96987940,"Đeo chéo da Bóp đầm da dạ hội trơn Aly CS35 Tặng móc khóa cá heo",84181,115048,30867,27
TIKI,tui-vi-nu,43694766,"Túi nữ thời trang phong cách Hàn Quốc Đồ Da Thành Long TLG 208098",44400,87000,42600,49
TIKI,tui-vi-nu,196147569,"Ví Da Nam Nữ Cầm Tay Khóa kéo Davanti Sang Trọng DFN257",460000,490000,30000,6
TIKI,tui-vi-nu,161524403,"Bóp ví nữ dài cầm tay V0510 LIVE nhiều ngăn tiện lợi, phong cách thời trang, cá tính",36000,72000,36000,50
TIKI,tui-vi-nu,160315171,"Ví Nữ Mini Cầm Tay PERFECT FOR YOU Đựng Tiền Dáng Vuông Xinh Xắn Da Cao Cấp Cực Đẹp PFY01 - Micocah Mall",99000,99000,0,0
TIKI,tui-vi-nu,198321186,"Túi nữ dạng cặp lồng đeo chéo hoặc cầm tay họa tiết sọc caro phong cách cổ điển",177100,177100,0,0
TIKI,tui-vi-nu,172192141,"Túi Nữ Thời Trang Phong Cách Hàn Quốc Đồ Da Thành Long TLG 208169",30000,30000,0,0
TIKI,tui-vi-nu,185849411,"Túi Xách Nữ Thời Trang Dây Đeo Chéo Đeo Vai Kẹp Nách CRESCENT MOON HOBO BAG GIPSY",690000,690000,0,0
TIKI,tui-vi-nu,59264752,"Ví tiền mini hình chữ vuông nhiều màu siêu dễ thương - Đựng tiền xu, tai nghe tiện lợi - Mẫu ngẫu nhiên",13500,13500,0,0
TIKI,tui-vi-nu,171214627,"Túi ví mèo thần tài (màu xanh lá số 11)",45000,45000,0,0
TIKI,voucher-dich-vu,180341239,"Sách nói: Một Đời Như Kẻ Tìm Đường",99000,99000,0,0
TIKI,voucher-dich-vu,195462411,"Monkey Junior TRỌN ĐỜI -Voucher Mã học  Tiếng Anh online",1269000,1269000,0,0
TIKI,tui-vi-nu,129382325,"Túi Đeo Chéo Pop It Nhiều Màu (Giao màu ngẫu nhiên)",44600,44600,0,0
TIKI,tui-vi-nu,71725974,"Túi clutch nữ thời trang cao cấp ELLY – ECH46",559300,799000,239700,30
TIKI,tui-vi-nu,157210295,"Túi tote - Combo Daisy ",364000,364000,0,0
TIKI,voucher-dich-vu,206536429,"Vinpearl VinOasis Resort 5* Phú Quốc - Buffet Sáng, Vui Chơi VinWonders/ Vinpearl Safari, Công Viên Nước, Hồ Bơi, Đón Tiễn Sân Bay",2550000,2550000,0,0
TIKI,voucher-dich-vu,272739343,"Bảo hiểm TNDS xe ô tô 4 - 5 chỗ ngồi, không kinh doanh, giấy chứng nhận điện tử tiện dụng - Bảo hiểm Quân đội MIC",480700,480700,0,0
TIKI,voucher-dich-vu,19362344,"Hồ Tràm Beach Boutique Resort & Spa 4* - Ưu Đãi Lớn, Buffet Sáng, Hồ Bơi, Bãi Biển Riêng, Nghỉ Dưỡng Đẳng Cấp Quốc Tế",2450000,2450000,0,0
TIKI,voucher-dich-vu,167015053,"Combo Gội Đầu Thảo Dược + Massage Vai, Cổ, Gáy - TÓC SẠCH THƠM - KHỎE VAI GÁY (90 phút) - Giá khuyến mãi cho khách hàng trải nghiệm lần đầu.",250000,250000,0,0
TIKI,voucher-dich-vu,195653173,"TOUR KHÁM PHÁ PHÚ QUỐC - BAY BAMBOO AIRWAYS",6190000,6190000,0,0
TIKI,voucher-dich-vu,174643298,"Gội đầu và massage dưỡng sinh tại Paradise Spa",99000,99000,0,0
TIKI,voucher-dich-vu,145209314,"KHÓA HỌC HCM - TIẾNG ANH CHUYÊN NGÀNH CÔNG NGHỆ THÔNG TIN",5900000,5900000,0,0
TIKI,voucher-dich-vu,249827266,"PHUN MÔI KHỬ THÂM - SẮC MÔI CĂNG HỒNG",3000000,3000000,0,0
TIKI,tui-vi-nu,107982318,"Túi kẹp nách nữ phối dây xích thời trang nhỏ gọn tiện dụng da mềm đẹp TK0095",49000,90000,41000,46
TIKI,voucher-dich-vu,193608588,"Sách nói: Bộ sách Kể Chuyển Cuộc Đời Các Thiên Tài",799000,799000,0,0
TIKI,voucher-dich-vu,158012198,"Phiếu Quà Tặng Beard Papa's 100K ",100000,100000,0,0
TIKI,voucher-dich-vu,118781191,"[E-VOUCHER]- KidsUP Soroban - Học toán tư duy kiểu Nhật (GÓI 1 NĂM& TRỌN ĐỜI) - Gói 1 năm",930000,930000,0,0
TIKI,voucher-dich-vu,197625350,"Vinpearl Nam Hội An Resort & Golf 5* -  Hồ Bơi, Bãi Biển Riêng dành cho 02 khách",3750000,3750000,0,0
TIKI,voucher-dich-vu,195520775,"Trụ La Lan can, cầu thang",185000,185000,0,0
TIKI,tui-vi-nu,189337493,"Túi đeo chéo nữ nam thời trang cao cấp chính hãng YVan C69",599000,599000,0,0
TIKI,voucher-dich-vu,38381342,"[HCM] Tour 3N2Đ Đà Nẵng - Bà Nà - Hội An - Sơn Trà, Gồm Vé Máy Bay, Khởi Hành Hàng Ngày",4390000,4390000,0,0
TIKI,tui-vi-nu,51637673,"Túi Xách Đeo Chéo Nữ Mini Đẹp Năng Động CF11",43000,56700,13700,24
TIKI,tui-vi-nu,177092421,"Túi xách nữ 2 trong 1 thời trang cao cấp phong cách mới",387000,430000,43000,10
TIKI,voucher-dich-vu,207230707,"Sách nói Fonos: Tâm Lý Học Tích Cực",99000,99000,0,0
TIKI,voucher-dich-vu,10125302,"[Tour VIP] Hạ Long 01 Ngày, Tàu 4 Sao Alova Premium, Xe Đưa Đón Từ Hà Nội, Đi Và Về Đường Cao Tốc",1280000,1280000,0,0
TIKI,voucher-dich-vu,247814719,"[2024] Gói 3N2Đ Premier Residences Phú Quốc Emerald Bay 5* Managed by Accor - Buffet Sáng, Bãi Khem Cực Đẹp, Đón Tiễn Sân Bay",3350000,3350000,0,0
TIKI,voucher-dich-vu,272665126,"Bảo hiểm TNDS xe ô tô bán tải, không kinh doanh, giấy chứng nhận điện tử - Bảo hiểm Quân đội MIC",480700,480700,0,0
TIKI,tui-vi-nu,174293719,"Túi xách nam  nữ vải dù Oxford thời trang cao cấp giá rẻ đeo chéo đa năng nhiều ngăn chống thấm nước",167000,167000,0,0
TIKI,voucher-dich-vu,137210189,"[E-BOOK] New Amanda & Friends 1 Sách giáo viên điện tử",15000,15000,0,0
TIKI,tui-vi-nu,66483145,"Túi  xách tay nữ công sở bản to có dây đeo",65000,65000,0,0
TIKI,tui-vi-nu,87050052,"Túi xách nữ pha màu, túi xách công sở thời trang phong cách Hàn Quốc",259000,259000,0,0
TIKI,voucher-dich-vu,249016334,"VOUCHER LẤY NHÂN MỤN CHUẨN Y KHOA 90 PHÚT",350000,350000,0,0
TIKI,voucher-dich-vu,68707570,"VietGrow Edu - Khóa Học Trực Tuyến Tư Duy Thiết Kế - Giảng Viên Nguyễn Phi Vân [E-learning]",499000,499000,0,0
TIKI,tui-vi-nu,81608563,"Túi xách nữ đeo chéo pha màu kiểu dáng Hàn Quốc sang trọng, thanh lịch TN160",119000,119000,0,0
TIKI,tui-vi-nu,46224953,"Túi xách nữ XN005",299000,299000,0,0
TIKI,voucher-dich-vu,205614261,"Tour tham quan Huế 1 ngày khởi hành từ Đà Nẵng",400000,400000,0,0
TIKI,tui-vi-nu,196522741,"MLB - Túi đeo chéo Checkerboard Hipsack 3AHSM082N",3590000,3590000,0,0
TIKI,tui-vi-nu,190489681,"Túi Xách Nữ Da Thật, Túi Công Sở Cầm Tay Sang Trọng, Cao Cấp HADATI - Màu Xanh Dương, Size 25cm  -Túi xách nữ đeo chéo, túi xách da, khí chất thời trang mới, túi xách nữ, túi đeo vai nữ da phối màu hợp thời trang",869000,869000,0,0
TIKI,voucher-dich-vu,34476186,"Khóa học Chìa khóa thành công cho Business Analyst",600000,600000,0,0
TIKI,tui-vi-nu,73748499,"Túi xách nữ thời trang cao cấp ELLY – EL157 Đen Nude",1399000,1399000,0,0
TIKI,tui-vi-nu,86561206," Túi xách nữ    Túi đeo chéo mini hàng quảng châu siêu hot TD17",63000,63000,0,0
TIKI,voucher-dich-vu,160895445,"Sinh Trắc Vân Tay Gen Talents – Dịch Vụ Tư Vấn Sinh Trắc Vân Tay Gia Đình – Gói Phân Tích Demo – Tặng Sách Muôn Kiếp Nhân Sinh Tập 2",600000,600000,0,0
TIKI,voucher-dich-vu,169928414,"Trở Vạch 1/4W 5% 160R→1K (1990đ/Gói 50Con)",2931,2931,0,0
TIKI,tui-vi-nu,160315233,"Túi Xách Nữ Kẹp Nách Chính Hãng MICOCAH Dáng Công Sở Thời Trang Nhiều Ngăn Tiện Dụng Chất Cực Đẹp MC21 - Micocah Mall",389000,389000,0,0
TIKI,voucher-dich-vu,204953597,"Vé vui chơi công viên Châu Á - Asia Park (All in one)",100000,100000,0,0
TIKI,voucher-dich-vu,152052334,"E-voucher lấy cao răng công nghệ siêu âm",150000,150000,0,0
TIKI,tui-vi-nu,144570962,"Túi xách nữ/ Túi đeo chéo, túi đeo vai nữ da bò nguyên miếng siêu cao cấp, đơn giản và thời thượng",850000,850000,0,0
TIKI,voucher-dich-vu,166157112,"Phiếu Quà Tặng KaT Jewelry 50K",47500,50000,2500,5
TIKI,tui-vi-nu,164961283,"Túi đeo chéo, đeo vai da cao cấp T0031 Basic chống thấm nước, bền bỉ unisex nam nữ phong cách thời trang Hàn",190000,380000,190000,50
TIKI,voucher-dich-vu,56596544,"Dory Beauty Spa - Combo Trị Mụn CO2 CORBONTHERAPY ",209000,209000,0,0
TIKI,voucher-dich-vu,117046285,"Monkey Math (Mã giấy) - Toán tiếng Anh (Theo chương trình GDPT mới cho Mầm non và Tiểu học) (Trọn đời, 1 năm",499000,499000,0,0
TIKI,voucher-dich-vu,10409866,"Liệu Trình 60 Phút Massage Trị Liệu Cổ Vai Gáy Tại Ven Ven Massage & Spa",249000,249000,0,0
TIKI,tui-vi-nu,118553670,"2 Túi Nhựa Bảo Vệ Thẻ, Căn Cước Công Dân, Thẻ ATM, Bằng Lái, Thẻ Sinh Viên, Card Visit",2999,2999,0,0
TIKI,tui-vi-nu,83921150,"Túi Đeo Chéo Nữ ️️ Túi Xách Nữ Bản To Đựng Laptop Chống Nước Phong Cách Hàn Quốc SPB136",125000,125000,0,0
TIKI,tui-vi-nu,98978186,"Túi Xách Da PU Mềm 2 Màu Đen, Trắng Phong Cách Sang Chảnh",99000,99000,0,0
TIKI,tui-vi-nu,138334203,"Túi Xách Nữ Thời Trang JUNO Cỡ Nhỏ Dáng Bì Thư TXN521",682000,682000,0,0
TIKI,tui-vi-nu,58702162,"Túi xách nữ",95000,95000,0,0
TIKI,voucher-dich-vu,52288538,"Khóa học Tiếng Hàn Sơ Cấp 1 (Giáo Trình Tiếng Hàn Tổng hợp 1), 33 video, 750 từ vựng.",650000,650000,0,0
TIKI,tui-vi-nu,186639332,"Túi Xách Nữ Công Sở Chất Da Pu Đeo Vai Sze Lớn Đi Làm Thời Trang Hàn Quốc Cao Cấp KN09",89000,89000,0,0
TIKI,tui-vi-nu,177158869,"Túi xách nữ 2 trong 1 thời trang cao cấp",387000,430000,43000,10
TIKI,voucher-dich-vu,122642430,"[E-BOOK] Practice Tests 6-10 Key For Schools A2 Sách mềm sách học sinh",15000,15000,0,0
TIKI,tui-vi-nu,89119829,"Túi đeo chéo đeo vai nữ cao cấp phong cách mới",269000,298000,29000,10
TIKI,voucher-dich-vu,57364250,"Combo Uốn/Duỗi/Nhuộm + Hấp Collagen Tại Labella Hair Salon",299000,299000,0,0
TIKI,tui-vi-nu,86562068,"Túi đeo chéo nữ    Túi xách nữ mini dây da pha xích Ulzzang siêu dễ thương TD14",59000,59000,0,0
TIKI,tui-vi-nu,147942468,"Ví Nữ Mini Cầm Tay Chính Hãng MICOCAH Vân Da Rắn Cao Cấp Nhỏ Gọn Nhiều Ngăn Tiện Dụng Siêu Đẹp Giá Rẻ MC49 - Tukado",159000,159000,0,0
TIKI,tui-vi-nu,4941579,"Túi xách tay nữ size lớn 32x29x12cm",219000,219000,0,0
TIKI,voucher-dich-vu,173008724,"Tour du lịch Dubai - Abu Dhabi 5N4Đ + Vé máy bay. Hành Trình Khám Phá Các Tiểu Vương Quốc Ả Rập Thống Nhất. ",29989000,29989000,0,0
TIKI,tui-vi-nu,81312126,"Túi xách nữ công sở HOTTREND  Túi xách nữ kẻ caro Hàn Quốc  Deli TN47",199000,199000,0,0
TIKI,tui-vi-nu,169594412,"Combo Túi Xách Nữ Kèm Túi Nhỏ, Túi Vải Canvas Cỡ Lớn Đựng Nhiều Đồ, Túi Tote Đeo Vai Phong Cách Hàn Quốc Cỡ Lớn (Kèm Thêm Túi Nhỏ) - OTV115 - Ope Store",172000,172000,0,0
TIKI,tui-vi-nu,5003133,"Túi Xách Nữ Thời Trang Cao Cấp Elly EL65",899400,1499000,599600,40
TIKI,voucher-dich-vu,56089416,"Voucher combo du lịch hạng phòng President 3 ngày 2 đêm tại Alpha Bird Hotel Nha Trang",1870000,1870000,0,0
TIKI,tui-vi-nu,101831134,"Túi Kẹp Nách, Túi Xách Nữ, Túi Đeo Chéo Hàn Quốc TDC045",75000,75000,0,0
TIKI,tui-vi-nu,195971660,"Túi cách nữ cao cấp da thật ELLY – ET141",2799000,2799000,0,0
TIKI,tui-vi-nu,42240080,"Túi đeo chéo đeo vai nữ đựng điện thoại dọc nắp Trơn ép chữ K9 Shalla",83160,120120,36960,31
TIKI,tui-vi-nu,189457910,"Túi xách thời trang nữ cao cấp Allwellshop - Túi cầm tay  da bò 2 lớp font đẹp, sang trọng sử dụng đa phong cách",745000,745000,0,0
TIKI,tui-vi-nu,263696207,"Túi da nữ đeo vai basic Lata HN108",590000,590000,0,0
TIKI,tui-vi-nu,173856862,"Túi tote đeo chéo đeo đi học đi làm đi chơi",46900,46900,0,0
TIKI,tui-vi-nu,47215277,"Túi xách nữ cao cấp da thật ELLY – ET82",1019400,1699000,679600,40
TIKI,tui-vi-nu,134754496,"Túi tote đeo vai vải bố canvas T052 nữ in chữ by merciparis có khóa kéo, mềm, đẹp phong cách Hàn",76000,152000,76000,50
TIKI,tui-vi-nu,37705615,"Túi xách nữ quai xích thời trang",145000,145000,0,0
TIKI,voucher-dich-vu,167017954,"Dịch Vụ Massage Đầu, Cổ, Vai, Gáy - Giúp Máu Huyết Lưu Thông Giảm Cơn Đau Cổ Vai Gáy Hiệu Quả (45 phút)",177000,177000,0,0
TIKI,voucher-dich-vu,71326201,"Không Gian Sạch - Dịch Vụ Vệ Sinh Sofa - Tổng đài 18006248 (Dịch vụ được thực hiện bởi Công nghệ chuyển giao từ hệ thống máy Rainbow của tập đoàn Rexair của Hoa Kỳ)",700000,700000,0,0
TIKI,tui-vi-nu,137951969,"Túi Giỏ Xách Đan Tay Quai Gỗ Hàng Xuất Khẩu Thủ Công Sang Chảnh Đi Chơi Đi Biển Chụp Hình - Doni House",100000,100000,0,0
TIKI,tui-vi-nu,176652201,"Túi đeo chéo nữ thời trang YUUMY YN91 nhiều màu",325000,490000,165000,34
